GISJOIN,AREANAME,PopTotal,White,NonWhite,WhiteNative,Black,MedHouseValue,MedGrossRent
G01007300001,STCTY-01073 TRACT-    0001     IN BIRMINGHAM AL,2792,2783,9,2771,9,2435,24.32
G01007300002,STCTY-01073 TRACT-    0002     IN BIRMINGHAM AL,1796,1767,29,1743,29,2444,22.65
G01007300003,STCTY-01073 TRACT-    0003     IN BIRMINGHAM AL,3935,3776,159,3754,159,2685,22.65
G01007300004,STCTY-01073 TRACT-    0004     IN BIRMINGHAM AL,4882,4144,738,4120,738,2284,19.66
G01007300005,STCTY-01073 TRACT-    0005     IN BIRMINGHAM AL,5960,4324,1636,4281,1636,1842,16.5
G01007300006,STCTY-01073 TRACT-    0006     IN BIRMINGHAM AL,3984,749,3235,735,3235,1402,12.09
G01007300007,STCTY-01073 TRACT-    0007     IN BIRMINGHAM AL,4937,92,4845,85,4845,1112,10.22
G01007300008,STCTY-01073 TRACT-    0008     IN BIRMINGHAM AL,7604,6279,1325,6180,1324,2390,18.24
G01007300009,STCTY-01073 TRACT-    0009     IN BIRMINGHAM AL,7296,1020,6276,948,6276,1750,11.93
G01007300010,STCTY-01073 TRACT-    0010     IN BIRMINGHAM AL,2403,1156,1247,1145,1247,1567,14.23
G01007300011,STCTY-01073 TRACT-    0011     IN BIRMINGHAM AL,5222,2402,2820,2299,2820,1290,11.98
G01007300012,STCTY-01073 TRACT-    0012     IN BIRMINGHAM AL,6597,3495,3102,3390,3102,1667,14.29
G01007300013,STCTY-01073 TRACT-    0013     IN BIRMINGHAM AL,2476,431,2045,423,2045,1939,13.44
G01007300014,STCTY-01073 TRACT-    0014     IN BIRMINGHAM AL,3747,125,3622,118,3622,1761,12.58
G01007300015,STCTY-01073 TRACT-    0015     IN BIRMINGHAM AL,8145,6779,1366,6468,1366,3015,23.69
G01007300016,STCTY-01073 TRACT-    0016     IN BIRMINGHAM AL,9138,8423,715,8177,715,4667,32.32
G01007300017,STCTY-01073 TRACT-    0017     IN BIRMINGHAM AL,2764,1858,906,1842,906,0,14.08
G01007300018,STCTY-01073 TRACT-    0018     IN BIRMINGHAM AL,6401,3585,2816,3545,2816,1801,14.83
G01007300019,STCTY-01073 TRACT-    0019     IN BIRMINGHAM AL,3274,2619,655,2566,655,2545,20.33
G01007300020,STCTY-01073 TRACT-    0020     IN BIRMINGHAM AL,2329,2155,174,2142,174,3000,28.32
G01007300021,STCTY-01073 TRACT-    0021     IN BIRMINGHAM AL,3982,3933,49,3907,48,2827,28.22
G01007300022,STCTY-01073 TRACT-    0022     IN BIRMINGHAM AL,2813,2378,435,2358,435,2591,22.68
G01007300023,STCTY-01073 TRACT-    0023     IN BIRMINGHAM AL,4756,3964,792,3933,792,3839,22.57
G01007300024,STCTY-01073 TRACT-    0024     IN BIRMINGHAM AL,5777,1809,3968,1775,3968,1648,12.69
G01007300025,STCTY-01073 TRACT-    0025     IN BIRMINGHAM AL,2631,1395,1236,1380,1236,0,10
G01007300026,STCTY-01073 TRACT-    0026     IN BIRMINGHAM AL,5426,849,4577,794,4577,0,10.53
G01007300027,STCTY-01073 TRACT-    0027     IN BIRMINGHAM AL,4044,3333,711,3205,701,0,17.63
G01007300028,STCTY-01073 TRACT-    0028     IN BIRMINGHAM AL,10896,1231,9665,1103,9661,0,12.42
G01007300029,STCTY-01073 TRACT-    0029     IN BIRMINGHAM AL,7594,191,7403,167,7403,2208,13.82
G01007300030,STCTY-01073 TRACT-    0030     IN BIRMINGHAM AL,6296,6131,165,6036,165,4358,29.77
G01007300031,STCTY-01073 TRACT-    0031     IN BIRMINGHAM AL,5248,5214,34,5140,34,3237,27.66
G01007300032,STCTY-01073 TRACT-    0032     IN BIRMINGHAM AL,7410,1471,5939,1398,5939,1758,14.16
G01007300033,STCTY-01073 TRACT-    0033     IN BIRMINGHAM AL,6254,2445,3809,2089,3809,1503,15.55
G01007300034,STCTY-01073 TRACT-    0034     IN BIRMINGHAM AL,6097,5618,479,5429,479,2935,21.36
G01007300035,STCTY-01073 TRACT-    0035     IN BIRMINGHAM AL,4084,3754,330,3526,330,1660,18
G01007300036,STCTY-01073 TRACT-    0036     IN BIRMINGHAM AL,2741,2334,407,2302,407,4110,29.12
G01007300037,STCTY-01073 TRACT-    0037     IN BIRMINGHAM AL,4041,4032,9,3975,9,3691,33.96
G01007300038,STCTY-01073 TRACT-    0038     IN BIRMINGHAM AL,6377,5302,1075,5255,1075,2650,23.95
G01007300039,STCTY-01073 TRACT-    0039     IN BIRMINGHAM AL,1764,614,1150,611,1150,1529,13.89
G01007300040,STCTY-01073 TRACT-    0040     IN BIRMINGHAM AL,9643,9387,256,9239,256,2993,27.72
G01007300041,STCTY-01073 TRACT-    0041     IN BIRMINGHAM AL,3592,1359,2233,1310,2233,2850,13.54
G01007300042,STCTY-01073 TRACT-    0042     IN BIRMINGHAM AL,4908,234,4674,224,4673,1460,12.57
G01007300043,STCTY-01073 TRACT-    0043     IN BIRMINGHAM AL,4939,555,4384,475,4384,0,11.46
G01007300044,STCTY-01073 TRACT-    0044     IN BIRMINGHAM AL,5904,1431,4473,1377,4467,0,12.23
G01007300045,STCTY-01073 TRACT-    0045     IN BIRMINGHAM AL,5598,401,5197,363,5197,0,11.55
G01007300046,STCTY-01073 TRACT-    0046     IN BIRMINGHAM AL,3017,174,2843,155,2843,0,11.7
G01007300047,STCTY-01073 TRACT-    0047     IN BIRMINGHAM AL,11626,10508,1118,10157,1118,6302,40.14
G01007300048,STCTY-01073 TRACT-    0048     IN BIRMINGHAM AL,5094,4707,387,4523,387,8306,41.06
G01007300049,STCTY-01073 TRACT-    0049     IN BIRMINGHAM AL,9804,9118,686,8788,686,3821,31.43
G01007300050,STCTY-01073 TRACT-    0050     IN BIRMINGHAM AL,4458,4245,213,3963,213,3969,27.14
G01007300051,STCTY-01073 TRACT-    0051     IN BIRMINGHAM AL,2477,343,2134,331,2134,1590,13.74
G01007300052,STCTY-01073 TRACT-    0052     IN BIRMINGHAM AL,2610,2200,410,2177,410,2385,24.63
G06000100001,STCTY-06001 TRACT-    0001     IN OAKLAND CA,527,488,39,432,2,0,0
G06000100001A,STCTY-06001 TRACT-    0001-A   IN BERKELEY CA,2582,2545,37,1989,12,2771,23.72
G06000100001B,STCTY-06001 TRACT-    0001-B   IN BERKELEY CA,3545,3427,118,2634,32,2296,23.72
G06000100002,STCTY-06001 TRACT-    0002     IN OAKLAND CA,3873,3852,21,3479,3,6437,41.55
G06000100002A,STCTY-06001 TRACT-    0002-A   IN BERKELEY CA,1941,1300,641,996,604,3209,30.09
G06000100002B,STCTY-06001 TRACT-    0002-B   IN BERKELEY CA,3563,2118,1445,1777,1179,3074,27.87
G06000100002C,STCTY-06001 TRACT-    0002-C   IN BERKELEY CA,2920,1699,1221,1412,724,3171,29.32
G06000100002D,STCTY-06001 TRACT-    0002-D   IN BERKELEY CA,2665,1970,695,1491,635,3381,29.43
G06000100003,STCTY-06001 TRACT-    0003     IN OAKLAND CA,4766,4756,10,3964,9,4498,35.24
G06000100003A,STCTY-06001 TRACT-    0003-A   IN BERKELEY CA,4829,4704,125,4001,7,3856,29.25
G06000100003B,STCTY-06001 TRACT-    0003-B   IN BERKELEY CA,3304,3267,37,2828,4,4857,36.19
G06000100003C,STCTY-06001 TRACT-    0003-C   IN BERKELEY CA,4407,4361,46,3904,10,5750,39.71
G06000100003D,STCTY-06001 TRACT-    0003-D   IN BERKELEY CA,4601,4515,86,4154,20,8168,47.82
G06000100003E,STCTY-06001 TRACT-    0003-E   IN BERKELEY CA,2013,1960,53,1767,22,13717,71.44
G06000100004,STCTY-06001 TRACT-    0004     IN OAKLAND CA,4829,4777,52,4120,36,4537,35.65
G06000100004A,STCTY-06001 TRACT-    0004-A   IN BERKELEY CA,3028,3011,17,2425,1,3665,31.61
G06000100004B,STCTY-06001 TRACT-    0004-B   IN BERKELEY CA,4266,4162,104,3591,8,3596,32.78
G06000100004C,STCTY-06001 TRACT-    0004-C   IN BERKELEY CA,5443,5351,92,4672,6,4130,35.87
G06000100004D,STCTY-06001 TRACT-    0004-D   IN BERKELEY CA,2598,2581,17,2153,9,3923,35.37
G06000100004E,STCTY-06001 TRACT-    0004-E   IN BERKELEY CA,3297,3208,89,2649,68,3647,31.43
G06000100005,STCTY-06001 TRACT-    0005     IN OAKLAND CA,5666,5592,74,4705,36,3956,33.48
G06000100005A,STCTY-06001 TRACT-    0005-A   IN BERKELEY CA,1887,1786,101,1565,0,0,24.89
G06000100005B,STCTY-06001 TRACT-    0005-B   IN BERKELEY CA,6535,6412,123,5695,12,6625,40.44
G06000100005C,STCTY-06001 TRACT-    0005-C   IN BERKELEY CA,2409,2393,16,2194,8,8267,48.58
G06000100005D,STCTY-06001 TRACT-    0005-D   IN BERKELEY CA,2666,2651,15,2328,2,4981,37.88
G06000100005E,STCTY-06001 TRACT-    0005-E   IN BERKELEY CA,2836,2704,132,2376,7,3892,33.34
G06000100006,STCTY-06001 TRACT-    0006     IN OAKLAND CA,4784,4677,107,4016,81,3647,31.87
G06000100006A,STCTY-06001 TRACT-    0006-A   IN BERKELEY CA,1966,1957,9,1783,0,7474,60.21
G06000100006B,STCTY-06001 TRACT-    0006-B   IN BERKELEY CA,2061,2051,10,1837,4,7136,54.16
G06000100006C,STCTY-06001 TRACT-    0006-C   IN BERKELEY CA,1491,1478,13,1370,7,8674,0
G06000100006D,STCTY-06001 TRACT-    0006-D   IN BERKELEY CA,3885,3855,30,3559,10,9199,68.88
G06000100006E,STCTY-06001 TRACT-    0006-E   IN BERKELEY CA,4809,4801,8,4360,4,6095,52.59
G06000100007,STCTY-06001 TRACT-    0007     IN OAKLAND CA,5271,5072,199,4138,166,2989,27.38
G06000100008,STCTY-06001 TRACT-    0008     IN OAKLAND CA,5882,5691,191,4430,173,3376,28.88
G06000100009,STCTY-06001 TRACT-    0009     IN OAKLAND CA,4239,4211,28,3529,7,4136,33.58
G06000100010,STCTY-06001 TRACT-    0010     IN OAKLAND CA,5000,4592,408,3852,304,3309,29.42
G06000100011,STCTY-06001 TRACT-    0011     IN OAKLAND CA,5880,4742,1138,4077,1011,3194,26.89
G06000100012,STCTY-06001 TRACT-    0012     IN OAKLAND CA,4478,4263,215,3706,96,3455,24.93
G06000100013,STCTY-06001 TRACT-    0013     IN OAKLAND CA,3282,3150,132,2742,38,2731,22.82
G06000100014,STCTY-06001 TRACT-    0014     IN OAKLAND CA,5458,4560,898,3772,627,2911,25.14
G06000100015,STCTY-06001 TRACT-    0015     IN OAKLAND CA,4377,3009,1368,2151,1266,2255,21.11
G06000100016,STCTY-06001 TRACT-    0016     IN OAKLAND CA,4658,2818,1840,2039,1670,3036,22.37
G06000100017,STCTY-06001 TRACT-    0017     IN OAKLAND CA,5966,5299,667,4419,514,2417,21.99
G06000100018,STCTY-06001 TRACT-    0018     IN OAKLAND CA,6756,6408,348,5348,119,2879,15.84
G06000100019,STCTY-06001 TRACT-    0019     IN OAKLAND CA,3120,3002,118,2584,57,0,17.34
G06000100020,STCTY-06001 TRACT-    0020     IN OAKLAND CA,2246,2097,149,1592,58,0,16.81
G06000100021,STCTY-06001 TRACT-    0021     IN OAKLAND CA,5640,4329,1311,3065,1147,1832,17.85
G06000100022,STCTY-06001 TRACT-    0022     IN OAKLAND CA,1582,1115,467,853,65,0,15.9
G06000100023,STCTY-06001 TRACT-    0023     IN OAKLAND CA,1604,869,735,677,37,0,15.83
G06000100024,STCTY-06001 TRACT-    0024     IN OAKLAND CA,3652,1990,1662,1721,14,0,23.4
G06000100025,STCTY-06001 TRACT-    0025     IN OAKLAND CA,4038,3928,110,3368,16,2972,21.24
G06000100026,STCTY-06001 TRACT-    0026     IN OAKLAND CA,4633,4588,45,3941,1,3109,26.77
G06000100027,STCTY-06001 TRACT-    0027     IN OAKLAND CA,3660,3639,21,3155,2,4328,30.31
G06000100028,STCTY-06001 TRACT-    0028     IN OAKLAND CA,2818,2783,35,2516,6,0,35.37
G06000100029,STCTY-06001 TRACT-    0029     IN OAKLAND CA,2166,2145,21,1878,2,0,24.41
G06000100030,STCTY-06001 TRACT-    0030     IN OAKLAND CA,4360,4224,136,3699,13,4257,32.82
G06000100031,STCTY-06001 TRACT-    0031     IN OAKLAND CA,4429,4357,72,3879,5,7975,46.13
G06000100032,STCTY-06001 TRACT-    0032     IN OAKLAND CA,4070,4056,14,3653,1,6314,45.75
G06000100033,STCTY-06001 TRACT-    0033     IN OAKLAND CA,5262,5227,35,4555,14,4116,35.79
G06000100034,STCTY-06001 TRACT-    0034     IN OAKLAND CA,4544,4531,13,3965,1,6368,46.73
G06000100035,STCTY-06001 TRACT-    0035     IN OAKLAND CA,4936,4855,81,4445,30,9388,69.1
G06000100036,STCTY-06001 TRACT-    0036     IN OAKLAND CA,3663,3635,28,3236,6,7381,45.99
G06000100037,STCTY-06001 TRACT-    0037     IN OAKLAND CA,4215,4176,39,3580,4,5469,36.89
G06000100038,STCTY-06001 TRACT-    0038     IN OAKLAND CA,4438,4417,21,3796,3,4255,35.46
G06000100039,STCTY-06001 TRACT-    0039     IN OAKLAND CA,4655,4591,64,4196,19,8432,60.3
G06000100040,STCTY-06001 TRACT-    0040     IN OAKLAND CA,2264,2256,8,2054,1,4981,36.23
G06000100041,STCTY-06001 TRACT-    0041     IN OAKLAND CA,1466,1455,11,1350,7,7358,0
G06000100042,STCTY-06001 TRACT-    0042     IN OAKLAND CA,1717,1704,13,1523,6,8199,0
G06000100043,STCTY-06001 TRACT-    0043     IN OAKLAND CA,4771,4769,2,4051,1,4258,31.77
G06000100044,STCTY-06001 TRACT-    0044     IN OAKLAND CA,3738,3735,3,3277,1,4264,34.57
G06000100045,STCTY-06001 TRACT-    0045     IN OAKLAND CA,5797,5796,1,5050,1,5139,40.73
G06000100046,STCTY-06001 TRACT-    0046     IN OAKLAND CA,6441,6327,114,5358,87,3735,31.52
G06000100047,STCTY-06001 TRACT-    0047     IN OAKLAND CA,5066,5008,58,4039,23,4086,32.56
G06000100048,STCTY-06001 TRACT-    0048     IN OAKLAND CA,5319,5315,4,4602,0,3922,35.19
G06000100049,STCTY-06001 TRACT-    0049     IN OAKLAND CA,4437,4420,17,3809,9,3399,31.64
G06000100050,STCTY-06001 TRACT-    0050     IN OAKLAND CA,5465,5455,10,4677,5,3739,32.27
G06000100051,STCTY-06001 TRACT-    0051     IN OAKLAND CA,3622,3613,9,3067,2,3593,32.59
G06000100052,STCTY-06001 TRACT-    0052     IN OAKLAND CA,5049,4920,129,4001,91,2969,24.98
G06000100053,STCTY-06001 TRACT-    0053     IN OAKLAND CA,4735,4697,38,4003,14,3839,29.25
G06000100054,STCTY-06001 TRACT-    0054     IN OAKLAND CA,4615,4606,9,3855,8,3649,30.06
G06000100055,STCTY-06001 TRACT-    0055     IN OAKLAND CA,5449,5368,81,4216,44,2293,21.74
G06000100056,STCTY-06001 TRACT-    0056     IN OAKLAND CA,2241,2186,55,1748,21,2778,22.83
G06000100057,STCTY-06001 TRACT-    0057     IN OAKLAND CA,5067,4995,72,4318,45,3743,32.91
G06000100058,STCTY-06001 TRACT-    0058     IN OAKLAND CA,4547,4544,3,3934,3,4038,35.04
G06000100059,STCTY-06001 TRACT-    0059     IN OAKLAND CA,5293,5291,2,4748,1,5108,43.36
G06000100060,STCTY-06001 TRACT-    0060     IN OAKLAND CA,3419,3387,32,2964,16,4252,30.58
G06000100061,STCTY-06001 TRACT-    0061     IN OAKLAND CA,638,635,3,572,2,5750,0
G06000100062,STCTY-06001 TRACT-    0062     IN OAKLAND CA,5459,5448,11,4883,2,3682,31.59
G06000100063,STCTY-06001 TRACT-    0063     IN OAKLAND CA,5967,5928,39,5216,3,3657,33.4
G06000100064,STCTY-06001 TRACT-    0064     IN OAKLAND CA,4486,4440,46,3861,30,3616,32.85
G06000100065,STCTY-06001 TRACT-    0065     IN OAKLAND CA,5357,5305,52,4545,38,4085,34.33
G06000100066,STCTY-06001 TRACT-    0066     IN OAKLAND CA,4136,3987,149,3401,119,2504,25.93
G06000100067,STCTY-06001 TRACT-    0067     IN OAKLAND CA,686,653,33,486,0,2141,0
G06000100068,STCTY-06001 TRACT-    0068     IN OAKLAND CA,5383,5188,195,4229,165,2462,25.92
G06000100069,STCTY-06001 TRACT-    0069     IN OAKLAND CA,6277,6211,66,5352,45,3343,28.14
G06000100070,STCTY-06001 TRACT-    0070     IN OAKLAND CA,5127,5087,40,4404,11,3798,28.93
G06000100071,STCTY-06001 TRACT-    0071     IN OAKLAND CA,2072,2069,3,1838,0,4239,34.86
G06000100072,STCTY-06001 TRACT-    0072     IN OAKLAND CA,634,627,7,571,2,5735,0
G0600010AC0001,STCTY-06001 TRACT- AC 0001     IN OAKLAND-BERKELEY CA ADJ AREA,3503,3500,3,3101,3,4744,44.14
G0600010AC0002,STCTY-06001 TRACT- AC 0002     IN OAKLAND-BERKELEY CA ADJ AREA,2591,2587,4,2334,0,5006,45.62
G0600010AC0003,STCTY-06001 TRACT- AC 0003     IN OAKLAND-BERKELEY CA ADJ AREA,2054,2054,0,1752,0,4111,35.74
G0600010AC0004,STCTY-06001 TRACT- AC 0004     IN OAKLAND-BERKELEY CA ADJ AREA,1991,1980,11,1682,0,3692,34.22
G0600010AC0005,STCTY-06001 TRACT- AC 0005     IN OAKLAND-BERKELEY CA ADJ AREA,1354,1348,6,1141,1,3526,33.17
G0600010AC0006,STCTY-06001 TRACT- AC 0006     IN OAKLAND-BERKELEY CA ADJ AREA,2521,2448,73,2122,27,2494,26.38
G0600010AC0007,STCTY-06001 TRACT- AC 0007     IN OAKLAND-BERKELEY CA ADJ AREA,4967,4813,154,4443,49,13373,74.76
G0600010AC0008,STCTY-06001 TRACT- AC 0008     IN OAKLAND-BERKELEY CA ADJ AREA,4899,4863,36,4387,9,7172,60.89
G0600010AC0009,STCTY-06001 TRACT- AC 0009     IN OAKLAND-BERKELEY CA ADJ AREA,3396,3264,132,2921,8,6331,38.98
G0600010AC0010,STCTY-06001 TRACT- AC 0010     IN OAKLAND-BERKELEY CA ADJ AREA,6746,6034,712,5032,189,3234,27.4
G0600010AC0011,STCTY-06001 TRACT- AC 0011     IN OAKLAND-BERKELEY CA ADJ AREA,3598,3582,16,2969,1,3653,32.87
G0600010AC0012,STCTY-06001 TRACT- AC 0012     IN OAKLAND-BERKELEY CA ADJ AREA,4476,4458,18,3794,3,4280,32
G0600010AC0013,STCTY-06001 TRACT- AC 0013     IN OAKLAND-BERKELEY CA ADJ AREA,4421,4376,45,3868,20,5235,36.23
G0600010AC0014,STCTY-06001 TRACT- AC 0014     IN OAKLAND-BERKELEY CA ADJ AREA,4850,4716,134,4034,11,3885,30.93
G0600010AC0015,STCTY-06001 TRACT- AC 0015     IN OAKLAND-BERKELEY CA ADJ AREA,3878,3856,22,3318,13,4766,37.52
G0600010AC0016,STCTY-06001 TRACT- AC 0016     IN OAKLAND-BERKELEY CA ADJ AREA,4891,4839,52,4158,4,4148,32.98
G0600010AC0017,STCTY-06001 TRACT- AC 0017     IN OAKLAND-BERKELEY CA ADJ AREA,4027,4008,19,3349,0,4972,30.2
G0600010AC0018,STCTY-06001 TRACT- AC 0018     IN OAKLAND-BERKELEY CA ADJ AREA,6248,6238,10,5582,4,5473,39.88
G0600010AC0019,STCTY-06001 TRACT- AC 0019     IN OAKLAND-BERKELEY CA ADJ AREA,4326,4256,70,3276,1,3650,24.14
G0600130CCC0001,STCTY-06013 TRACT-CCC 0001     IN OAKLAND-BERKELEY CA ADJ AREA,2378,2378,0,2140,0,3921,40.85
G0600130CCC0002,STCTY-06013 TRACT-CCC 0002     IN OAKLAND-BERKELEY CA ADJ AREA,1580,1580,0,1431,0,3742,28.83
G0600130CCC0003,STCTY-06013 TRACT-CCC 0003     IN OAKLAND-BERKELEY CA ADJ AREA,3065,2805,260,2209,225,1868,17.97
G0600130CCC0004,STCTY-06013 TRACT-CCC 0004     IN OAKLAND-BERKELEY CA ADJ AREA,4298,4286,12,3638,2,2754,27.8
G0600130CCC0005,STCTY-06013 TRACT-CCC 0005     IN OAKLAND-BERKELEY CA ADJ AREA,3729,3715,14,3243,2,3674,29.9
G0600130CCC0006,STCTY-06013 TRACT-CCC 0006     IN OAKLAND-BERKELEY CA ADJ AREA,2683,2640,43,2180,5,3026,24.46
G0600130CCC0007,STCTY-06013 TRACT-CCC 0007     IN OAKLAND-BERKELEY CA ADJ AREA,4057,4013,44,3409,3,2651,25.11
G0600130CCC0008,STCTY-06013 TRACT-CCC 0008     IN OAKLAND-BERKELEY CA ADJ AREA,1852,1817,35,1516,33,2074,22.7
G0600130CCC0009,STCTY-06013 TRACT-CCC 0009     IN OAKLAND-BERKELEY CA ADJ AREA,1118,1032,86,935,2,5627,0
G0600130CCC0010,STCTY-06013 TRACT-CCC 0010     IN OAKLAND-BERKELEY CA ADJ AREA,1358,1336,22,1050,0,2260,22.83
G0600130CCC0011,STCTY-06013 TRACT-CCC 0011     IN OAKLAND-BERKELEY CA ADJ AREA,2112,2109,3,1831,0,3132,30.08
G0600130CCC0012,STCTY-06013 TRACT-CCC 0012     IN OAKLAND-BERKELEY CA ADJ AREA,1549,1549,0,1374,0,4420,0
G0600130CCC0013,STCTY-06013 TRACT-CCC 0013     IN OAKLAND-BERKELEY CA ADJ AREA,562,560,2,499,2,1850,0
G06003700001,STCTY-06037 TRACT-    0001     IN LOS ANGELES CA,4304,4069,235,3492,70,2176,21.21
G06003700002,STCTY-06037 TRACT-    0002     IN LOS ANGELES CA,2091,2064,27,1814,13,3325,17.38
G06003700003,STCTY-06037 TRACT-    0003     IN LOS ANGELES CA,1240,1196,44,1070,0,3058,0
G06003700004,STCTY-06037 TRACT-    0004     IN LOS ANGELES CA,7248,6919,329,5882,34,1862,19.14
G06003700005,STCTY-06037 TRACT-    0005     IN LOS ANGELES CA,1536,1525,11,1403,0,2654,25.4
G06003700006,STCTY-06037 TRACT-    0006     IN LOS ANGELES CA,864,789,75,696,2,3111,0
G06003700007,STCTY-06037 TRACT-    0007     IN LOS ANGELES CA,2925,2886,39,2616,0,2578,26.05
G06003700008,STCTY-06037 TRACT-    0008     IN LOS ANGELES CA,1106,1105,1,938,1,3500,19.21
G06003700009,STCTY-06037 TRACT-    0009     IN LOS ANGELES CA,2502,2414,88,2126,7,3500,25.01
G06003700010,STCTY-06037 TRACT-    0010     IN LOS ANGELES CA,4586,4439,147,4039,2,3276,26.03
G06003700011,STCTY-06037 TRACT-    0011     IN LOS ANGELES CA,734,728,6,661,0,3851,0
G06003700012,STCTY-06037 TRACT-    0012     IN LOS ANGELES CA,607,600,7,549,1,1615,0
G06003700013,STCTY-06037 TRACT-    0013     IN LOS ANGELES CA,732,697,35,620,2,3433,0
G06003700014,STCTY-06037 TRACT-    0014     IN LOS ANGELES CA,1784,1764,20,1505,3,2536,19.67
G06003700015,STCTY-06037 TRACT-    0015     IN LOS ANGELES CA,1992,1972,20,1725,1,3362,22.81
G06003700016,STCTY-06037 TRACT-    0016     IN LOS ANGELES CA,4147,4134,13,3787,4,3064,0
G06003700017,STCTY-06037 TRACT-    0017     IN LOS ANGELES CA,10298,10202,96,9174,12,3922,29.28
G06003700018,STCTY-06037 TRACT-    0018     IN LOS ANGELES CA,10000,9923,77,9154,19,4276,31.34
G06003700019,STCTY-06037 TRACT-    0019     IN LOS ANGELES CA,2692,2606,86,2316,11,3303,28.38
G06003700020,STCTY-06037 TRACT-    0020     IN LOS ANGELES CA,2077,2058,19,1864,4,4485,34.81
G06003700021,STCTY-06037 TRACT-    0021     IN LOS ANGELES CA,7925,7837,88,7255,16,4627,35.03
G06003700022,STCTY-06037 TRACT-    0022     IN LOS ANGELES CA,3596,3576,20,3183,1,3200,26.13
G06003700023,STCTY-06037 TRACT-    0023     IN LOS ANGELES CA,5762,5732,30,5250,21,5434,36.66
G06003700024,STCTY-06037 TRACT-    0024     IN LOS ANGELES CA,5089,5012,77,4554,60,5812,45.82
G06003700025,STCTY-06037 TRACT-    0025     IN LOS ANGELES CA,11441,11342,99,10126,67,5787,37.66
G06003700026,STCTY-06037 TRACT-    0026     IN LOS ANGELES CA,889,856,33,779,6,3052,0
G06003700027,STCTY-06037 TRACT-    0027     IN LOS ANGELES CA,1744,1722,22,1517,9,3924,27.45
G06003700028,STCTY-06037 TRACT-    0028     IN LOS ANGELES CA,1548,1499,49,1311,34,8506,28.7
G06003700029,STCTY-06037 TRACT-    0029     IN LOS ANGELES CA,5967,5926,41,5334,26,5047,36.84
G06003700030,STCTY-06037 TRACT-    0030     IN LOS ANGELES CA,2847,2793,54,2348,33,8497,47.34
G06003700031,STCTY-06037 TRACT-    0031     IN LOS ANGELES CA,8502,8341,161,7375,35,4611,36.86
G06003700032,STCTY-06037 TRACT-    0032     IN LOS ANGELES CA,7377,7191,186,6289,40,6778,41.01
G06003700033,STCTY-06037 TRACT-    0033     IN LOS ANGELES CA,5280,5268,12,4816,12,5360,41.52
G06003700034,STCTY-06037 TRACT-    0034     IN LOS ANGELES CA,5861,5856,5,5253,1,3913,32.01
G06003700035,STCTY-06037 TRACT-    0035     IN LOS ANGELES CA,5576,5565,11,5027,1,3601,30.98
G06003700036,STCTY-06037 TRACT-    0036     IN LOS ANGELES CA,6001,6000,1,5325,1,3738,30.39
G06003700037,STCTY-06037 TRACT-    0037     IN LOS ANGELES CA,2778,2770,8,2385,0,3120,25.46
G06003700038,STCTY-06037 TRACT-    0038     IN LOS ANGELES CA,5502,5476,26,4748,0,3224,28.51
G06003700039,STCTY-06037 TRACT-    0039     IN LOS ANGELES CA,5613,5594,19,4874,1,2833,23.88
G06003700040,STCTY-06037 TRACT-    0040     IN LOS ANGELES CA,3420,3417,3,3048,0,2711,25.68
G06003700041,STCTY-06037 TRACT-    0041     IN LOS ANGELES CA,5724,5717,7,5132,0,3226,27.57
G06003700042,STCTY-06037 TRACT-    0042     IN LOS ANGELES CA,6127,6101,26,5430,0,3384,28.89
G06003700043,STCTY-06037 TRACT-    0043     IN LOS ANGELES CA,4151,4147,4,3670,3,3639,28.4
G06003700044,STCTY-06037 TRACT-    0044     IN LOS ANGELES CA,5323,5313,10,4742,10,3307,28
G06003700045,STCTY-06037 TRACT-    0045     IN LOS ANGELES CA,4277,4277,0,3892,0,3412,29.19
G06003700046,STCTY-06037 TRACT-    0046     IN LOS ANGELES CA,3204,3202,2,2883,0,3337,23.64
G06003700047,STCTY-06037 TRACT-    0047     IN LOS ANGELES CA,3716,3684,32,3308,0,2743,22.95
G06003700048,STCTY-06037 TRACT-    0048     IN LOS ANGELES CA,7737,7328,409,6126,304,11482,39.85
G06003700049,STCTY-06037 TRACT-    0049     IN LOS ANGELES CA,688,665,23,560,8,4857,37.34
G06003700050,STCTY-06037 TRACT-    0050     IN LOS ANGELES CA,1133,1086,47,941,31,9263,0
G06003700051,STCTY-06037 TRACT-    0051     IN LOS ANGELES CA,5703,5490,213,4674,163,8968,52.8
G06003700052,STCTY-06037 TRACT-    0052     IN LOS ANGELES CA,7769,7624,145,6359,84,7877,42.99
G06003700053,STCTY-06037 TRACT-    0053     IN LOS ANGELES CA,6281,6237,44,5287,10,6625,39.31
G06003700054,STCTY-06037 TRACT-    0054     IN LOS ANGELES CA,5791,5673,118,4849,3,4791,36.01
G06003700055,STCTY-06037 TRACT-    0055     IN LOS ANGELES CA,6622,6554,68,5473,26,7560,44.46
G06003700056,STCTY-06037 TRACT-    0056     IN LOS ANGELES CA,6583,6380,203,5370,11,5411,38.62
G06003700057,STCTY-06037 TRACT-    0057     IN LOS ANGELES CA,5933,5874,59,5010,39,6642,47.37
G06003700058,STCTY-06037 TRACT-    0058     IN LOS ANGELES CA,8956,8828,128,7562,77,7332,37.69
G06003700059,STCTY-06037 TRACT-    0059     IN LOS ANGELES CA,2691,2639,52,2230,17,3437,30.13
G06003700060,STCTY-06037 TRACT-    0060     IN LOS ANGELES CA,5431,5414,17,4863,1,3588,32.46
G06003700061,STCTY-06037 TRACT-    0061     IN LOS ANGELES CA,6468,6461,7,5753,2,2939,27.11
G06003700062,STCTY-06037 TRACT-    0062     IN LOS ANGELES CA,4295,4226,69,3589,3,4339,31.74
G06003700063,STCTY-06037 TRACT-    0063     IN LOS ANGELES CA,6954,6916,38,5718,2,3670,29.17
G06003700064,STCTY-06037 TRACT-    0064     IN LOS ANGELES CA,6142,6116,26,5117,9,2678,25.95
G06003700065,STCTY-06037 TRACT-    0065     IN LOS ANGELES CA,4046,4040,6,3487,1,2829,28.83
G06003700066,STCTY-06037 TRACT-    0066     IN LOS ANGELES CA,3143,3131,12,2601,2,3040,28.49
G06003700067,STCTY-06037 TRACT-    0067     IN LOS ANGELES CA,4656,4601,55,3144,3,1922,15.98
G06003700068,STCTY-06037 TRACT-    0068     IN LOS ANGELES CA,5099,5098,1,4424,1,2907,24.39
G06003700069,STCTY-06037 TRACT-    0069     IN LOS ANGELES CA,5780,5582,198,4720,147,2500,22.18
G06003700070,STCTY-06037 TRACT-    0070     IN LOS ANGELES CA,2623,2587,36,2294,9,3303,25.64
G06003700071,STCTY-06037 TRACT-    0071     IN LOS ANGELES CA,7666,7567,99,6413,54,2708,23.8
G06003700072,STCTY-06037 TRACT-    0072     IN LOS ANGELES CA,6569,6513,56,5086,26,3222,24.37
G06003700073,STCTY-06037 TRACT-    0073     IN LOS ANGELES CA,3120,3112,8,2623,4,1966,22.87
G06003700074,STCTY-06037 TRACT-    0074     IN LOS ANGELES CA,4649,4631,18,4021,10,3083,24.88
G06003700075,STCTY-06037 TRACT-    0075     IN LOS ANGELES CA,1506,1506,0,1356,0,3114,28.36
G06003700076,STCTY-06037 TRACT-    0076     IN LOS ANGELES CA,7880,7849,31,6700,21,5995,45.2
G06003700077,STCTY-06037 TRACT-    0077     IN LOS ANGELES CA,4759,4746,13,3987,8,4548,42.79
G06003700078,STCTY-06037 TRACT-    0078     IN LOS ANGELES CA,7132,7082,50,6091,26,5656,39.14
G06003700079,STCTY-06037 TRACT-    0079     IN LOS ANGELES CA,11203,11100,103,9490,67,6450,53.33
G06003700080,STCTY-06037 TRACT-    0080     IN LOS ANGELES CA,7361,7271,90,5985,66,9549,45.61
G06003700081,STCTY-06037 TRACT-    0081     IN LOS ANGELES CA,6861,6824,37,4688,35,8000,43.91
G06003700082,STCTY-06037 TRACT-    0082     IN LOS ANGELES CA,6836,6625,211,5599,172,11070,66.41
G06003700083,STCTY-06037 TRACT-    0083     IN LOS ANGELES CA,4562,4337,225,3703,3,5208,35.03
G06003700084,STCTY-06037 TRACT-    0084     IN LOS ANGELES CA,6545,6352,193,5390,13,4333,32.94
G06003700085,STCTY-06037 TRACT-    0085     IN LOS ANGELES CA,4789,4774,15,4035,1,4043,34.85
G06003700086,STCTY-06037 TRACT-    0086     IN LOS ANGELES CA,6235,6219,16,5316,2,4283,34.42
G06003700087,STCTY-06037 TRACT-    0087     IN LOS ANGELES CA,4196,3668,528,3115,239,2689,29.26
G06003700088,STCTY-06037 TRACT-    0088     IN LOS ANGELES CA,4678,4545,133,4017,1,3395,29.83
G06003700089,STCTY-06037 TRACT-    0089     IN LOS ANGELES CA,5210,5182,28,4405,8,4076,31.77
G06003700090,STCTY-06037 TRACT-    0090     IN LOS ANGELES CA,4622,4598,24,3908,0,4549,33.54
G06003700091,STCTY-06037 TRACT-    0091     IN LOS ANGELES CA,2730,2726,4,2369,1,6134,35.43
G06003700092,STCTY-06037 TRACT-    0092     IN LOS ANGELES CA,4182,4164,18,3636,4,2794,31.1
G06003700093,STCTY-06037 TRACT-    0093     IN LOS ANGELES CA,2200,2180,20,1890,14,6450,64.73
G06003700094,STCTY-06037 TRACT-    0094     IN LOS ANGELES CA,5408,5351,57,4625,15,5451,39.18
G06003700095,STCTY-06037 TRACT-    0095     IN LOS ANGELES CA,3765,3748,17,3253,0,4892,37.56
G06003700096,STCTY-06037 TRACT-    0096     IN LOS ANGELES CA,4362,4347,15,3822,5,4500,35.34
G06003700097,STCTY-06037 TRACT-    0097     IN LOS ANGELES CA,2522,1594,928,1359,101,1994,27.17
G06003700098,STCTY-06037 TRACT-    0098     IN LOS ANGELES CA,2635,2489,146,2168,107,14802,76.71
G06003700099,STCTY-06037 TRACT-    0099     IN LOS ANGELES CA,7918,7738,180,6839,116,8959,46.34
G06003700100,STCTY-06037 TRACT-    0100     IN LOS ANGELES CA,6884,6809,75,6015,35,7097,44
G06003700101,STCTY-06037 TRACT-    0101     IN LOS ANGELES CA,11670,11594,76,9874,14,5300,41.45
G06003700102,STCTY-06037 TRACT-    0102     IN LOS ANGELES CA,3289,3252,37,2861,6,9375,37.59
G06003700103,STCTY-06037 TRACT-    0103     IN LOS ANGELES CA,5280,5175,105,4444,7,3567,31.29
G06003700104,STCTY-06037 TRACT-    0104     IN LOS ANGELES CA,5832,5799,33,4825,7,3584,32.42
G06003700105,STCTY-06037 TRACT-    0105     IN LOS ANGELES CA,5911,5572,339,4687,243,2872,25.39
G06003700106,STCTY-06037 TRACT-    0106     IN LOS ANGELES CA,3573,2926,647,2551,511,4394,33.99
G06003700107,STCTY-06037 TRACT-    0107     IN LOS ANGELES CA,5062,4467,595,3825,467,3377,26.62
G06003700108,STCTY-06037 TRACT-    0108     IN LOS ANGELES CA,4826,4710,116,4099,16,3219,22.64
G06003700109,STCTY-06037 TRACT-    0109     IN LOS ANGELES CA,2666,2637,29,2257,13,0,29.9
G06003700110,STCTY-06037 TRACT-    0110     IN LOS ANGELES CA,8859,8786,73,7325,13,4477,28.2
G06003700111,STCTY-06037 TRACT-    0111     IN LOS ANGELES CA,6568,6551,17,5775,2,0,26.34
G06003700112,STCTY-06037 TRACT-    0112     IN LOS ANGELES CA,7866,7778,88,6688,5,0,23.3
G06003700113,STCTY-06037 TRACT-    0113     IN LOS ANGELES CA,7186,6673,513,5257,12,2337,19
G06003700114,STCTY-06037 TRACT-    0114     IN LOS ANGELES CA,3938,3918,20,3244,0,3254,25.22
G06003700115,STCTY-06037 TRACT-    0115     IN LOS ANGELES CA,7659,7369,290,5131,2,3005,23.58
G06003700116,STCTY-06037 TRACT-    0116     IN LOS ANGELES CA,5514,4774,740,2836,9,3048,16.84
G06003700117,STCTY-06037 TRACT-    0117     IN LOS ANGELES CA,6769,5550,1219,4173,227,0,11.86
G06003700118,STCTY-06037 TRACT-    0118     IN LOS ANGELES CA,4035,3606,429,2362,17,0,14.42
G06003700119,STCTY-06037 TRACT-    0119     IN LOS ANGELES CA,3074,2738,336,1916,55,0,16.28
G06003700120,STCTY-06037 TRACT-    0120     IN LOS ANGELES CA,5792,5760,32,4145,9,2524,20.1
G06003700121,STCTY-06037 TRACT-    0121     IN LOS ANGELES CA,3766,3605,161,2473,7,2411,17.01
G06003700122,STCTY-06037 TRACT-    0122     IN LOS ANGELES CA,7051,6651,400,4598,12,2399,19.4
G06003700123,STCTY-06037 TRACT-    0123     IN LOS ANGELES CA,3250,3183,67,2580,45,2873,22.33
G06003700124,STCTY-06037 TRACT-    0124     IN LOS ANGELES CA,5173,5149,24,3412,8,2735,23.79
G06003700125,STCTY-06037 TRACT-    0125     IN LOS ANGELES CA,5392,5252,140,3623,10,2670,21
G06003700126,STCTY-06037 TRACT-    0126     IN LOS ANGELES CA,5567,5557,10,3078,3,2716,28.3
G06003700127,STCTY-06037 TRACT-    0127     IN LOS ANGELES CA,9041,8690,351,4708,216,2781,29.38
G06003700128,STCTY-06037 TRACT-    0128     IN LOS ANGELES CA,5378,4882,496,2796,13,3338,26.45
G06003700129,STCTY-06037 TRACT-    0129     IN LOS ANGELES CA,7556,5591,1965,3454,305,2714,25.35
G06003700130,STCTY-06037 TRACT-    0130     IN LOS ANGELES CA,7592,6424,1168,4753,63,2498,23.19
G06003700131,STCTY-06037 TRACT-    0131     IN LOS ANGELES CA,4076,3855,221,2724,8,2945,24.33
G06003700132,STCTY-06037 TRACT-    0132     IN LOS ANGELES CA,5876,5633,243,4343,5,2681,22.65
G06003700133,STCTY-06037 TRACT-    0133     IN LOS ANGELES CA,6251,5996,255,4836,2,3031,24.38
G06003700134,STCTY-06037 TRACT-    0134     IN LOS ANGELES CA,4233,4206,27,3543,4,2574,24
G06003700135,STCTY-06037 TRACT-    0135     IN LOS ANGELES CA,2387,2371,16,1966,1,2404,34.56
G06003700136,STCTY-06037 TRACT-    0136     IN LOS ANGELES CA,1844,1833,11,1598,2,3165,25
G06003700137,STCTY-06037 TRACT-    0137     IN LOS ANGELES CA,8373,8371,2,7568,1,3677,30.59
G06003700138,STCTY-06037 TRACT-    0138     IN LOS ANGELES CA,11831,11518,313,10501,264,11339,60.04
G06003700139,STCTY-06037 TRACT-    0139     IN LOS ANGELES CA,10166,10152,14,9245,8,5735,47.37
G06003700140,STCTY-06037 TRACT-    0140     IN LOS ANGELES CA,6444,6335,109,5629,71,6113,31.97
G06003700141,STCTY-06037 TRACT-    0141     IN LOS ANGELES CA,3545,3464,81,3172,9,2540,26.89
G06003700142,STCTY-06037 TRACT-    0142     IN LOS ANGELES CA,4468,4178,290,3805,9,3117,26.56
G06003700143,STCTY-06037 TRACT-    0143     IN LOS ANGELES CA,6578,5451,1127,4894,24,1936,20.07
G06003700144,STCTY-06037 TRACT-    0144     IN LOS ANGELES CA,11393,11291,102,10284,4,3780,32.85
G06003700145,STCTY-06037 TRACT-    0145     IN LOS ANGELES CA,7099,7014,85,6361,39,7028,52.93
G06003700146,STCTY-06037 TRACT-    0146     IN LOS ANGELES CA,6554,6544,10,5830,4,4586,37.38
G06003700147,STCTY-06037 TRACT-    0147     IN LOS ANGELES CA,5007,5001,6,4484,3,3694,31.93
G06003700148,STCTY-06037 TRACT-    0148     IN LOS ANGELES CA,4824,4765,59,4061,34,7989,55.18
G06003700149,STCTY-06037 TRACT-    0149     IN LOS ANGELES CA,4445,4395,50,3808,38,7162,54.39
G06003700150,STCTY-06037 TRACT-    0150     IN LOS ANGELES CA,3135,3104,31,2696,25,7114,54.61
G06003700151,STCTY-06037 TRACT-    0151     IN LOS ANGELES CA,7455,7381,74,6217,62,6942,58.43
G06003700152,STCTY-06037 TRACT-    0152     IN LOS ANGELES CA,4705,4684,21,3956,7,5763,50.75
G06003700153,STCTY-06037 TRACT-    0153     IN LOS ANGELES CA,4270,4253,17,3626,7,5125,43.7
G06003700154,STCTY-06037 TRACT-    0154     IN LOS ANGELES CA,3370,3362,8,2772,5,4695,45.78
G06003700155,STCTY-06037 TRACT-    0155     IN LOS ANGELES CA,8044,8028,16,6809,13,5702,46.62
G06003700156,STCTY-06037 TRACT-    0156     IN LOS ANGELES CA,2757,2755,2,2281,2,4576,37.63
G06003700157,STCTY-06037 TRACT-    0157     IN LOS ANGELES CA,4993,4965,28,4317,20,4524,33.66
G06003700158,STCTY-06037 TRACT-    0158     IN LOS ANGELES CA,6732,6727,5,5435,2,3922,36.56
G06003700159,STCTY-06037 TRACT-    0159     IN LOS ANGELES CA,4219,4213,6,3282,0,4101,35.62
G06003700160,STCTY-06037 TRACT-    0160     IN LOS ANGELES CA,4194,4088,106,3552,70,7374,57.66
G06003700161,STCTY-06037 TRACT-    0161     IN LOS ANGELES CA,6093,6070,23,5182,9,5584,39.79
G06003700162,STCTY-06037 TRACT-    0162     IN LOS ANGELES CA,5606,5582,24,4832,4,5202,34.98
G06003700163,STCTY-06037 TRACT-    0163     IN LOS ANGELES CA,1908,1852,56,1646,18,8272,39.76
G06003700164,STCTY-06037 TRACT-    0164     IN LOS ANGELES CA,5810,5729,81,5055,29,8376,47.67
G06003700165,STCTY-06037 TRACT-    0165     IN LOS ANGELES CA,8452,8364,88,7182,23,6534,37.95
G06003700166,STCTY-06037 TRACT-    0166     IN LOS ANGELES CA,5814,4685,1129,4007,219,2993,26.94
G06003700167,STCTY-06037 TRACT-    0167     IN LOS ANGELES CA,5209,4158,1051,3553,158,3135,24.1
G06003700168,STCTY-06037 TRACT-    0168     IN LOS ANGELES CA,4589,4556,33,4050,13,5478,34.77
G06003700169,STCTY-06037 TRACT-    0169     IN LOS ANGELES CA,5345,5269,76,4576,47,3747,26.64
G06003700170,STCTY-06037 TRACT-    0170     IN LOS ANGELES CA,8683,8609,74,7634,19,5479,28.78
G06003700171,STCTY-06037 TRACT-    0171     IN LOS ANGELES CA,4045,3995,50,3483,8,3413,24.1
G06003700172,STCTY-06037 TRACT-    0172     IN LOS ANGELES CA,5802,5677,125,4828,7,1464,22.04
G06003700173,STCTY-06037 TRACT-    0173     IN LOS ANGELES CA,5592,5530,62,4685,4,0,16.95
G06003700174,STCTY-06037 TRACT-    0174     IN LOS ANGELES CA,4359,4339,20,3696,8,4607,24.06
G06003700175,STCTY-06037 TRACT-    0175     IN LOS ANGELES CA,5561,5488,73,4860,7,0,20.8
G06003700176,STCTY-06037 TRACT-    0176     IN LOS ANGELES CA,3487,3446,41,3020,1,3059,23.37
G06003700177,STCTY-06037 TRACT-    0177     IN LOS ANGELES CA,3624,3578,46,3217,8,0,20.41
G06003700178,STCTY-06037 TRACT-    0178     IN LOS ANGELES CA,3611,3580,31,3125,1,3433,23.28
G06003700179,STCTY-06037 TRACT-    0179     IN LOS ANGELES CA,5930,5872,58,5125,3,3518,21.4
G06003700180,STCTY-06037 TRACT-    0180     IN LOS ANGELES CA,3780,3574,206,2828,0,0,12.91
G06003700181,STCTY-06037 TRACT-    0181     IN LOS ANGELES CA,5350,5254,96,4299,0,0,14.66
G06003700182,STCTY-06037 TRACT-    0182     IN LOS ANGELES CA,4752,4642,110,3886,3,0,15.98
G06003700183,STCTY-06037 TRACT-    0183     IN LOS ANGELES CA,4226,4195,31,3641,6,0,22.8
G06003700184,STCTY-06037 TRACT-    0184     IN LOS ANGELES CA,3686,3622,64,3100,0,0,14.15
G06003700185,STCTY-06037 TRACT-    0185     IN LOS ANGELES CA,5177,4554,623,3706,61,0,11.44
G06003700186,STCTY-06037 TRACT-    0186     IN LOS ANGELES CA,5031,3559,1472,2692,26,0,10.89
G06003700187,STCTY-06037 TRACT-    0187     IN LOS ANGELES CA,6479,5456,1023,4270,415,0,8.94
G06003700188,STCTY-06037 TRACT-    0188     IN LOS ANGELES CA,4548,3737,811,2903,150,0,10.37
G06003700189,STCTY-06037 TRACT-    0189     IN LOS ANGELES CA,3492,1856,1636,1341,378,0,14.29
G06003700190,STCTY-06037 TRACT-    0190     IN LOS ANGELES CA,2468,2459,9,2215,1,3192,31.2
G06003700191,STCTY-06037 TRACT-    0191     IN LOS ANGELES CA,7741,7335,406,6623,330,2485,25.05
G06003700192,STCTY-06037 TRACT-    0192     IN LOS ANGELES CA,7963,7906,57,6102,7,3118,23.58
G06003700193,STCTY-06037 TRACT-    0193     IN LOS ANGELES CA,4364,4329,35,3932,1,2928,23.88
G06003700194,STCTY-06037 TRACT-    0194     IN LOS ANGELES CA,727,712,15,668,1,0,23.16
G06003700195,STCTY-06037 TRACT-    0195     IN LOS ANGELES CA,593,583,10,536,6,8385,0
G06003700196,STCTY-06037 TRACT-    0196     IN LOS ANGELES CA,2999,2831,168,2442,0,2938,26.65
G06003700197,STCTY-06037 TRACT-    0197     IN LOS ANGELES CA,5518,5495,23,4621,1,2988,30.4
G06003700198,STCTY-06037 TRACT-    0198     IN LOS ANGELES CA,2650,2649,1,2088,0,3524,33.56
G06003700199,STCTY-06037 TRACT-    0199     IN LOS ANGELES CA,5678,5674,4,3948,2,4481,36.37
G06003700200,STCTY-06037 TRACT-    0200     IN LOS ANGELES CA,3152,3151,1,2402,1,3858,33.4
G06003700201,STCTY-06037 TRACT-    0201     IN LOS ANGELES CA,8737,8665,72,7383,28,5420,36.15
G06003700202,STCTY-06037 TRACT-    0202     IN LOS ANGELES CA,6167,6126,41,5088,3,3408,31.93
G06003700203,STCTY-06037 TRACT-    0203     IN LOS ANGELES CA,2644,2542,102,2130,61,5863,31.3
G06003700204,STCTY-06037 TRACT-    0204     IN LOS ANGELES CA,2866,1214,1652,905,948,3657,33.46
G06003700205,STCTY-06037 TRACT-    0205     IN LOS ANGELES CA,3414,2391,1023,1898,808,3277,28.29
G06003700206,STCTY-06037 TRACT-    0206     IN LOS ANGELES CA,3950,3950,0,3369,0,3453,32.38
G06003700207,STCTY-06037 TRACT-    0207     IN LOS ANGELES CA,9345,9331,14,8221,9,6235,44.78
G06003700208,STCTY-06037 TRACT-    0208     IN LOS ANGELES CA,3399,3355,44,2945,16,5221,27.44
G06003700209,STCTY-06037 TRACT-    0209     IN LOS ANGELES CA,4829,4621,208,3885,78,3025,26.31
G06003700210,STCTY-06037 TRACT-    0210     IN LOS ANGELES CA,4446,4334,112,3708,62,2902,24.5
G06003700211,STCTY-06037 TRACT-    0211     IN LOS ANGELES CA,2896,2880,16,2485,1,3703,28.2
G06003700212,STCTY-06037 TRACT-    0212     IN LOS ANGELES CA,3670,3651,19,3208,11,5311,27.95
G06003700213,STCTY-06037 TRACT-    0213     IN LOS ANGELES CA,5920,5803,117,4951,40,3445,27.52
G06003700214,STCTY-06037 TRACT-    0214     IN LOS ANGELES CA,3724,474,3250,347,2174,3248,28.55
G06003700215,STCTY-06037 TRACT-    0215     IN LOS ANGELES CA,3904,2232,1672,1938,1109,3496,24.82
G06003700216,STCTY-06037 TRACT-    0216     IN LOS ANGELES CA,2828,2691,137,2352,20,3591,22.65
G06003700217,STCTY-06037 TRACT-    0217     IN LOS ANGELES CA,4237,4230,7,3710,1,3529,30.29
G06003700218,STCTY-06037 TRACT-    0218     IN LOS ANGELES CA,5799,5765,34,5148,10,3171,29.05
G06003700219,STCTY-06037 TRACT-    0219     IN LOS ANGELES CA,7527,7438,89,6450,27,3943,24.37
G06003700220,STCTY-06037 TRACT-    0220     IN LOS ANGELES CA,4806,4718,88,4104,6,0,16.39
G06003700221,STCTY-06037 TRACT-    0221     IN LOS ANGELES CA,4292,4227,65,3602,3,2673,19
G06003700222,STCTY-06037 TRACT-    0222     IN LOS ANGELES CA,5183,5104,79,4376,24,2728,19.63
G06003700223,STCTY-06037 TRACT-    0223     IN LOS ANGELES CA,7032,5012,2020,3633,1381,2929,18.85
G06003700224,STCTY-06037 TRACT-    0224     IN LOS ANGELES CA,4042,1571,2471,1131,2385,3100,19.61
G06003700225,STCTY-06037 TRACT-    0225     IN LOS ANGELES CA,5895,2962,2933,2151,2161,3007,23.11
G06003700226,STCTY-06037 TRACT-    0226     IN LOS ANGELES CA,6429,806,5623,525,5575,2337,23.05
G06003700227,STCTY-06037 TRACT-    0227     IN LOS ANGELES CA,4938,2077,2861,1474,2657,3248,23.38
G06003700228,STCTY-06037 TRACT-    0228     IN LOS ANGELES CA,4965,4962,3,4394,0,4559,34.55
G06003700229,STCTY-06037 TRACT-    0229     IN LOS ANGELES CA,6603,6593,10,5818,1,4301,37.9
G06003700230,STCTY-06037 TRACT-    0230     IN LOS ANGELES CA,353,334,19,317,0,0,0
G06003700231,STCTY-06037 TRACT-    0231     IN LOS ANGELES CA,5316,5316,0,4679,0,4315,37.37
G06003700232,STCTY-06037 TRACT-    0232     IN LOS ANGELES CA,5991,5987,4,5259,1,3656,32.07
G06003700233,STCTY-06037 TRACT-    0233     IN LOS ANGELES CA,4755,4734,21,4206,0,4451,35.96
G06003700234,STCTY-06037 TRACT-    0234     IN LOS ANGELES CA,4319,4292,27,3712,2,4392,38.02
G06003700235,STCTY-06037 TRACT-    0235     IN LOS ANGELES CA,5467,5450,17,4844,1,4332,30.75
G06003700236,STCTY-06037 TRACT-    0236     IN LOS ANGELES CA,5428,5409,19,4728,0,2892,29.18
G06003700237,STCTY-06037 TRACT-    0237     IN LOS ANGELES CA,5916,5898,18,5192,1,3703,31.87
G06003700238,STCTY-06037 TRACT-    0238     IN LOS ANGELES CA,6113,6102,11,5375,3,3797,32.88
G06003700239,STCTY-06037 TRACT-    0239     IN LOS ANGELES CA,4910,4890,20,4150,0,3389,28.56
G06003700240,STCTY-06037 TRACT-    0240     IN LOS ANGELES CA,3845,3842,3,3371,0,3386,33.01
G06003700241,STCTY-06037 TRACT-    0241     IN LOS ANGELES CA,4796,4781,15,4135,2,3504,32.1
G06003700242,STCTY-06037 TRACT-    0242     IN LOS ANGELES CA,3782,3763,19,3175,1,3188,29.35
G06003700243,STCTY-06037 TRACT-    0243     IN LOS ANGELES CA,3838,3808,30,3284,3,3135,26.79
G06003700244,STCTY-06037 TRACT-    0244     IN LOS ANGELES CA,4884,4836,48,4167,0,3202,26.16
G06003700245,STCTY-06037 TRACT-    0245     IN LOS ANGELES CA,5221,5181,40,4396,18,3433,26.4
G06003700246,STCTY-06037 TRACT-    0246     IN LOS ANGELES CA,4037,3948,89,3379,47,3294,26.88
G06003700247,STCTY-06037 TRACT-    0247     IN LOS ANGELES CA,6097,5481,616,4500,510,2611,22.73
G06003700248,STCTY-06037 TRACT-    0248     IN LOS ANGELES CA,5218,1981,3237,1495,3167,2857,24.21
G06003700249,STCTY-06037 TRACT-    0249     IN LOS ANGELES CA,6403,2856,3547,2200,3441,2706,26.01
G06003700250,STCTY-06037 TRACT-    0250     IN LOS ANGELES CA,5898,3391,2507,2758,2460,3318,24.92
G06003700251,STCTY-06037 TRACT-    0251     IN LOS ANGELES CA,5339,2943,2396,2510,2341,2800,23.17
G06003700252,STCTY-06037 TRACT-    0252     IN LOS ANGELES CA,4759,284,4475,188,4447,2753,26.66
G06003700253,STCTY-06037 TRACT-    0253     IN LOS ANGELES CA,4934,2185,2749,1611,2739,2067,20.82
G06003700254,STCTY-06037 TRACT-    0254     IN LOS ANGELES CA,5531,504,5027,342,4979,2730,25.29
G06003700255,STCTY-06037 TRACT-    0255     IN LOS ANGELES CA,3636,839,2797,614,2766,2276,21.85
G06003700256,STCTY-06037 TRACT-    0256     IN LOS ANGELES CA,5090,1489,3601,1131,3568,2573,22.57
G06003700257,STCTY-06037 TRACT-    0257     IN LOS ANGELES CA,4803,4794,9,4282,0,3138,30.13
G06003700258,STCTY-06037 TRACT-    0258     IN LOS ANGELES CA,6166,6152,14,5407,7,3448,28.31
G06003700259,STCTY-06037 TRACT-    0259     IN LOS ANGELES CA,5156,5156,0,4661,0,3877,36.55
G06003700260,STCTY-06037 TRACT-    0260     IN LOS ANGELES CA,6357,6348,9,5522,1,3336,31.86
G06003700261,STCTY-06037 TRACT-    0261     IN LOS ANGELES CA,7053,7026,27,6133,3,2791,26.83
G06003700262,STCTY-06037 TRACT-    0262     IN LOS ANGELES CA,3490,3489,1,3102,0,4735,43.73
G06003700263,STCTY-06037 TRACT-    0263     IN LOS ANGELES CA,3517,3514,3,3101,0,3996,36.63
G06003700264,STCTY-06037 TRACT-    0264     IN LOS ANGELES CA,4931,4931,0,4355,0,2847,26.94
G06003700265,STCTY-06037 TRACT-    0265     IN LOS ANGELES CA,3722,3722,0,3370,0,4571,40.88
G06003700266,STCTY-06037 TRACT-    0266     IN LOS ANGELES CA,4286,4282,4,3724,2,4741,35.87
G06003700267,STCTY-06037 TRACT-    0267     IN LOS ANGELES CA,5468,5456,12,4805,0,3333,27.52
G06003700268,STCTY-06037 TRACT-    0268     IN LOS ANGELES CA,2828,2816,12,2398,0,2790,24.45
G06003700269,STCTY-06037 TRACT-    0269     IN LOS ANGELES CA,1505,1504,1,1327,1,2313,23.25
G06003700270,STCTY-06037 TRACT-    0270     IN LOS ANGELES CA,4508,4506,2,3916,0,2936,25.66
G06003700271,STCTY-06037 TRACT-    0271     IN LOS ANGELES CA,2328,2328,0,2074,0,2342,25.38
G06003700272,STCTY-06037 TRACT-    0272     IN LOS ANGELES CA,3639,3631,8,3172,1,2524,25.19
G06003700273,STCTY-06037 TRACT-    0273     IN LOS ANGELES CA,4261,4255,6,3662,0,3152,28.38
G06003700274,STCTY-06037 TRACT-    0274     IN LOS ANGELES CA,3698,3691,7,3198,1,2809,26.16
G06003700275,STCTY-06037 TRACT-    0275     IN LOS ANGELES CA,4747,4735,12,4121,0,3122,28.17
G06003700276,STCTY-06037 TRACT-    0276     IN LOS ANGELES CA,5390,5382,8,4849,1,4821,39.06
G06003700277,STCTY-06037 TRACT-    0277     IN LOS ANGELES CA,6221,6212,9,5540,1,3271,27.8
G06003700278,STCTY-06037 TRACT-    0278     IN LOS ANGELES CA,4072,4065,7,3614,1,4247,33.64
G06003700279,STCTY-06037 TRACT-    0279     IN LOS ANGELES CA,4544,4528,16,3928,2,2967,26.03
G06003700280,STCTY-06037 TRACT-    0280     IN LOS ANGELES CA,8162,8103,59,7367,48,2572,25.51
G06003700281,STCTY-06037 TRACT-    0281     IN LOS ANGELES CA,4130,4128,2,3705,1,2622,26.11
G06003700282,STCTY-06037 TRACT-    0282     IN LOS ANGELES CA,5566,5549,17,4968,0,2491,25.74
G06003700283,STCTY-06037 TRACT-    0283     IN LOS ANGELES CA,4425,4417,8,4128,2,2228,24.57
G06003700284,STCTY-06037 TRACT-    0284     IN LOS ANGELES CA,4330,4223,107,3888,69,2500,26.31
G06003700285,STCTY-06037 TRACT-    0285     IN LOS ANGELES CA,5685,4893,792,4165,730,1920,20.7
G06003700286,STCTY-06037 TRACT-    0286     IN LOS ANGELES CA,5618,2558,3060,1879,2948,1883,18.15
G06003700287,STCTY-06037 TRACT-    0287     IN LOS ANGELES CA,5652,3999,1653,2956,1610,1611,17.08
G06003700288,STCTY-06037 TRACT-    0288     IN LOS ANGELES CA,2103,1931,172,1755,2,3246,24.45
G06003700289,STCTY-06037 TRACT-    0289     IN LOS ANGELES CA,2614,2485,129,2246,0,2673,22.87
G06003700290,STCTY-06037 TRACT-    0290     IN LOS ANGELES CA,5393,5010,383,4472,6,2893,23.61
G06003700291,STCTY-06037 TRACT-    0291     IN LOS ANGELES CA,5051,5033,18,4620,2,3222,29.03
G06003700292,STCTY-06037 TRACT-    0292     IN LOS ANGELES CA,5214,4963,251,4179,108,2342,20.92
G06003700293,STCTY-06037 TRACT-    0293     IN LOS ANGELES CA,1968,1889,79,1578,16,0,17.99
G06003700294,STCTY-06037 TRACT-    0294     IN LOS ANGELES CA,3831,1534,2297,1217,44,0,15.9
G06003700295,STCTY-06037 TRACT-    0295     IN LOS ANGELES CA,5293,5124,169,4208,78,3015,21.94
G06003700296,STCTY-06037 TRACT-    0296     IN LOS ANGELES CA,4510,4202,308,3110,120,1931,16.89
G06003700297,STCTY-06037 TRACT-    0297     IN LOS ANGELES CA,3941,3826,115,2894,36,2943,24.66
G06003700298,STCTY-06037 TRACT-    0298     IN LOS ANGELES CA,7985,7899,86,6352,24,3830,30.62
G06003700299,STCTY-06037 TRACT-    0299     IN LOS ANGELES CA,5255,5093,162,3553,22,3475,22.99
G06003700300,STCTY-06037 TRACT-    0300     IN LOS ANGELES CA,5388,5307,81,4462,2,3610,27.39
G06003700301,STCTY-06037 TRACT-    0301     IN LOS ANGELES CA,5693,5596,97,5153,80,3577,30.67
G06003700303,STCTY-06037 TRACT-    0303     IN LONG BEACH CA,2282,2166,116,1991,2,1711,18.26
G06003700304,STCTY-06037 TRACT-    0304     IN LONG BEACH CA,3040,2958,82,2665,31,3069,27.75
G06003700305,STCTY-06037 TRACT-    0305     IN LONG BEACH CA,3712,3624,88,3350,75,3283,25.72
G06003700306,STCTY-06037 TRACT-    0306     IN LONG BEACH CA,5798,5644,154,5088,142,3092,23.96
G06003700307,STCTY-06037 TRACT-    0307     IN LONG BEACH CA,5906,5837,69,5311,5,3747,25.54
G06003700308,STCTY-06037 TRACT-    0308     IN LONG BEACH CA,6664,6639,25,5955,0,2862,23.75
G06003700309,STCTY-06037 TRACT-    0309     IN LONG BEACH CA,4191,4150,41,3723,5,3742,23.24
G06003700310,STCTY-06037 TRACT-    0310     IN LONG BEACH CA,4673,4655,18,4107,0,3462,24.99
G06003700311,STCTY-06037 TRACT-    0311     IN LONG BEACH CA,2931,2898,33,2572,0,0,27.95
G06003700312,STCTY-06037 TRACT-    0312     IN LONG BEACH CA,5314,5281,33,4742,3,5532,34
G06003700313,STCTY-06037 TRACT-    0313     IN LONG BEACH CA,6839,6812,27,6246,2,3496,27.16
G06003700314,STCTY-06037 TRACT-    0314     IN LONG BEACH CA,6469,6338,131,5886,103,3314,25.43
G06003700315,STCTY-06037 TRACT-    0315     IN LONG BEACH CA,6456,6424,32,5995,0,3520,25.9
G06003700316,STCTY-06037 TRACT-    0316     IN LONG BEACH CA,5504,5470,34,5055,2,4096,31.51
G06003700317,STCTY-06037 TRACT-    0317     IN LONG BEACH CA,2923,2913,10,2696,4,5527,36.47
G06003700318,STCTY-06037 TRACT-    0318     IN LONG BEACH CA,3680,3672,8,3370,3,5561,35.9
G06003700319,STCTY-06037 TRACT-    0319     IN LONG BEACH CA,9027,9000,27,8281,6,4525,40.92
G06003700320,STCTY-06037 TRACT-    0320     IN LONG BEACH CA,5957,5954,3,5496,1,3920,32.13
G06003700321,STCTY-06037 TRACT-    0321     IN LONG BEACH CA,6926,6896,30,6391,5,4615,31.21
G06003700322,STCTY-06037 TRACT-    0322     IN LONG BEACH CA,2181,2138,43,1972,16,3217,24.12
G06003700323,STCTY-06037 TRACT-    0323     IN LONG BEACH CA,5847,5830,17,5488,0,2651,22.74
G06003700324,STCTY-06037 TRACT-    0324     IN LONG BEACH CA,6040,5993,47,5646,27,2745,23.52
G06003700325,STCTY-06037 TRACT-    0325     IN LONG BEACH CA,3534,3413,121,3207,86,2027,21.49
G06003700326,STCTY-06037 TRACT-    0326     IN LONG BEACH CA,6730,6650,80,6205,34,3000,26.79
G06003700327,STCTY-06037 TRACT-    0327     IN LONG BEACH CA,13303,13042,261,12040,48,3834,33.05
G06003700328,STCTY-06037 TRACT-    0328     IN LONG BEACH CA,4347,4326,21,4095,0,5008,43.03
G06003700329,STCTY-06037 TRACT-    0329     IN LONG BEACH CA,11677,11591,86,10895,10,2945,26.05
G06003700330,STCTY-06037 TRACT-    0330     IN LONG BEACH CA,10958,10911,47,10397,0,3139,31.04
G06003700331,STCTY-06037 TRACT- 0331   IN LOS ANGELES-LONG BEACH CA ADJ AREA,1109,1086,23,866,13,2750,25.53
G06003700332A,STCTY-06037 TRACT- 0332-A IN LOS ANGELES-LONG BEACH CA ADJ AREA,1820,1749,71,1580,0,5610,25.68
G06003700332B,STCTY-06037 TRACT-    0332-B   IN LONG BEACH CA,0,0,0,0,0,0,0
G06003700332C,STCTY-06037 TRACT-    0332-C   IN LONG BEACH CA,1292,1287,5,1218,0,7466,0
G06003700332D,STCTY-06037 TRACT-    0332-D   IN LONG BEACH CA,70,70,0,67,0,0,0
G06003700333,STCTY-06037 TRACT- 0333   IN LOS ANGELES-LONG BEACH CA ADJ AREA,238,207,31,157,0,0,0
G06003700334,STCTY-06037 TRACT- 0334   IN LOS ANGELES-LONG BEACH CA ADJ AREA,3184,3153,31,3014,0,2936,21.57
G06003700335,STCTY-06037 TRACT- 0335   IN LOS ANGELES-LONG BEACH CA ADJ AREA,5487,4364,1123,3760,9,2425,24.34
G06003700336A,STCTY-06037 TRACT- 0336-A IN LOS ANGELES-LONG BEACH CA ADJ AREA,4794,4695,99,4223,3,2498,24.16
G06003700336B,STCTY-06037 TRACT- 0336-B IN LOS ANGELES-LONG BEACH CA ADJ AREA,764,708,56,643,0,2590,20.2
G06003700337A,STCTY-06037 TRACT- 0337-A IN LOS ANGELES-LONG BEACH CA ADJ AREA,1685,1428,257,1227,3,5109,0
G06003700337B,STCTY-06037 TRACT- 0337-B IN LOS ANGELES-LONG BEACH CA ADJ AREA,987,896,91,803,14,9714,0
G06003700338,STCTY-06037 TRACT- 0338   IN LOS ANGELES-LONG BEACH CA ADJ AREA,1718,1160,558,1055,0,2340,22.21
G06003700339,STCTY-06037 TRACT- 0339   IN LOS ANGELES-LONG BEACH CA ADJ AREA,6343,6213,130,5555,1,3213,24.25
G06003700340A,STCTY-06037 TRACT- 0340-A IN LOS ANGELES-LONG BEACH CA ADJ AREA,962,565,397,445,1,0,0
G06003700340B,STCTY-06037 TRACT- 0340-B IN LOS ANGELES-LONG BEACH CA ADJ AREA,3707,3431,276,3082,3,2583,22.71
G06003700340C,STCTY-06037 TRACT- 0340-C IN LOS ANGELES-LONG BEACH CA ADJ AREA,96,96,0,79,0,0,0
G06003700341A,STCTY-06037 TRACT- 0341-A IN LOS ANGELES-LONG BEACH CA ADJ AREA,789,677,112,595,0,3258,0
G06003700341B,STCTY-06037 TRACT- 0341-B IN LOS ANGELES-LONG BEACH CA ADJ AREA,2202,1949,253,1759,11,2604,23.07
G06003700342A,STCTY-06037 TRACT- 0342-A IN LOS ANGELES-LONG BEACH CA ADJ AREA,9163,8930,233,7998,2,2953,27.43
G06003700342B,STCTY-06037 TRACT-    0342-B   IN LOS ANGELES CA,331,331,0,313,0,0,0
G06003700343,STCTY-06037 TRACT- 0343   IN LOS ANGELES-LONG BEACH CA ADJ AREA,3208,3199,9,2826,0,2865,25.43
G06003700344,STCTY-06037 TRACT- 0344   IN LOS ANGELES-LONG BEACH CA ADJ AREA,5,5,0,5,0,0,0
G06003700345,STCTY-06037 TRACT- 0345   IN LOS ANGELES-LONG BEACH CA ADJ AREA,5855,5667,188,5124,21,5528,47.37
G06003700346,STCTY-06037 TRACT- 0346   IN LOS ANGELES-LONG BEACH CA ADJ AREA,9284,9266,18,8401,2,3517,30.71
G06003700347,STCTY-06037 TRACT- 0347   IN LOS ANGELES-LONG BEACH CA ADJ AREA,4208,4202,6,3861,0,3240,32.06
G06003700348,STCTY-06037 TRACT- 0348   IN LOS ANGELES-LONG BEACH CA ADJ AREA,9274,9249,25,8245,1,3116,30.03
G06003700349,STCTY-06037 TRACT- 0349   IN LOS ANGELES-LONG BEACH CA ADJ AREA,288,288,0,280,0,0,0
G06003700350A,STCTY-06037 TRACT- 0350-A IN LOS ANGELES-LONG BEACH CA ADJ AREA,7635,7595,40,6904,0,2851,27.09
G06003700350B,STCTY-06037 TRACT- 0350-B IN LOS ANGELES-LONG BEACH CA ADJ AREA,1493,1493,0,1313,0,3125,26.96
G06003700351A,STCTY-06037 TRACT- 0351-A IN LOS ANGELES-LONG BEACH CA ADJ AREA,3342,3320,22,2992,1,2436,23.49
G06003700351B,STCTY-06037 TRACT- 0351-B IN LOS ANGELES-LONG BEACH CA ADJ AREA,1,1,0,0,0,0,0
G06003700352,STCTY-06037 TRACT- 0352   IN LOS ANGELES-LONG BEACH CA ADJ AREA,8262,8163,99,7477,1,2410,24.34
G06003700353,STCTY-06037 TRACT- 0353   IN LOS ANGELES-LONG BEACH CA ADJ AREA,4490,4000,490,3595,15,2314,21.72
G06003700354A,STCTY-06037 TRACT- 0354-A IN LOS ANGELES-LONG BEACH CA ADJ AREA,2005,1998,7,1885,1,1428,18.13
G06003700354B,STCTY-06037 TRACT- 0354-B IN LOS ANGELES-LONG BEACH CA ADJ AREA,285,285,0,270,0,0,0
G06003700354C,STCTY-06037 TRACT- 0354-C IN LOS ANGELES-LONG BEACH CA ADJ AREA,163,95,68,76,0,0,0
G06003700355,STCTY-06037 TRACT- 0355   IN LOS ANGELES-LONG BEACH CA ADJ AREA,337,281,56,232,0,0,0
G06003700356,STCTY-06037 TRACT- 0356   IN LOS ANGELES-LONG BEACH CA ADJ AREA,309,261,48,238,1,0,0
G06003700357,STCTY-06037 TRACT- 0357   IN LOS ANGELES-LONG BEACH CA ADJ AREA,9180,9098,82,8147,17,2858,21.68
G06003700358,STCTY-06037 TRACT- 0358   IN LOS ANGELES-LONG BEACH CA ADJ AREA,3912,3854,58,3470,1,1531,18.14
G06003700359,STCTY-06037 TRACT- 0359   IN LOS ANGELES-LONG BEACH CA ADJ AREA,7197,7148,49,6494,15,2924,24.7
G06003700360,STCTY-06037 TRACT- 0360   IN LOS ANGELES-LONG BEACH CA ADJ AREA,6398,6362,36,5859,14,3293,30.92
G06003700361,STCTY-06037 TRACT- 0361   IN LOS ANGELES-LONG BEACH CA ADJ AREA,440,439,1,396,0,0,29.27
G06003700362,STCTY-06037 TRACT- 0362   IN LOS ANGELES-LONG BEACH CA ADJ AREA,3738,3718,20,3510,0,3143,26.58
G06003700363,STCTY-06037 TRACT- 0363   IN LOS ANGELES-LONG BEACH CA ADJ AREA,540,137,403,113,0,0,0
G06003700364,STCTY-06037 TRACT- 0364   IN LOS ANGELES-LONG BEACH CA ADJ AREA,304,216,88,152,2,0,0
G06003700365,STCTY-06037 TRACT- 0365   IN LOS ANGELES-LONG BEACH CA ADJ AREA,5517,5484,33,4936,21,7569,53.64
G06003700366,STCTY-06037 TRACT- 0366   IN LOS ANGELES-LONG BEACH CA ADJ AREA,2,2,0,2,0,0,0
G06003700367,STCTY-06037 TRACT- 0367   IN LOS ANGELES-LONG BEACH CA ADJ AREA,893,893,0,776,0,3942,31.23
G06003700368,STCTY-06037 TRACT- 0368   IN LOS ANGELES-LONG BEACH CA ADJ AREA,8976,8918,58,7949,4,3603,27.87
G06003700369,STCTY-06037 TRACT- 0369   IN LOS ANGELES-LONG BEACH CA ADJ AREA,0,0,0,0,0,0,0
G06003700370,STCTY-06037 TRACT- 0370   IN LOS ANGELES-LONG BEACH CA ADJ AREA,17,10,7,7,0,0,0
G06003700371,STCTY-06037 TRACT- 0371   IN LOS ANGELES-LONG BEACH CA ADJ AREA,37,37,0,34,0,0,0
G06003700372,STCTY-06037 TRACT- 0372   IN LOS ANGELES-LONG BEACH CA ADJ AREA,5450,5379,71,4554,4,2517,22.13
G06003700373,STCTY-06037 TRACT- 0373   IN LOS ANGELES-LONG BEACH CA ADJ AREA,4041,3819,222,3284,187,3064,24.54
G06003700374,STCTY-06037 TRACT- 0374   IN LOS ANGELES-LONG BEACH CA ADJ AREA,11033,10348,685,9101,582,4297,29.37
G06003700375,STCTY-06037 TRACT- 0375   IN LOS ANGELES-LONG BEACH CA ADJ AREA,4511,4177,334,3669,222,1789,24.22
G06003700376,STCTY-06037 TRACT- 0376   IN LOS ANGELES-LONG BEACH CA ADJ AREA,4614,4600,14,4014,5,5205,32.96
G06003700377,STCTY-06037 TRACT- 0377   IN LOS ANGELES-LONG BEACH CA ADJ AREA,3811,3465,346,3094,214,2792,26.48
G06003700378,STCTY-06037 TRACT- 0378   IN LOS ANGELES-LONG BEACH CA ADJ AREA,9415,9346,69,8310,7,4215,34.33
G06003700379,STCTY-06037 TRACT- 0379   IN LOS ANGELES-LONG BEACH CA ADJ AREA,10625,10557,68,9273,44,6822,44.81
G06003700380,STCTY-06037 TRACT- 0380   IN LOS ANGELES-LONG BEACH CA ADJ AREA,5017,4805,212,4289,199,0,0
G06003700381,STCTY-06037 TRACT- 0381   IN LOS ANGELES-LONG BEACH CA ADJ AREA,7260,6526,734,5488,593,20000,100
G06003700382,STCTY-06037 TRACT- 0382   IN LOS ANGELES-LONG BEACH CA ADJ AREA,13671,13486,185,12228,125,8590,58.25
G06003700383,STCTY-06037 TRACT- 0383   IN LOS ANGELES-LONG BEACH CA ADJ AREA,5892,5864,28,5209,21,7191,51.96
G06003700384,STCTY-06037 TRACT- 0384   IN LOS ANGELES-LONG BEACH CA ADJ AREA,18,18,0,16,0,0,0
G06003700385,STCTY-06037 TRACT- 0385   IN LOS ANGELES-LONG BEACH CA ADJ AREA,5419,5378,41,4610,3,4390,36.36
G06003700386,STCTY-06037 TRACT- 0386   IN LOS ANGELES-LONG BEACH CA ADJ AREA,5355,5349,6,4609,1,4548,37.02
G06003700387,STCTY-06037 TRACT- 0387   IN LOS ANGELES-LONG BEACH CA ADJ AREA,9304,9227,77,7854,41,4983,43.12
G06003700388,STCTY-06037 TRACT- 0388   IN LOS ANGELES-LONG BEACH CA ADJ AREA,12,12,0,12,0,0,0
G06003700389,STCTY-06037 TRACT- 0389   IN LOS ANGELES-LONG BEACH CA ADJ AREA,11,11,0,7,0,0,0
G06003700390,STCTY-06037 TRACT- 0390   IN LOS ANGELES-LONG BEACH CA ADJ AREA,7798,7745,53,7092,7,4220,38.64
G06003700391,STCTY-06037 TRACT- 0391   IN LOS ANGELES-LONG BEACH CA ADJ AREA,5121,5095,26,4720,2,3696,30.63
G06003700392,STCTY-06037 TRACT- 0392   IN LOS ANGELES-LONG BEACH CA ADJ AREA,9550,9527,23,8878,3,3516,34.04
G06003700393,STCTY-06037 TRACT- 0393   IN LOS ANGELES-LONG BEACH CA ADJ AREA,5612,5603,9,5230,9,4744,35.7
G06003700394,STCTY-06037 TRACT- 0394   IN LOS ANGELES-LONG BEACH CA ADJ AREA,6256,6228,28,5702,1,3419,29.92
G06003700395,STCTY-06037 TRACT- 0395   IN LOS ANGELES-LONG BEACH CA ADJ AREA,315,315,0,289,0,0,0
G06003700396,STCTY-06037 TRACT- 0396   IN LOS ANGELES-LONG BEACH CA ADJ AREA,8,8,0,8,0,0,0
G06003700397,STCTY-06037 TRACT- 0397   IN LOS ANGELES-LONG BEACH CA ADJ AREA,7095,7090,5,6620,1,4962,37.6
G06003700398A,STCTY-06037 TRACT- 0398-A IN LOS ANGELES-LONG BEACH CA ADJ AREA,4369,4291,78,4000,7,3613,34.14
G06003700398B,STCTY-06037 TRACT- 0398-B IN LOS ANGELES-LONG BEACH CA ADJ AREA,4,4,0,4,0,0,0
G06003700399,STCTY-06037 TRACT- 0399   IN LOS ANGELES-LONG BEACH CA ADJ AREA,9747,9704,43,9097,26,6413,40.57
G06003700400,STCTY-06037 TRACT- 0400   IN LOS ANGELES-LONG BEACH CA ADJ AREA,5104,5100,4,4712,0,4307,37.83
G06003700401,STCTY-06037 TRACT- 0401   IN LOS ANGELES-LONG BEACH CA ADJ AREA,4620,4608,12,4254,1,3967,32.04
G06003700402,STCTY-06037 TRACT- 0402   IN LOS ANGELES-LONG BEACH CA ADJ AREA,5630,5553,77,5158,0,3406,31.08
G06003700403,STCTY-06037 TRACT- 0403   IN LOS ANGELES-LONG BEACH CA ADJ AREA,4518,4408,110,3991,3,3163,29.16
G06003700404,STCTY-06037 TRACT- 0404   IN LOS ANGELES-LONG BEACH CA ADJ AREA,6300,6242,58,5833,1,4180,35.46
G06003700405,STCTY-06037 TRACT- 0405   IN LOS ANGELES-LONG BEACH CA ADJ AREA,6647,6609,38,6060,5,3711,32.82
G06003700406,STCTY-06037 TRACT- 0406   IN LOS ANGELES-LONG BEACH CA ADJ AREA,4893,4823,70,4491,0,3851,32.11
G06003700407,STCTY-06037 TRACT- 0407   IN LOS ANGELES-LONG BEACH CA ADJ AREA,4499,4476,23,4075,0,3725,30.58
G06003700408,STCTY-06037 TRACT- 0408   IN LOS ANGELES-LONG BEACH CA ADJ AREA,4568,4558,10,4298,7,6365,48.2
G06003700409,STCTY-06037 TRACT- 0409   IN LOS ANGELES-LONG BEACH CA ADJ AREA,5803,5780,23,5364,11,6637,49.44
G06003700410,STCTY-06037 TRACT- 0410   IN LOS ANGELES-LONG BEACH CA ADJ AREA,3782,3758,24,3412,1,4997,39.21
G06003700411,STCTY-06037 TRACT- 0411   IN LOS ANGELES-LONG BEACH CA ADJ AREA,5007,4992,15,4635,5,5678,36.13
G06003700412,STCTY-06037 TRACT- 0412   IN LOS ANGELES-LONG BEACH CA ADJ AREA,2617,2614,3,2356,3,4586,31.11
G06003700413,STCTY-06037 TRACT- 0413   IN LOS ANGELES-LONG BEACH CA ADJ AREA,5927,5893,34,5292,23,3516,33.23
G06003700414,STCTY-06037 TRACT- 0414   IN LOS ANGELES-LONG BEACH CA ADJ AREA,4154,3983,171,3548,110,3178,28.79
G06003700415,STCTY-06037 TRACT- 0415   IN LOS ANGELES-LONG BEACH CA ADJ AREA,975,956,19,883,10,10943,0
G06003700416,STCTY-06037 TRACT- 0416   IN LOS ANGELES-LONG BEACH CA ADJ AREA,1000,922,78,827,65,12750,0
G06003700417,STCTY-06037 TRACT- 0417   IN LOS ANGELES-LONG BEACH CA ADJ AREA,4514,2109,2405,1747,2250,2833,22.53
G06003700418,STCTY-06037 TRACT- 0418   IN LOS ANGELES-LONG BEACH CA ADJ AREA,6650,6334,316,5595,283,3724,30.45
G06003700419,STCTY-06037 TRACT- 0419   IN LOS ANGELES-LONG BEACH CA ADJ AREA,3702,3680,22,3303,21,3885,34.86
G06003700420,STCTY-06037 TRACT- 0420   IN LOS ANGELES-LONG BEACH CA ADJ AREA,2663,2654,9,2411,5,5525,45.13
G06003700421,STCTY-06037 TRACT- 0421   IN LOS ANGELES-LONG BEACH CA ADJ AREA,2732,2662,70,2361,6,4319,25.07
G06003700422A,STCTY-06037 TRACT- 0422-A IN LOS ANGELES-LONG BEACH CA ADJ AREA,2493,2493,0,2251,0,3299,28.33
G06003700422B,STCTY-06037 TRACT- 0422-B IN LOS ANGELES-LONG BEACH CA ADJ AREA,5025,4995,30,4504,7,3843,30.26
G06003700423,STCTY-06037 TRACT- 0423   IN LOS ANGELES-LONG BEACH CA ADJ AREA,4589,4482,107,3966,56,2672,28.96
G06003700424,STCTY-06037 TRACT- 0424   IN LOS ANGELES-LONG BEACH CA ADJ AREA,7542,7478,64,6498,16,3620,24.94
G06003700425,STCTY-06037 TRACT- 0425   IN LOS ANGELES-LONG BEACH CA ADJ AREA,3849,3533,316,3011,179,2912,21.99
G06003700426,STCTY-06037 TRACT- 0426   IN LOS ANGELES-LONG BEACH CA ADJ AREA,1659,1635,24,1464,12,7953,0
G06003700427,STCTY-06037 TRACT- 0427   IN LOS ANGELES-LONG BEACH CA ADJ AREA,3793,2903,890,2436,559,6344,23.04
G06003700428,STCTY-06037 TRACT- 0428   IN LOS ANGELES-LONG BEACH CA ADJ AREA,5156,5003,153,4395,73,5344,29.31
G06003700429,STCTY-06037 TRACT- 0429   IN LOS ANGELES-LONG BEACH CA ADJ AREA,3461,3388,73,2922,17,5559,33.03
G06003700430,STCTY-06037 TRACT- 0430   IN LOS ANGELES-LONG BEACH CA ADJ AREA,3386,3345,41,2987,35,4404,31.82
G06003700431,STCTY-06037 TRACT- 0431   IN LOS ANGELES-LONG BEACH CA ADJ AREA,1435,1430,5,1285,2,4203,31.95
G06003700432,STCTY-06037 TRACT- 0432   IN LOS ANGELES-LONG BEACH CA ADJ AREA,4673,4528,145,3914,82,7984,40.24
G06003700433,STCTY-06037 TRACT- 0433   IN LOS ANGELES-LONG BEACH CA ADJ AREA,2352,2200,152,1887,115,9034,42.8
G06003700434A,STCTY-06037 TRACT- 0434-A IN LOS ANGELES-LONG BEACH CA ADJ AREA,6517,6512,5,5845,1,3520,31.9
G06003700434B,STCTY-06037 TRACT- 0434-B IN LOS ANGELES-LONG BEACH CA ADJ AREA,10,10,0,10,0,0,0
G06003700435,STCTY-06037 TRACT- 0435   IN LOS ANGELES-LONG BEACH CA ADJ AREA,4683,4658,25,4171,6,4372,31.95
G06003700436,STCTY-06037 TRACT- 0436   IN LOS ANGELES-LONG BEACH CA ADJ AREA,5241,5179,62,4746,46,7448,46.33
G06003700437,STCTY-06037 TRACT- 0437   IN LOS ANGELES-LONG BEACH CA ADJ AREA,6918,6909,9,6230,7,4742,34.9
G06003700438A,STCTY-06037 TRACT- 0438-A IN LOS ANGELES-LONG BEACH CA ADJ AREA,407,387,20,357,3,0,0
G06003700438B,STCTY-06037 TRACT- 0438-B IN LOS ANGELES-LONG BEACH CA ADJ AREA,71,67,4,64,4,0,0
G06003700438C,STCTY-06037 TRACT- 0438-C IN LOS ANGELES-LONG BEACH CA ADJ AREA,7,7,0,2,0,0,0
G06003700439,STCTY-06037 TRACT- 0439   IN LOS ANGELES-LONG BEACH CA ADJ AREA,2054,2037,17,1841,11,5831,49.41
G06003700440,STCTY-06037 TRACT- 0440   IN LOS ANGELES-LONG BEACH CA ADJ AREA,4106,4074,32,3791,15,3365,26.32
G06003700441,STCTY-06037 TRACT- 0441   IN LOS ANGELES-LONG BEACH CA ADJ AREA,4099,4088,11,3745,1,4763,34.59
G06003700442,STCTY-06037 TRACT- 0442   IN LOS ANGELES-LONG BEACH CA ADJ AREA,9051,8912,139,8117,13,5441,31.17
G06003700443,STCTY-06037 TRACT- 0443   IN LOS ANGELES-LONG BEACH CA ADJ AREA,4581,4493,88,3913,6,3624,25.67
G06003700444,STCTY-06037 TRACT- 0444   IN LOS ANGELES-LONG BEACH CA ADJ AREA,8525,8470,55,7836,14,3807,27.54
G06003700445,STCTY-06037 TRACT- 0445   IN LOS ANGELES-LONG BEACH CA ADJ AREA,4282,3650,632,3316,596,2606,21.75
G06003700446,STCTY-06037 TRACT- 0446   IN LOS ANGELES-LONG BEACH CA ADJ AREA,2197,1913,284,1563,252,1568,18.56
G06003700447,STCTY-06037 TRACT- 0447   IN LOS ANGELES-LONG BEACH CA ADJ AREA,1226,1204,22,1044,4,0,0
G06003700448,STCTY-06037 TRACT- 0448   IN LOS ANGELES-LONG BEACH CA ADJ AREA,5209,5171,38,4286,0,2218,17.88
G06003700449,STCTY-06037 TRACT- 0449   IN LOS ANGELES-LONG BEACH CA ADJ AREA,1370,1366,4,1276,3,0,18.67
G06003700450,STCTY-06037 TRACT- 0450   IN LOS ANGELES-LONG BEACH CA ADJ AREA,2822,2748,74,2558,0,3190,20.36
G06003700451,STCTY-06037 TRACT- 0451   IN LOS ANGELES-LONG BEACH CA ADJ AREA,915,870,45,825,0,0,0
G06003700452,STCTY-06037 TRACT- 0452   IN LOS ANGELES-LONG BEACH CA ADJ AREA,448,447,1,422,0,0,0
G06003700453,STCTY-06037 TRACT- 0453   IN LOS ANGELES-LONG BEACH CA ADJ AREA,3057,3043,14,2808,6,4792,28.64
G06003700454,STCTY-06037 TRACT- 0454   IN LOS ANGELES-LONG BEACH CA ADJ AREA,6670,6660,10,6373,1,3624,29.82
G06003700455,STCTY-06037 TRACT- 0455   IN LOS ANGELES-LONG BEACH CA ADJ AREA,5151,5133,18,4884,3,2706,23.88
G06003700456,STCTY-06037 TRACT- 0456   IN LOS ANGELES-LONG BEACH CA ADJ AREA,5322,5207,115,4643,92,2161,20.29
G06003700457,STCTY-06037 TRACT- 0457   IN LOS ANGELES-LONG BEACH CA ADJ AREA,6396,6373,23,5905,8,3433,24.62
G06003700458,STCTY-06037 TRACT- 0458   IN LOS ANGELES-LONG BEACH CA ADJ AREA,3092,3067,25,2667,1,2705,19.65
G06003700459,STCTY-06037 TRACT- 0459   IN LOS ANGELES-LONG BEACH CA ADJ AREA,3588,3423,165,3139,5,2008,18.27
G06003700460,STCTY-06037 TRACT- 0460   IN LOS ANGELES-LONG BEACH CA ADJ AREA,1148,1140,8,1071,2,0,0
G06003700461,STCTY-06037 TRACT- 0461   IN LOS ANGELES-LONG BEACH CA ADJ AREA,3049,3042,7,2927,1,3303,23
G06003700462A,STCTY-06037 TRACT- 0462-A IN LOS ANGELES-LONG BEACH CA ADJ AREA,304,301,3,280,0,0,0
G06003700462B,STCTY-06037 TRACT- 0462-B IN LOS ANGELES-LONG BEACH CA ADJ AREA,248,246,2,227,1,0,0
G06003700463,STCTY-06037 TRACT- 0463   IN LOS ANGELES-LONG BEACH CA ADJ AREA,824,698,126,650,0,0,0
G06003700464,STCTY-06037 TRACT- 0464   IN LOS ANGELES-LONG BEACH CA ADJ AREA,6275,6168,107,5708,16,2851,23.22
G06003700465,STCTY-06037 TRACT- 0465   IN LOS ANGELES-LONG BEACH CA ADJ AREA,16242,15900,342,14541,11,3196,23.21
G06003700466,STCTY-06037 TRACT- 0466   IN LOS ANGELES-LONG BEACH CA ADJ AREA,4746,4679,67,4186,0,3160,23.6
G06003700467,STCTY-06037 TRACT- 0467   IN LOS ANGELES-LONG BEACH CA ADJ AREA,11443,11261,182,10347,4,2137,19.66
G06003700468,STCTY-06037 TRACT- 0468   IN LOS ANGELES-LONG BEACH CA ADJ AREA,6507,6389,118,5986,0,2231,23.21
G06003700469,STCTY-06037 TRACT- 0469   IN LOS ANGELES-LONG BEACH CA ADJ AREA,5083,5060,23,4679,1,2593,25.72
G06003700470,STCTY-06037 TRACT- 0470   IN LOS ANGELES-LONG BEACH CA ADJ AREA,6994,6935,59,6314,0,4016,30.86
G06003700471,STCTY-06037 TRACT- 0471   IN LOS ANGELES-LONG BEACH CA ADJ AREA,11867,11606,261,10250,52,4917,25.93
G06003700472,STCTY-06037 TRACT- 0472   IN LOS ANGELES-LONG BEACH CA ADJ AREA,8175,8004,171,7482,108,11639,81.01
G06003700473,STCTY-06037 TRACT- 0473   IN LOS ANGELES-LONG BEACH CA ADJ AREA,3333,3250,83,2942,22,5204,32.97
G06003700474,STCTY-06037 TRACT- 0474   IN LOS ANGELES-LONG BEACH CA ADJ AREA,5663,5564,99,5069,7,4675,34.31
G06003700475,STCTY-06037 TRACT- 0475   IN LOS ANGELES-LONG BEACH CA ADJ AREA,5360,5297,63,4859,6,5998,39.85
G06003700476,STCTY-06037 TRACT- 0476   IN LOS ANGELES-LONG BEACH CA ADJ AREA,8610,8566,44,7825,10,4562,31.62
G06003700477,STCTY-06037 TRACT- 0477   IN LOS ANGELES-LONG BEACH CA ADJ AREA,12467,12460,7,11381,0,4801,34.2
G06003700478,STCTY-06037 TRACT- 0478   IN LOS ANGELES-LONG BEACH CA ADJ AREA,5207,5161,46,4660,3,3793,29.37
G06003700479,STCTY-06037 TRACT- 0479   IN LOS ANGELES-LONG BEACH CA ADJ AREA,4966,4866,100,4507,65,3914,29.07
G06003700480,STCTY-06037 TRACT- 0480   IN LOS ANGELES-LONG BEACH CA ADJ AREA,7685,7684,1,7089,1,4703,36.91
G06003700481,STCTY-06037 TRACT- 0481   IN LOS ANGELES-LONG BEACH CA ADJ AREA,4667,4651,16,4200,0,3332,29.86
G06003700482,STCTY-06037 TRACT- 0482   IN LOS ANGELES-LONG BEACH CA ADJ AREA,2291,2281,10,2000,0,3000,25.51
G06003700483,STCTY-06037 TRACT- 0483   IN LOS ANGELES-LONG BEACH CA ADJ AREA,1573,1503,70,1333,0,3133,28.48
G06003700484,STCTY-06037 TRACT- 0484   IN LOS ANGELES-LONG BEACH CA ADJ AREA,11076,10988,88,7205,10,2714,25.01
G06003700485,STCTY-06037 TRACT- 0485   IN LOS ANGELES-LONG BEACH CA ADJ AREA,5341,4991,350,3541,5,2334,21.82
G06003700486,STCTY-06037 TRACT- 0486   IN LOS ANGELES-LONG BEACH CA ADJ AREA,6626,6546,80,4738,8,2450,19.78
G06003700487,STCTY-06037 TRACT- 0487   IN LOS ANGELES-LONG BEACH CA ADJ AREA,6648,6605,43,5392,3,2261,22.34
G06003700488,STCTY-06037 TRACT- 0488   IN LOS ANGELES-LONG BEACH CA ADJ AREA,5866,5856,10,5062,0,2061,23.07
G06003700489,STCTY-06037 TRACT- 0489   IN LOS ANGELES-LONG BEACH CA ADJ AREA,2004,2000,4,1715,0,2494,22.62
G06003700490,STCTY-06037 TRACT- 0490   IN LOS ANGELES-LONG BEACH CA ADJ AREA,6865,6803,62,4797,7,1750,17.14
G06003700491,STCTY-06037 TRACT- 0491   IN LOS ANGELES-LONG BEACH CA ADJ AREA,7284,7124,160,5261,4,1259,16.17
G06003700492,STCTY-06037 TRACT- 0492   IN LOS ANGELES-LONG BEACH CA ADJ AREA,6579,6577,2,5867,0,2403,22.81
G06003700493,STCTY-06037 TRACT- 0493   IN LOS ANGELES-LONG BEACH CA ADJ AREA,5685,5681,4,5056,0,2948,27.25
G06003700494,STCTY-06037 TRACT- 0494   IN LOS ANGELES-LONG BEACH CA ADJ AREA,7567,7564,3,6822,2,3693,32.24
G06003700495,STCTY-06037 TRACT- 0495   IN LOS ANGELES-LONG BEACH CA ADJ AREA,4260,4259,1,3908,0,3474,31.26
G06003700496,STCTY-06037 TRACT- 0496   IN LOS ANGELES-LONG BEACH CA ADJ AREA,3901,3815,86,3582,1,4528,32.28
G06003700497,STCTY-06037 TRACT- 0497   IN LOS ANGELES-LONG BEACH CA ADJ AREA,4115,3968,147,3590,0,3273,26.4
G06003700498,STCTY-06037 TRACT- 0498   IN LOS ANGELES-LONG BEACH CA ADJ AREA,3720,3715,5,3158,0,2787,20.64
G06003700499,STCTY-06037 TRACT- 0499   IN LOS ANGELES-LONG BEACH CA ADJ AREA,1457,1343,114,1204,0,1653,11.17
G06003700500,STCTY-06037 TRACT- 0500   IN LOS ANGELES-LONG BEACH CA ADJ AREA,35,34,1,29,0,0,0
G06003700501,STCTY-06037 TRACT- 0501   IN LOS ANGELES-LONG BEACH CA ADJ AREA,850,804,46,612,16,0,14.35
G06003700502,STCTY-06037 TRACT- 0502   IN LOS ANGELES-LONG BEACH CA ADJ AREA,345,345,0,307,0,0,0
G06003700503,STCTY-06037 TRACT- 0503   IN LOS ANGELES-LONG BEACH CA ADJ AREA,1634,1633,1,1522,0,3113,24.14
G06003700504,STCTY-06037 TRACT- 0504   IN LOS ANGELES-LONG BEACH CA ADJ AREA,9097,9095,2,8516,1,2924,29.12
G06003700505,STCTY-06037 TRACT- 0505   IN LOS ANGELES-LONG BEACH CA ADJ AREA,11264,11238,26,10447,2,3147,28.17
G06003700506,STCTY-06037 TRACT- 0506   IN LOS ANGELES-LONG BEACH CA ADJ AREA,13397,13353,44,12559,2,2028,19.82
G06003700507,STCTY-06037 TRACT- 0507   IN LOS ANGELES-LONG BEACH CA ADJ AREA,2875,2867,8,2682,0,2899,28.77
G06003700508,STCTY-06037 TRACT- 0508   IN LOS ANGELES-LONG BEACH CA ADJ AREA,7388,7382,6,6692,1,4086,33.69
G06003700509,STCTY-06037 TRACT- 0509   IN LOS ANGELES-LONG BEACH CA ADJ AREA,7718,7699,19,7051,4,4134,31.89
G06003700510,STCTY-06037 TRACT- 0510   IN LOS ANGELES-LONG BEACH CA ADJ AREA,3246,3245,1,2891,0,2531,24.45
G06003700511,STCTY-06037 TRACT- 0511   IN LOS ANGELES-LONG BEACH CA ADJ AREA,7421,7421,0,6781,0,3372,28.19
G06003700512,STCTY-06037 TRACT- 0512   IN LOS ANGELES-LONG BEACH CA ADJ AREA,2705,2698,7,2499,0,2392,19.56
G06003700513,STCTY-06037 TRACT- 0513   IN LOS ANGELES-LONG BEACH CA ADJ AREA,3422,3251,171,2919,158,2775,20
G06003700514,STCTY-06037 TRACT- 0514   IN LOS ANGELES-LONG BEACH CA ADJ AREA,8298,8286,12,7528,10,2806,24.01
G06003700515,STCTY-06037 TRACT- 0515   IN LOS ANGELES-LONG BEACH CA ADJ AREA,8677,8651,26,7764,0,2425,23.5
G06003700516,STCTY-06037 TRACT- 0516   IN LOS ANGELES-LONG BEACH CA ADJ AREA,5320,5289,31,4789,1,2520,25.83
G06003700517,STCTY-06037 TRACT- 0517   IN LOS ANGELES-LONG BEACH CA ADJ AREA,4649,3498,1151,3151,1095,2004,21.64
G06003700518,STCTY-06037 TRACT- 0518   IN LOS ANGELES-LONG BEACH CA ADJ AREA,4012,3997,15,3556,2,1721,19.49
G06003700519,STCTY-06037 TRACT- 0519   IN LOS ANGELES-LONG BEACH CA ADJ AREA,6495,6493,2,5889,1,4266,35.88
G06003700520,STCTY-06037 TRACT- 0520   IN LOS ANGELES-LONG BEACH CA ADJ AREA,2787,2785,2,2528,2,4823,43.8
G06003700521,STCTY-06037 TRACT- 0521   IN LOS ANGELES-LONG BEACH CA ADJ AREA,10221,10220,1,9364,0,3607,32.92
G06003700522,STCTY-06037 TRACT- 0522   IN LOS ANGELES-LONG BEACH CA ADJ AREA,10595,10588,7,9902,2,2948,28.49
G06003700523,STCTY-06037 TRACT- 0523   IN LOS ANGELES-LONG BEACH CA ADJ AREA,5674,5668,6,5326,0,3156,28.45
G06003700524,STCTY-06037 TRACT- 0524   IN LOS ANGELES-LONG BEACH CA ADJ AREA,455,450,5,429,0,0,0
G06003700525,STCTY-06037 TRACT- 0525   IN LOS ANGELES-LONG BEACH CA ADJ AREA,2,2,0,2,0,0,0
G06003700526,STCTY-06037 TRACT- 0526   IN LOS ANGELES-LONG BEACH CA ADJ AREA,10982,10979,3,10259,1,3199,29.61
G06003700527,STCTY-06037 TRACT- 0527   IN LOS ANGELES-LONG BEACH CA ADJ AREA,9448,8296,1152,7372,1042,1815,20.16
G06003700528,STCTY-06037 TRACT- 0528   IN LOS ANGELES-LONG BEACH CA ADJ AREA,1596,1378,218,1215,1,2472,22.78
G06003700529,STCTY-06037 TRACT- 0529   IN LOS ANGELES-LONG BEACH CA ADJ AREA,1092,871,221,786,0,1711,0
G06003700530,STCTY-06037 TRACT- 0530   IN LOS ANGELES-LONG BEACH CA ADJ AREA,8529,8510,19,7895,0,2194,25.21
G06003700531,STCTY-06037 TRACT- 0531   IN LOS ANGELES-LONG BEACH CA ADJ AREA,7669,7616,53,7207,0,3584,31.35
G06003700532,STCTY-06037 TRACT- 0532   IN LOS ANGELES-LONG BEACH CA ADJ AREA,418,418,0,395,0,0,0
G06003700533,STCTY-06037 TRACT- 0533   IN LOS ANGELES-LONG BEACH CA ADJ AREA,5,0,5,0,0,0,0
G06003700534,STCTY-06037 TRACT- 0534   IN LOS ANGELES-LONG BEACH CA ADJ AREA,2826,2788,38,2671,0,2290,26.8
G06003700535,STCTY-06037 TRACT- 0535   IN LOS ANGELES-LONG BEACH CA ADJ AREA,6112,6080,32,5820,6,2174,23.06
G06003700536,STCTY-06037 TRACT- 0536   IN LOS ANGELES-LONG BEACH CA ADJ AREA,7019,6923,96,6067,0,2379,24.03
G06003700537,STCTY-06037 TRACT- 0537   IN LOS ANGELES-LONG BEACH CA ADJ AREA,11072,11025,47,10172,0,2959,25.96
G06003700538,STCTY-06037 TRACT- 0538   IN LOS ANGELES-LONG BEACH CA ADJ AREA,5837,5575,262,4497,0,2309,21.79
G06003700539,STCTY-06037 TRACT- 0539   IN LOS ANGELES-LONG BEACH CA ADJ AREA,757,716,41,522,0,0,0
G06003700540,STCTY-06037 TRACT- 0540   IN LOS ANGELES-LONG BEACH CA ADJ AREA,8690,8123,567,6992,112,2340,20.34
G06003700541,STCTY-06037 TRACT- 0541   IN LOS ANGELES-LONG BEACH CA ADJ AREA,12538,12037,501,10347,107,2917,23.44
G06003700542,STCTY-06037 TRACT- 0542   IN LOS ANGELES-LONG BEACH CA ADJ AREA,6389,6279,110,5669,3,2592,23.44
G06003700543,STCTY-06037 TRACT- 0543   IN LOS ANGELES-LONG BEACH CA ADJ AREA,5033,4941,92,4281,35,3123,15.89
G06003700544,STCTY-06037 TRACT- 0544   IN LOS ANGELES-LONG BEACH CA ADJ AREA,4611,4589,22,4280,5,3883,28.23
G06003700545,STCTY-06037 TRACT- 0545   IN LOS ANGELES-LONG BEACH CA ADJ AREA,7606,7557,49,7191,11,4762,26.19
G06003700546,STCTY-06037 TRACT- 0546   IN LOS ANGELES-LONG BEACH CA ADJ AREA,3898,3889,9,3729,1,3405,28.15
G06003700547,STCTY-06037 TRACT- 0547   IN LOS ANGELES-LONG BEACH CA ADJ AREA,5190,5028,162,4669,13,2715,24.04
G06003700548,STCTY-06037 TRACT- 0548   IN LOS ANGELES-LONG BEACH CA ADJ AREA,7154,6804,350,5908,5,2313,18.02
G06003700549,STCTY-06037 TRACT- 0549   IN LOS ANGELES-LONG BEACH CA ADJ AREA,1911,1848,63,1729,21,0,0
G06003700550,STCTY-06037 TRACT- 0550   IN LOS ANGELES-LONG BEACH CA ADJ AREA,370,360,10,330,10,0,0
G06003700551,STCTY-06037 TRACT- 0551   IN LOS ANGELES-LONG BEACH CA ADJ AREA,284,272,12,241,10,0,0
G06003700552,STCTY-06037 TRACT- 0552   IN LOS ANGELES-LONG BEACH CA ADJ AREA,173,173,0,153,0,0,0
G06003700553,STCTY-06037 TRACT- 0553   IN LOS ANGELES-LONG BEACH CA ADJ AREA,3334,3263,71,2972,62,7081,44.74
G06003700554A,STCTY-06037 TRACT- 0554-A IN LOS ANGELES-LONG BEACH CA ADJ AREA,8187,8164,23,7546,4,3341,29.35
G06003700554B,STCTY-06037 TRACT- 0554-B IN LOS ANGELES-LONG BEACH CA ADJ AREA,0,0,0,0,0,0,0
G06003700554C,STCTY-06037 TRACT- 0554-C IN LOS ANGELES-LONG BEACH CA ADJ AREA,11,11,0,9,0,0,0
G06003700555,STCTY-06037 TRACT-    0555     IN LOS ANGELES CA,4575,4560,15,4052,4,2712,24.6
G06003700556,STCTY-06037 TRACT- 0556   IN LOS ANGELES-LONG BEACH CA ADJ AREA,9094,8869,225,7479,16,2677,23.75
G06003700557,STCTY-06037 TRACT- 0557   IN LOS ANGELES-LONG BEACH CA ADJ AREA,977,963,14,855,10,0,0
G06003700558,STCTY-06037 TRACT- 0558   IN LOS ANGELES-LONG BEACH CA ADJ AREA,805,795,10,716,8,0,10.71
G06003700559,STCTY-06037 TRACT- 0559   IN LOS ANGELES-LONG BEACH CA ADJ AREA,777,777,0,756,0,0,0
G06003700560,STCTY-06037 TRACT- 0560   IN LOS ANGELES-LONG BEACH CA ADJ AREA,986,980,6,910,1,0,0
G06003700561,STCTY-06037 TRACT- 0561   IN LOS ANGELES-LONG BEACH CA ADJ AREA,3463,3421,42,3231,10,2556,27.2
G06003700562,STCTY-06037 TRACT- 0562   IN LOS ANGELES-LONG BEACH CA ADJ AREA,1419,1419,0,1312,0,0,23.19
G06003700563A,STCTY-06037 TRACT- 0563-A IN LOS ANGELES-LONG BEACH CA ADJ AREA,1084,1048,36,905,2,0,0
G06003700563B,STCTY-06037 TRACT- 0563-B IN LOS ANGELES-LONG BEACH CA ADJ AREA,426,426,0,406,0,0,0
G06003700564,STCTY-06037 TRACT- 0564   IN LOS ANGELES-LONG BEACH CA ADJ AREA,4407,4274,133,3896,97,1684,18.78
G06003700565,STCTY-06037 TRACT- 0565   IN LOS ANGELES-LONG BEACH CA ADJ AREA,2041,2021,20,1809,16,1786,15.55
G06003700566,STCTY-06037 TRACT- 0566   IN LOS ANGELES-LONG BEACH CA ADJ AREA,929,907,22,808,8,2132,27.54
G06003700567,STCTY-06037 TRACT- 0567   IN LOS ANGELES-LONG BEACH CA ADJ AREA,1637,1611,26,1389,18,3985,31.13
G06003700568,STCTY-06037 TRACT- 0568   IN LOS ANGELES-LONG BEACH CA ADJ AREA,296,294,2,278,1,0,0
G0600750A0001,STCTY-06075 TRACT-  A 0001     IN SAN FRANCISCO CA,2123,2072,51,1357,35,0,21.7
G0600750A0002,STCTY-06075 TRACT-  A 0002     IN SAN FRANCISCO CA,4409,4338,71,3558,8,8667,49.12
G0600750A0003,STCTY-06075 TRACT-  A 0003     IN SAN FRANCISCO CA,4949,4919,30,3289,6,3855,34.07
G0600750A0004,STCTY-06075 TRACT-  A 0004     IN SAN FRANCISCO CA,5609,5559,50,3428,20,6158,28.24
G0600750A0005,STCTY-06075 TRACT-  A 0005     IN SAN FRANCISCO CA,3465,3199,266,1502,78,0,21.01
G0600750A0006,STCTY-06075 TRACT-  A 0006     IN SAN FRANCISCO CA,4401,3203,1198,1510,32,3319,23.19
G0600750A0007,STCTY-06075 TRACT-  A 0007     IN SAN FRANCISCO CA,5466,4489,977,3382,71,3514,36.07
G0600750A0008,STCTY-06075 TRACT-  A 0008     IN SAN FRANCISCO CA,5152,5124,28,3965,6,4875,37.29
G0600750A0009,STCTY-06075 TRACT-  A 0009     IN SAN FRANCISCO CA,5052,4959,93,3804,49,3392,33.16
G0600750A0010,STCTY-06075 TRACT-  A 0010     IN SAN FRANCISCO CA,4902,4866,36,3996,0,0,32.8
G0600750A0011,STCTY-06075 TRACT-  A 0011     IN SAN FRANCISCO CA,4005,3083,922,2479,30,0,38.1
G0600750A0012,STCTY-06075 TRACT-  A 0012     IN SAN FRANCISCO CA,5853,5750,103,4840,7,0,37.69
G0600750A0013,STCTY-06075 TRACT-  A 0013     IN SAN FRANCISCO CA,4601,982,3619,779,33,0,29.2
G0600750A0014,STCTY-06075 TRACT-  A 0014     IN SAN FRANCISCO CA,6427,55,6372,32,3,0,9.04
G0600750A0015,STCTY-06075 TRACT-  A 0015     IN SAN FRANCISCO CA,3095,293,2802,206,21,0,15.75
G0600750A0016,STCTY-06075 TRACT-  A 0016     IN SAN FRANCISCO CA,2658,1635,1023,900,79,0,14.23
G0600750A0017,STCTY-06075 TRACT-  A 0017     IN SAN FRANCISCO CA,3350,2869,481,2200,40,0,29.2
G0600750A0018,STCTY-06075 TRACT-  A 0018     IN SAN FRANCISCO CA,4725,4647,78,4064,6,0,36.81
G0600750A0019,STCTY-06075 TRACT-  A 0019     IN SAN FRANCISCO CA,3720,3683,37,3085,6,0,32.78
G0600750A0020,STCTY-06075 TRACT-  A 0020     IN SAN FRANCISCO CA,5499,5439,60,4564,5,0,35.93
G0600750A0021,STCTY-06075 TRACT-  A 0021     IN SAN FRANCISCO CA,6855,6784,71,5676,3,0,35.27
G0600750A0022,STCTY-06075 TRACT-  A 0022     IN SAN FRANCISCO CA,4381,4305,76,3479,4,0,32.88
G0600750A0023,STCTY-06075 TRACT-  A 0023     IN SAN FRANCISCO CA,4956,4924,32,3995,4,0,32.61
G0600750B0001,STCTY-06075 TRACT-  B 0001     IN SAN FRANCISCO CA,6623,6596,27,5565,6,8742,52.9
G0600750B0002,STCTY-06075 TRACT-  B 0002     IN SAN FRANCISCO CA,5015,4993,22,4180,5,8964,51.94
G0600750B0003,STCTY-06075 TRACT-  B 0003     IN SAN FRANCISCO CA,6129,6005,124,4823,25,6750,42.78
G0600750B0004,STCTY-06075 TRACT-  B 0004     IN SAN FRANCISCO CA,7312,7199,113,5458,64,4819,40.57
G0600750B0005,STCTY-06075 TRACT-  B 0005     IN SAN FRANCISCO CA,5264,5098,166,4002,71,5288,38.68
G0600750B0006,STCTY-06075 TRACT-  B 0006     IN SAN FRANCISCO CA,5845,5705,140,4816,17,12879,59.6
G0600750B0007,STCTY-06075 TRACT-  B 0007     IN SAN FRANCISCO CA,5179,4901,278,4170,30,20000,73.97
G0600750B0008,STCTY-06075 TRACT-  B 0008     IN SAN FRANCISCO CA,6263,5984,279,4762,50,15000,39.64
G0600750B0009,STCTY-06075 TRACT-  B 0009     IN SAN FRANCISCO CA,4623,4353,270,3333,136,6619,34.5
G0600750B0010,STCTY-06075 TRACT-  B 0010     IN SAN FRANCISCO CA,3603,3388,215,2763,61,7885,35.82
G0600750C0001,STCTY-06075 TRACT-  C 0001     IN SAN FRANCISCO CA,6021,5969,52,5625,12,0,70.75
G0600750D0001,STCTY-06075 TRACT-  D 0001     IN SAN FRANCISCO CA,4783,4667,116,3565,1,5316,34.86
G0600750D0002,STCTY-06075 TRACT-  D 0002     IN SAN FRANCISCO CA,5697,5679,18,4505,9,5315,40.21
G0600750E0001,STCTY-06075 TRACT-  E 0001     IN SAN FRANCISCO CA,2997,2889,108,2508,12,12764,57.74
G0600750E0002,STCTY-06075 TRACT-  E 0002     IN SAN FRANCISCO CA,4069,4047,22,3242,10,4193,39.88
G0600750E0003,STCTY-06075 TRACT-  E 0003     IN SAN FRANCISCO CA,7473,7387,86,5947,7,5149,41.82
G0600750F0001,STCTY-06075 TRACT-  F 0001     IN SAN FRANCISCO CA,234,231,3,205,3,0,0
G0600750G0001,STCTY-06075 TRACT-  G 0001     IN SAN FRANCISCO CA,6053,6042,11,4869,0,5703,47.21
G0600750G0002,STCTY-06075 TRACT-  G 0002     IN SAN FRANCISCO CA,7627,7615,12,6005,7,5578,46.25
G0600750G0003,STCTY-06075 TRACT-  G 0003     IN SAN FRANCISCO CA,5776,5760,16,4763,2,6058,47.9
G0600750G0004,STCTY-06075 TRACT-  G 0004     IN SAN FRANCISCO CA,6884,6868,16,5631,4,5478,46.3
G0600750H0001,STCTY-06075 TRACT-  H 0001     IN SAN FRANCISCO CA,4650,4606,44,3530,1,4850,34.87
G0600750H0002,STCTY-06075 TRACT-  H 0002     IN SAN FRANCISCO CA,7058,7021,37,5454,7,5563,39.63
G0600750I0001,STCTY-06075 TRACT-  I 0001     IN SAN FRANCISCO CA,186,179,7,151,0,0,0
G0600750J0001,STCTY-06075 TRACT-  J 0001     IN SAN FRANCISCO CA,2493,2390,103,1890,7,0,16.53
G0600750J0002,STCTY-06075 TRACT-  J 0002     IN SAN FRANCISCO CA,5106,3094,2012,2279,322,4875,29.99
G0600750J0003,STCTY-06075 TRACT-  J 0003     IN SAN FRANCISCO CA,3386,2901,485,2001,403,3957,27.63
G0600750J0004,STCTY-06075 TRACT-  J 0004     IN SAN FRANCISCO CA,5542,4807,735,3791,522,5323,36.53
G0600750J0005,STCTY-06075 TRACT-  J 0005     IN SAN FRANCISCO CA,6791,6735,56,5380,32,5964,32.37
G0600750J0006,STCTY-06075 TRACT-  J 0006     IN SAN FRANCISCO CA,5650,3241,2409,2249,831,4600,24.83
G0600750J0007,STCTY-06075 TRACT-  J 0007     IN SAN FRANCISCO CA,9392,8766,626,6374,406,3708,27.09
G0600750J0008,STCTY-06075 TRACT-  J 0008     IN SAN FRANCISCO CA,6473,4741,1732,3362,449,0,17.05
G0600750J0009,STCTY-06075 TRACT-  J 0009     IN SAN FRANCISCO CA,3201,3169,32,2486,3,0,17.95
G0600750J0010,STCTY-06075 TRACT-  J 0010     IN SAN FRANCISCO CA,5534,5217,317,3766,126,0,19.25
G0600750J0011,STCTY-06075 TRACT-  J 0011     IN SAN FRANCISCO CA,3636,3623,13,3033,6,0,27.86
G0600750J0012,STCTY-06075 TRACT-  J 0012     IN SAN FRANCISCO CA,5157,5066,91,4006,12,3250,24.84
G0600750J0013,STCTY-06075 TRACT-  J 0013     IN SAN FRANCISCO CA,4359,4305,54,3434,3,3474,32.28
G0600750J0014,STCTY-06075 TRACT-  J 0014     IN SAN FRANCISCO CA,5909,5889,20,4663,6,3662,35.58
G0600750J0015,STCTY-06075 TRACT-  J 0015     IN SAN FRANCISCO CA,6808,6730,78,5417,0,2492,29.46
G0600750J0016,STCTY-06075 TRACT-  J 0016     IN SAN FRANCISCO CA,6016,5983,33,4810,5,2878,28.49
G0600750J0017,STCTY-06075 TRACT-  J 0017     IN SAN FRANCISCO CA,7680,7655,25,6168,2,3486,28.02
G0600750J0018,STCTY-06075 TRACT-  J 0018     IN SAN FRANCISCO CA,4356,4354,2,3291,0,2533,28.24
G0600750J0019,STCTY-06075 TRACT-  J 0019     IN SAN FRANCISCO CA,3487,3464,23,2629,2,4014,31.54
G0600750J0020,STCTY-06075 TRACT-  J 0020     IN SAN FRANCISCO CA,9058,8955,103,7323,8,4374,33.83
G0600750K0001,STCTY-06075 TRACT-  K 0001     IN SAN FRANCISCO CA,4626,4400,226,2890,105,0,15.82
G0600750K0002,STCTY-06075 TRACT-  K 0002     IN SAN FRANCISCO CA,8070,7838,232,5579,23,0,17.08
G0600750K0003,STCTY-06075 TRACT-  K 0003     IN SAN FRANCISCO CA,6216,5783,433,3630,142,0,15
G0600750K0004,STCTY-06075 TRACT-  K 0004     IN SAN FRANCISCO CA,1683,1601,82,1017,56,0,17.14
G0600750K0005,STCTY-06075 TRACT-  K 0005     IN SAN FRANCISCO CA,45,45,0,30,0,0,0
G0600750K0006,STCTY-06075 TRACT-  K 0006     IN SAN FRANCISCO CA,2742,2721,21,2074,9,0,22.73
G0600750L0001,STCTY-06075 TRACT-  L 0001     IN SAN FRANCISCO CA,9035,8932,103,5988,14,3066,24
G0600750L0002,STCTY-06075 TRACT-  L 0002     IN SAN FRANCISCO CA,10898,10801,97,8191,17,4358,26.42
G0600750L0003,STCTY-06075 TRACT-  L 0003     IN SAN FRANCISCO CA,7945,7920,25,6110,6,4037,27.51
G0600750L0004,STCTY-06075 TRACT-  L 0004     IN SAN FRANCISCO CA,5812,5805,7,4036,4,3474,26.72
G0600750L0005,STCTY-06075 TRACT-  L 0005     IN SAN FRANCISCO CA,8199,8063,136,5673,3,3901,27.91
G0600750M0001,STCTY-06075 TRACT-  M 0001     IN SAN FRANCISCO CA,2258,2252,6,1718,0,2873,26.56
G0600750M0002,STCTY-06075 TRACT-  M 0002     IN SAN FRANCISCO CA,5041,5032,9,3775,9,2986,26.42
G0600750M0003,STCTY-06075 TRACT-  M 0003     IN SAN FRANCISCO CA,4573,4557,16,3640,3,3183,27.56
G0600750M0004,STCTY-06075 TRACT-  M 0004     IN SAN FRANCISCO CA,7070,7036,34,5440,29,3542,29.11
G0600750M0005,STCTY-06075 TRACT-  M 0005     IN SAN FRANCISCO CA,6698,6674,24,4909,10,3964,31.86
G0600750M0006,STCTY-06075 TRACT-  M 0006     IN SAN FRANCISCO CA,10632,10587,45,7786,17,3662,31.66
G0600750M0007,STCTY-06075 TRACT-  M 0007     IN SAN FRANCISCO CA,6524,6520,4,5076,2,4774,35.97
G0600750M0008,STCTY-06075 TRACT-  M 0008     IN SAN FRANCISCO CA,6942,6942,0,5555,0,5005,35.01
G0600750M0009,STCTY-06075 TRACT-  M 0009     IN SAN FRANCISCO CA,6223,6222,1,5037,1,4451,38.3
G0600750M0010,STCTY-06075 TRACT-  M 0010     IN SAN FRANCISCO CA,638,638,0,479,0,0,0
G0600750M0011,STCTY-06075 TRACT-  M 0011     IN SAN FRANCISCO CA,4086,4079,7,3096,4,3221,29.44
G0600750N0001,STCTY-06075 TRACT-  N 0001     IN SAN FRANCISCO CA,4549,4530,19,3494,2,0,24.01
G0600750N0002,STCTY-06075 TRACT-  N 0002     IN SAN FRANCISCO CA,5273,5260,13,4175,0,3594,30.77
G0600750N0003,STCTY-06075 TRACT-  N 0003     IN SAN FRANCISCO CA,3692,3688,4,2798,2,3583,30.37
G0600750N0004,STCTY-06075 TRACT-  N 0004     IN SAN FRANCISCO CA,4288,4274,14,3436,2,4679,31.78
G0600750N0005,STCTY-06075 TRACT-  N 0005     IN SAN FRANCISCO CA,6654,6653,1,5225,0,3844,31.31
G0600750N0006,STCTY-06075 TRACT-  N 0006     IN SAN FRANCISCO CA,5922,5909,13,4642,3,3686,31.15
G0600750N0007,STCTY-06075 TRACT-  N 0007     IN SAN FRANCISCO CA,6047,6044,3,4798,0,3630,33.02
G0600750N0008,STCTY-06075 TRACT-  N 0008     IN SAN FRANCISCO CA,5375,5340,35,4290,1,4069,24.88
G0600750N0009,STCTY-06075 TRACT-  N 0009     IN SAN FRANCISCO CA,4403,4380,23,3559,0,4173,28.8
G0600750N0010,STCTY-06075 TRACT-  N 0010     IN SAN FRANCISCO CA,4988,4977,11,4030,2,4300,30.75
G0600750N0011,STCTY-06075 TRACT-  N 0011     IN SAN FRANCISCO CA,4858,4857,1,3868,0,3674,32.77
G0600750N0012,STCTY-06075 TRACT-  N 0012     IN SAN FRANCISCO CA,6837,6834,3,5419,3,3670,31.89
G0600750N0013,STCTY-06075 TRACT-  N 0013     IN SAN FRANCISCO CA,1395,1374,21,1002,21,3295,27.1
G0600750N0014,STCTY-06075 TRACT-  N 0014     IN SAN FRANCISCO CA,6151,6138,13,4894,13,3983,31.6
G0600750N0015,STCTY-06075 TRACT-  N 0015     IN SAN FRANCISCO CA,5912,5894,18,4704,11,3621,30.61
G0600750O0001,STCTY-06075 TRACT-  O 0001     IN SAN FRANCISCO CA,7986,7865,121,5994,21,5715,37.52
G0600750O0002,STCTY-06075 TRACT-  O 0002     IN SAN FRANCISCO CA,6968,6945,23,5761,5,4895,39.14
G0600750O0003,STCTY-06075 TRACT-  O 0003     IN SAN FRANCISCO CA,9253,9216,37,7839,11,6693,50.19
G0600750O0004,STCTY-06075 TRACT-  O 0004     IN SAN FRANCISCO CA,7848,7796,52,6846,12,7022,60.84
G0600750O0005,STCTY-06075 TRACT-  O 0005     IN SAN FRANCISCO CA,6980,6978,2,5642,0,4787,37.85
G0600750O0006,STCTY-06075 TRACT-  O 0006     IN SAN FRANCISCO CA,3329,3319,10,2867,1,6885,63.25
G0600750O0007,STCTY-06075 TRACT-  O 0007     IN SAN FRANCISCO CA,6078,6016,62,5364,10,9376,77.95
G0600750O0008,STCTY-06075 TRACT-  O 0008     IN SAN FRANCISCO CA,4600,4591,9,3672,5,3967,32.3
G0600750O0009,STCTY-06075 TRACT-  O 0009     IN SAN FRANCISCO CA,5329,5306,23,4299,7,4027,35.21
G0600750P0001,STCTY-06075 TRACT-  P 0001     IN SAN FRANCISCO CA,10534,10509,25,8948,4,5947,48.77
G0600750P0002,STCTY-06075 TRACT-  P 0002     IN SAN FRANCISCO CA,8171,8168,3,7115,1,5491,50.78
G0600750P0003,STCTY-06075 TRACT-  P 0003     IN SAN FRANCISCO CA,6505,6491,14,5532,2,6076,48.63
G0600750Q0001,STCTY-06075 TRACT-  Q 0001     IN SAN FRANCISCO CA,6259,6252,7,5255,3,5208,35.21
G0600750R0001,STCTY-06075 TRACT-  R 0001     IN SAN FRANCISCO CA,176,168,8,149,0,0,0
G0600750S0001,STCTY-06075 TRACT-  S 0001     IN SAN FRANCISCO CA,1169,1037,132,762,19,0,0
G08003100001,STCTY-08031 TRACT-    0001     IN DENVER CO,6966,6961,5,6454,2,3062,31.63
G08003100002,STCTY-08031 TRACT-    0002     IN DENVER CO,2909,2909,0,2617,0,2576,32.2
G08003100003,STCTY-08031 TRACT-    0003     IN DENVER CO,14309,14298,11,13356,10,3328,32.59
G08003100004,STCTY-08031 TRACT-    0004     IN DENVER CO,9701,9693,8,8939,1,3369,32.28
G08003100005,STCTY-08031 TRACT-    0005     IN DENVER CO,3464,3461,3,3203,2,3621,31.82
G08003100006,STCTY-08031 TRACT-    0006     IN DENVER CO,6857,6857,0,6404,0,2421,23.64
G08003100007,STCTY-08031 TRACT-    0007     IN DENVER CO,4294,4283,11,2990,10,3592,35.22
G08003100008,STCTY-08031 TRACT-    0008     IN DENVER CO,3672,3641,31,2734,30,1199,20.17
G08003100009,STCTY-08031 TRACT-    0009     IN DENVER CO,4752,4716,36,4492,36,1782,21.63
G08003100010,STCTY-08031 TRACT-    0010     IN DENVER CO,4790,4767,23,4506,11,1813,21.57
G08003100011,STCTY-08031 TRACT-    0011     IN DENVER CO,11785,11770,15,9915,1,2008,21.72
G08003100012,STCTY-08031 TRACT-    0012     IN DENVER CO,4613,4517,96,4141,50,879,13.64
G08003100013,STCTY-08031 TRACT-    0013     IN DENVER CO,1947,1943,4,1860,4,1545,21.42
G08003100014,STCTY-08031 TRACT-    0014     IN DENVER CO,3612,3569,43,3374,33,1900,23.28
G08003100015,STCTY-08031 TRACT-    0015     IN DENVER CO,4605,4578,27,3528,27,1678,17.33
G08003100016,STCTY-08031 TRACT-    0016     IN DENVER CO,4626,4296,330,3786,185,0,12.61
G08003100017,STCTY-08031 TRACT-    0017     IN DENVER CO,11752,11561,191,10166,36,0,16.23
G08003100018,STCTY-08031 TRACT-    0018     IN DENVER CO,4067,4033,34,3759,32,0,22.63
G08003100019,STCTY-08031 TRACT-    0019     IN DENVER CO,7816,7797,19,7244,13,0,22.4
G08003100020,STCTY-08031 TRACT-    0020     IN DENVER CO,5660,5648,12,5284,7,3,20.07
G08003100021,STCTY-08031 TRACT-    0021     IN DENVER CO,7378,7368,10,7002,5,1,25.4
G08003100022,STCTY-08031 TRACT-    0022     IN DENVER CO,6289,6044,245,5577,104,0,15.79
G08003100023,STCTY-08031 TRACT-    0023     IN DENVER CO,7889,4140,3749,3814,3728,3,26.7
G08003100024,STCTY-08031 TRACT-    0024     IN DENVER CO,10273,7534,2739,7077,2692,1,17.95
G08003100025,STCTY-08031 TRACT-    0025     IN DENVER CO,3459,3392,67,3186,48,0,17.04
G08003100026,STCTY-08031 TRACT-    0026     IN DENVER CO,12458,12392,66,11644,48,3613,29.88
G08003100027,STCTY-08031 TRACT-    0027     IN DENVER CO,17365,17317,48,16343,37,4656,35.76
G08003100028,STCTY-08031 TRACT-    0028     IN DENVER CO,11743,11731,12,11002,8,3481,33.89
G08003100029,STCTY-08031 TRACT-    0029     IN DENVER CO,12311,12304,7,11570,4,3611,34.24
G08003100030,STCTY-08031 TRACT-    0030     IN DENVER CO,13820,13783,37,12979,34,3388,34.76
G08003100031,STCTY-08031 TRACT-    0031     IN DENVER CO,11529,11359,170,10612,164,4336,34.1
G08003100032,STCTY-08031 TRACT-    0032     IN DENVER CO,8372,8278,94,7722,80,6588,48.26
G08003100033,STCTY-08031 TRACT-    0033     IN DENVER CO,3942,3915,27,3583,24,6221,61.86
G08003100034,STCTY-08031 TRACT-    0034     IN DENVER CO,8847,8833,14,8344,11,4830,48.6
G08003100035,STCTY-08031 TRACT-    0035     IN DENVER CO,4687,4673,14,4282,14,1559,19.26
G08003100036,STCTY-08031 TRACT-    0036     IN DENVER CO,12482,12394,88,11391,86,3179,25.4
G08003100037,STCTY-08031 TRACT-    0037     IN DENVER CO,11745,11739,6,10824,1,4341,44.68
G08003100038,STCTY-08031 TRACT-    0038     IN DENVER CO,3511,3393,118,3125,112,2510,32.95
G08003100039,STCTY-08031 TRACT-    0039     IN DENVER CO,3254,3235,19,3069,13,4927,37.69
G08003100040,STCTY-08031 TRACT-    0040     IN DENVER CO,2582,2581,1,2458,1,3940,37.35
G08003100041,STCTY-08031 TRACT-    0041     IN DENVER CO,2493,2469,24,2317,15,5318,56.95
G08003100042,STCTY-08031 TRACT-    0042     IN DENVER CO,11301,11234,67,10635,54,6468,58.27
G08003100043,STCTY-08031 TRACT-    0043     IN DENVER CO,8065,8003,62,7541,48,6941,57.95
G08003100044,STCTY-08031 TRACT-    0044     IN DENVER CO,4420,4401,19,4204,15,3265,0
G09000300001,STCTY-09003 TRACT-    0001     IN HARTFORD CT,4036,4016,20,3160,20,3769,41.5
G09000300002,STCTY-09003 TRACT-    0002     IN HARTFORD CT,2585,2585,0,2027,0,0,38.41
G09000300003,STCTY-09003 TRACT-    0003     IN HARTFORD CT,8106,8101,5,6325,3,0,34.76
G09000300004,STCTY-09003 TRACT-    0004     IN HARTFORD CT,2105,2104,1,1734,1,0,38.13
G09000300005,STCTY-09003 TRACT-    0005     IN HARTFORD CT,4048,4045,3,3082,1,0,24.94
G09000300006,STCTY-09003 TRACT-    0006     IN HARTFORD CT,3148,3133,15,1913,15,0,26.09
G09000300007,STCTY-09003 TRACT-    0007     IN HARTFORD CT,4323,3513,810,2299,810,0,23.2
G09000300008,STCTY-09003 TRACT-    0008     IN HARTFORD CT,1627,955,672,647,669,0,32.77
G09000300009,STCTY-09003 TRACT-    0009     IN HARTFORD CT,3967,981,2986,682,2986,0,30.32
G09000300010,STCTY-09003 TRACT-    0010     IN HARTFORD CT,3387,3205,182,2591,182,5361,39.74
G09000300011,STCTY-09003 TRACT-    0011     IN HARTFORD CT,6771,6075,696,4182,689,3322,35.92
G09000300012,STCTY-09003 TRACT-    0012     IN HARTFORD CT,4053,4043,10,2833,10,3927,46.61
G09000300013,STCTY-09003 TRACT-    0013     IN HARTFORD CT,5310,5186,124,3539,123,4410,46.8
G09000300014,STCTY-09003 TRACT-    0014     IN HARTFORD CT,2601,2539,62,1839,61,0,24.69
G09000300015,STCTY-09003 TRACT-    0015     IN HARTFORD CT,3481,2982,499,2163,499,0,33.17
G09000300016,STCTY-09003 TRACT-    0016     IN HARTFORD CT,6248,5523,725,3865,723,0,36.21
G09000300017,STCTY-09003 TRACT-    0017     IN HARTFORD CT,1719,1719,0,1346,0,0,37.48
G09000300018,STCTY-09003 TRACT-    0018     IN HARTFORD CT,2317,2317,0,1934,0,0,31.52
G09000300019,STCTY-09003 TRACT-    0019     IN HARTFORD CT,2834,2814,20,2326,9,0,37.72
G09000300020,STCTY-09003 TRACT-    0020     IN HARTFORD CT,4155,4135,20,3312,20,5377,48.13
G09000300021,STCTY-09003 TRACT-    0021     IN HARTFORD CT,7052,6958,94,5392,86,3725,41.36
G09000300022,STCTY-09003 TRACT-    0022     IN HARTFORD CT,2322,2312,10,1842,5,3964,42.5
G09000300023,STCTY-09003 TRACT-    0023     IN HARTFORD CT,5486,5486,0,4763,0,5644,51.7
G09000300024,STCTY-09003 TRACT-    0024     IN HARTFORD CT,5545,5539,6,4484,5,4060,42.65
G09000300025,STCTY-09003 TRACT-    0025     IN HARTFORD CT,5965,5946,19,4229,18,3615,32.89
G09000300026,STCTY-09003 TRACT-    0026     IN HARTFORD CT,4364,4364,0,3121,0,0,35.63
G09000300027,STCTY-09003 TRACT-    0027     IN HARTFORD CT,4462,4460,2,3070,0,3146,35.16
G09000300028,STCTY-09003 TRACT-    0028     IN HARTFORD CT,5001,4996,5,4190,5,9155,44.53
G09000300029,STCTY-09003 TRACT-    0029     IN HARTFORD CT,1739,1737,2,1415,2,0,29.24
G09000300030,STCTY-09003 TRACT-    0030     IN HARTFORD CT,2145,2143,2,1854,2,0,48.71
G09000300031,STCTY-09003 TRACT-    0031     IN HARTFORD CT,3670,3667,3,3157,3,6360,47.97
G09000300032,STCTY-09003 TRACT-    0032     IN HARTFORD CT,2238,2213,25,1667,25,0,46.23
G09000300033,STCTY-09003 TRACT-    0033     IN HARTFORD CT,636,627,9,479,7,20000,0
G09000300034,STCTY-09003 TRACT-    0034     IN HARTFORD CT,4515,4470,45,3321,44,4136,46.52
G09000300035,STCTY-09003 TRACT-    0035     IN HARTFORD CT,6791,6775,16,5454,16,6828,56.72
G09000300036,STCTY-09003 TRACT-    0036     IN HARTFORD CT,2232,2228,4,1779,0,0,37.35
G09000300037,STCTY-09003 TRACT-    0037     IN HARTFORD CT,5157,5138,19,4454,16,8641,47.64
G09000300038,STCTY-09003 TRACT-    0038     IN HARTFORD CT,3989,3985,4,2998,4,3459,36.97
G09000300039,STCTY-09003 TRACT-    0039     IN HARTFORD CT,4599,4570,29,3820,28,9529,45.39
G09000300040,STCTY-09003 TRACT-    0040     IN HARTFORD CT,7523,7520,3,6255,3,5564,52.01
G09000300041,STCTY-09003 TRACT-    0041     IN HARTFORD CT,4015,4014,1,2971,0,4270,39.47
G0900030C0001,STCTY-09003 TRACT-  C 0001     IN HARTFORD CT ADJ AREA,3160,3159,1,2500,1,6087,45.85
G0900030C0002,STCTY-09003 TRACT-  C 0002     IN HARTFORD CT ADJ AREA,4553,4538,15,4218,14,1080,90.68
G0900030C0003,STCTY-09003 TRACT-  C 0003     IN HARTFORD CT ADJ AREA,5992,5991,1,4472,1,5974,50.84
G0900030C0004,STCTY-09003 TRACT-  C 0004     IN HARTFORD CT ADJ AREA,7213,7194,19,6041,18,7789,57.12
G0900030C0005,STCTY-09003 TRACT-  C 0005     IN HARTFORD CT ADJ AREA,7108,7053,55,6287,51,11525,75.59
G0900030C0006,STCTY-09003 TRACT-  C 0006     IN HARTFORD CT ADJ AREA,5750,5682,68,5108,66,12275,71.08
G0900030C0007,STCTY-09003 TRACT-  C 0007     IN HARTFORD CT ADJ AREA,4309,4179,130,3587,126,5746,40.96
G0900030C0008,STCTY-09003 TRACT-  C 0008     IN HARTFORD CT ADJ AREA,6860,6769,91,5786,90,5588,43.66
G0900030C0009,STCTY-09003 TRACT-  C 0009     IN HARTFORD CT ADJ AREA,3208,3088,120,2564,120,3640,23.57
G0900030C0010,STCTY-09003 TRACT-  C 0010     IN HARTFORD CT ADJ AREA,3391,3382,9,2842,9,5322,40.94
G0900030C0011,STCTY-09003 TRACT-  C 0011     IN HARTFORD CT ADJ AREA,6406,6344,62,5480,59,4905,38.6
G0900030C0012,STCTY-09003 TRACT-  C 0012     IN HARTFORD CT ADJ AREA,4750,4740,10,3993,10,5421,40.8
G0900030C0013,STCTY-09003 TRACT-  C 0013     IN HARTFORD CT ADJ AREA,4068,4060,8,3472,8,5136,41.55
G0900030C0014,STCTY-09003 TRACT-  C 0014     IN HARTFORD CT ADJ AREA,3923,3802,121,3376,118,7436,49.14
G0900030C0015,STCTY-09003 TRACT-  C 0015     IN HARTFORD CT ADJ AREA,5721,5693,28,4899,28,6842,57.95
G0900030C0016,STCTY-09003 TRACT-  C 0016     IN HARTFORD CT ADJ AREA,5449,5428,21,4458,21,5204,39.37
G09000900001,STCTY-09009 TRACT-    0001     IN NEW HAVEN CT,1949,1933,16,1584,5,0,36.49
G09000900002,STCTY-09009 TRACT-    0002     IN NEW HAVEN CT,3973,3627,346,2728,325,5781,32.93
G09000900003,STCTY-09009 TRACT-    0003     IN NEW HAVEN CT,5513,5445,68,3966,67,3755,40.56
G09000900004,STCTY-09009 TRACT-    0004     IN NEW HAVEN CT,5776,5704,72,3968,63,3152,29.53
G09000900005,STCTY-09009 TRACT-    0005     IN NEW HAVEN CT,3936,3665,271,2672,260,2863,22.3
G09000900006,STCTY-09009 TRACT-    0006     IN NEW HAVEN CT,7037,7030,7,5278,5,2608,28.29
G09000900007,STCTY-09009 TRACT-    0007     IN NEW HAVEN CT,7170,7153,17,5134,17,3226,25.57
G09000900008,STCTY-09009 TRACT-    0008     IN NEW HAVEN CT,5049,5038,11,3893,3,2765,29.64
G09000900009,STCTY-09009 TRACT-    0009     IN NEW HAVEN CT,4213,4205,8,3529,8,3594,35.74
G09000900010,STCTY-09009 TRACT-    0010     IN NEW HAVEN CT,4720,4677,43,3434,43,2492,23.3
G09000900011,STCTY-09009 TRACT-    0011     IN NEW HAVEN CT,6251,6187,64,4550,64,2914,23.18
G09000900012,STCTY-09009 TRACT-    0012     IN NEW HAVEN CT,8380,8171,209,6056,207,2481,21.92
G09000900013,STCTY-09009 TRACT-    0013     IN NEW HAVEN CT,4055,4041,14,3133,13,5548,38.19
G09000900014,STCTY-09009 TRACT-    0014     IN NEW HAVEN CT,4016,4013,3,3246,2,3227,35.03
G09000900015,STCTY-09009 TRACT-    0015     IN NEW HAVEN CT,3642,3600,42,3056,36,8698,63.87
G09000900016,STCTY-09009 TRACT-    0016     IN NEW HAVEN CT,5789,5712,77,4667,77,3570,32.64
G09000900017,STCTY-09009 TRACT-    0017     IN NEW HAVEN CT,5865,5697,168,4638,165,3553,32.31
G09000900018,STCTY-09009 TRACT-    0018     IN NEW HAVEN CT,3407,3344,63,2812,63,15568,46.64
G09000900019,STCTY-09009 TRACT-    0019     IN NEW HAVEN CT,5075,1739,3336,1355,3334,3214,26.46
G09000900020,STCTY-09009 TRACT-    0020     IN NEW HAVEN CT,2494,2204,290,1766,287,3933,32.14
G09000900021,STCTY-09009 TRACT-    0021     IN NEW HAVEN CT,3175,3004,171,2549,164,5318,38.78
G09000900022,STCTY-09009 TRACT-    0022     IN NEW HAVEN CT,4348,3545,803,2807,791,3945,38.21
G09000900023,STCTY-09009 TRACT-    0023     IN NEW HAVEN CT,5027,4991,36,4107,36,6516,49.89
G09000900024,STCTY-09009 TRACT-    0024     IN NEW HAVEN CT,4952,4929,23,4144,23,7967,52.22
G09000900025,STCTY-09009 TRACT-    0025     IN NEW HAVEN CT,7889,7819,70,6172,69,2510,28.29
G09000900026,STCTY-09009 TRACT-    0026     IN NEW HAVEN CT,3657,3654,3,3129,3,3491,33.23
G09000900027,STCTY-09009 TRACT-    0027     IN NEW HAVEN CT,5968,5938,30,4653,30,2370,26.91
G09000900028,STCTY-09009 TRACT-    0028     IN NEW HAVEN CT,5852,5847,5,4787,4,3327,30.55
G09000900029,STCTY-09009 TRACT-    0029     IN NEW HAVEN CT,4848,4834,14,3914,12,4725,41.11
G09000900030,STCTY-09009 TRACT-    0030     IN NEW HAVEN CT,4985,4961,24,4516,24,9509,60.73
G09000900031,STCTY-09009 TRACT-    0031     IN NEW HAVEN CT,3682,3677,5,3133,5,4215,32.67
G09000900032,STCTY-09009 TRACT-    0032     IN NEW HAVEN CT,5340,5309,31,4327,27,4700,32.95
G09000900033,STCTY-09009 TRACT-    0033     IN NEW HAVEN CT,2572,2569,3,2169,3,5446,46.35
G11000100001,STCTY-11001 TRACT-    0001     IN WASHINGTON DC,8278,5950,2328,5563,2316,10850,44.8
G11000100002,STCTY-11001 TRACT-    0002     IN WASHINGTON DC,6680,5750,930,5377,899,7602,44.8
G11000100003,STCTY-11001 TRACT-    0003     IN WASHINGTON DC,6117,6074,43,5753,40,8178,61.42
G11000100004,STCTY-11001 TRACT-    0004     IN WASHINGTON DC,1490,1373,117,1277,111,20000,0
G11000100005,STCTY-11001 TRACT-    0005     IN WASHINGTON DC,7531,7326,205,6866,193,13564,67.59
G11000100006,STCTY-11001 TRACT-    0006     IN WASHINGTON DC,5509,5305,204,5025,200,13164,65.53
G11000100007,STCTY-11001 TRACT-    0007     IN WASHINGTON DC,4908,4829,79,4580,79,13042,76.28
G11000100008,STCTY-11001 TRACT-    0008     IN WASHINGTON DC,4552,4368,184,4189,179,13402,58.41
G11000100009,STCTY-11001 TRACT-    0009     IN WASHINGTON DC,3514,3282,232,3131,227,9333,53.67
G11000100010,STCTY-11001 TRACT-    0010     IN WASHINGTON DC,6493,6370,123,6353,119,10286,63.97
G11000100011,STCTY-11001 TRACT-    0011     IN WASHINGTON DC,5423,5086,337,4830,332,12000,66.8
G11000100012,STCTY-11001 TRACT-    0012     IN WASHINGTON DC,4242,4156,86,3967,78,11548,66.67
G11000100013,STCTY-11001 TRACT-    0013     IN WASHINGTON DC,3298,3161,137,2947,135,19077,77.99
G11000100014,STCTY-11001 TRACT-    0014     IN WASHINGTON DC,5754,5662,92,5326,87,12304,95.93
G11000100015,STCTY-11001 TRACT-    0015     IN WASHINGTON DC,3921,3807,114,3635,113,12561,10
G11000100016,STCTY-11001 TRACT-    0016     IN WASHINGTON DC,3684,3494,190,3289,188,15235,55.5
G11000100017,STCTY-11001 TRACT-    0017     IN WASHINGTON DC,5251,5047,204,4734,199,9230,53.69
G11000100018,STCTY-11001 TRACT-    0018     IN WASHINGTON DC,5204,4954,250,4519,245,11227,56.46
G11000100019,STCTY-11001 TRACT-    0019     IN WASHINGTON DC,8648,8620,28,7987,20,8233,63.63
G11000100020,STCTY-11001 TRACT-    0020     IN WASHINGTON DC,7275,7150,125,6632,123,12361,57.92
G11000100021,STCTY-11001 TRACT-    0021     IN WASHINGTON DC,13278,13176,102,12076,97,7852,53.46
G11000100022,STCTY-11001 TRACT-    0022     IN WASHINGTON DC,9685,9630,55,8584,52,7349,55.24
G11000100023,STCTY-11001 TRACT-    0023     IN WASHINGTON DC,6007,5903,104,5188,103,7609,53.55
G11000100024,STCTY-11001 TRACT-    0024     IN WASHINGTON DC,5394,5364,30,4893,19,7241,56.35
G11000100025,STCTY-11001 TRACT-    0025     IN WASHINGTON DC,9036,8890,146,7759,133,8572,53.78
G11000100026,STCTY-11001 TRACT-    0026     IN WASHINGTON DC,1952,1896,56,1690,51,17975,0
G11000100027,STCTY-11001 TRACT-    0027     IN WASHINGTON DC,10341,10164,177,9437,171,9119,56.27
G11000100028,STCTY-11001 TRACT-    0028     IN WASHINGTON DC,7398,7193,205,6589,193,8438,49.58
G11000100029,STCTY-11001 TRACT-    0029     IN WASHINGTON DC,5580,5323,257,4860,253,6935,48.55
G11000100030,STCTY-11001 TRACT-    0030     IN WASHINGTON DC,4980,2989,1991,2820,1990,8362,40.6
G11000100031,STCTY-11001 TRACT-    0031     IN WASHINGTON DC,5267,731,4536,594,4533,6694,47.29
G11000100032,STCTY-11001 TRACT-    0032     IN WASHINGTON DC,7859,6250,1609,5035,1604,6381,46.53
G11000100033,STCTY-11001 TRACT-    0033     IN WASHINGTON DC,9487,5472,4015,5132,3996,6609,50.36
G11000100034,STCTY-11001 TRACT-    0034     IN WASHINGTON DC,6802,96,6706,64,6700,6756,45.47
G11000100035,STCTY-11001 TRACT-    0035     IN WASHINGTON DC,4753,325,4428,281,4428,6768,42.22
G11000100036,STCTY-11001 TRACT-    0036     IN WASHINGTON DC,6138,5051,1087,4753,1086,8799,46.11
G11000100037,STCTY-11001 TRACT-    0037     IN WASHINGTON DC,5585,5054,531,4695,530,8460,51.11
G11000100038,STCTY-11001 TRACT-    0038     IN WASHINGTON DC,5714,3348,2366,2996,2341,6675,50.15
G11000100039,STCTY-11001 TRACT-    0039     IN WASHINGTON DC,5099,4931,168,4583,155,8674,56.52
G11000100040,STCTY-11001 TRACT-    0040     IN WASHINGTON DC,8528,6992,1536,6525,1520,12122,57.94
G11000100041,STCTY-11001 TRACT-    0041     IN WASHINGTON DC,4042,3738,304,3442,297,20000,69.59
G11000100042,STCTY-11001 TRACT-    0042     IN WASHINGTON DC,10785,4354,6431,4039,6405,8768,45.87
G11000100043,STCTY-11001 TRACT-    0043     IN WASHINGTON DC,5751,1766,3985,1609,3983,6955,51.6
G11000100044,STCTY-11001 TRACT-    0044     IN WASHINGTON DC,5594,150,5444,115,5439,6838,38.9
G11000100045,STCTY-11001 TRACT-    0045     IN WASHINGTON DC,3639,64,3575,38,3566,6405,42.25
G11000100046,STCTY-11001 TRACT-    0046     IN WASHINGTON DC,8235,1723,6512,1548,6503,5620,37.56
G11000100047,STCTY-11001 TRACT-    0047     IN WASHINGTON DC,11118,3252,7866,2759,7844,6112,31.81
G11000100048,STCTY-11001 TRACT-    0048     IN WASHINGTON DC,12721,408,12313,292,12303,6182,33.7
G11000100049,STCTY-11001 TRACT-    0049     IN WASHINGTON DC,12491,3840,8651,3349,8624,6658,33.62
G11000100050,STCTY-11001 TRACT-    0050     IN WASHINGTON DC,10363,4763,5600,4402,5580,8516,37.28
G11000100051,STCTY-11001 TRACT-    0051     IN WASHINGTON DC,3956,3770,186,3449,137,0,38.33
G11000100052,STCTY-11001 TRACT-    0052     IN WASHINGTON DC,9456,6236,3220,5804,3202,8344,46.33
G11000100053,STCTY-11001 TRACT-    0053     IN WASHINGTON DC,10833,9518,1315,8795,1296,10690,52.32
G11000100054,STCTY-11001 TRACT-    0054     IN WASHINGTON DC,10307,7814,2493,7299,2408,8843,47.73
G11000100055,STCTY-11001 TRACT-    0055     IN WASHINGTON DC,8776,5199,3577,4736,3546,9591,44.37
G11000100056,STCTY-11001 TRACT-    0056     IN WASHINGTON DC,6240,2286,3954,2161,3918,5846,35.54
G11000100057,STCTY-11001 TRACT-    0057     IN WASHINGTON DC,11249,9485,1764,8962,1717,10634,48.42
G11000100058,STCTY-11001 TRACT-    0058     IN WASHINGTON DC,4927,4612,315,4056,118,0,29.75
G11000100059,STCTY-11001 TRACT-    0059     IN WASHINGTON DC,9013,5770,3243,5098,3196,6931,24.13
G11000100060,STCTY-11001 TRACT-    0060     IN WASHINGTON DC,10106,988,9118,793,9112,4455,23.99
G11000100061,STCTY-11001 TRACT-    0061     IN WASHINGTON DC,6632,5226,1406,4870,1385,5641,31.13
G11000100062,STCTY-11001 TRACT-    0062     IN WASHINGTON DC,5169,3828,1341,3616,1318,4924,32.28
G11000100063,STCTY-11001 TRACT-    0063     IN WASHINGTON DC,4808,2208,2600,2098,2594,0,30.48
G11000100064,STCTY-11001 TRACT-    0064     IN WASHINGTON DC,2634,214,2420,196,2415,0,28.49
G11000100065,STCTY-11001 TRACT-    0065     IN WASHINGTON DC,7057,5336,1721,5007,1684,5946,38.54
G11000100066,STCTY-11001 TRACT-    0066     IN WASHINGTON DC,4311,3821,490,3627,481,7268,38
G11000100067,STCTY-11001 TRACT-    0067     IN WASHINGTON DC,7028,5873,1155,5623,1139,6285,39.64
G11000100068,STCTY-11001 TRACT-    0068     IN WASHINGTON DC,8869,7497,1372,7214,1361,6244,41.24
G11000100069,STCTY-11001 TRACT-    0069     IN WASHINGTON DC,5393,4323,1070,4096,1060,5329,41.27
G11000100070,STCTY-11001 TRACT-    0070     IN WASHINGTON DC,6779,5404,1375,5146,1315,4610,37.1
G11000100071,STCTY-11001 TRACT-    0071     IN WASHINGTON DC,4452,3952,500,3773,499,5070,35.85
G11000100072,STCTY-11001 TRACT-    0072     IN WASHINGTON DC,7183,1492,5691,1415,5671,0,27.34
G11000100073,STCTY-11001 TRACT-    0073     IN WASHINGTON DC,7379,6605,774,6382,768,5556,44.07
G11000100074,STCTY-11001 TRACT-    0074     IN WASHINGTON DC,3962,440,3522,416,3521,3982,29.39
G11000100075,STCTY-11001 TRACT-    0075     IN WASHINGTON DC,5646,4905,741,4723,741,4805,45.12
G11000100076,STCTY-11001 TRACT-    0076     IN WASHINGTON DC,9853,9831,22,9424,22,6748,47.6
G11000100077,STCTY-11001 TRACT-    0077     IN WASHINGTON DC,5976,4137,1839,3971,1818,6037,46.63
G11000100078,STCTY-11001 TRACT-    0078     IN WASHINGTON DC,12379,2598,9781,2412,9777,4487,35.87
G11000100079,STCTY-11001 TRACT-    0079     IN WASHINGTON DC,8865,5417,3448,5147,3446,5696,43.22
G11000100080,STCTY-11001 TRACT-    0080     IN WASHINGTON DC,11533,9392,2141,8932,2137,5485,42.37
G11000100081,STCTY-11001 TRACT-    0081     IN WASHINGTON DC,5021,4697,324,4503,308,5694,41.58
G11000100082,STCTY-11001 TRACT-    0082     IN WASHINGTON DC,6903,6249,654,5942,651,6668,41.76
G11000100083,STCTY-11001 TRACT-    0083     IN WASHINGTON DC,10753,8461,2292,7777,2266,5780,40.16
G11000100084,STCTY-11001 TRACT-    0084     IN WASHINGTON DC,8326,5542,2784,4950,2749,5748,40.39
G11000100085,STCTY-11001 TRACT-    0085     IN WASHINGTON DC,8196,5436,2760,4863,2736,5380,40.21
G11000100086,STCTY-11001 TRACT-    0086     IN WASHINGTON DC,5261,1520,3741,1345,3719,0,32.92
G11000100087,STCTY-11001 TRACT-    0087     IN WASHINGTON DC,6978,6731,247,6304,236,5975,48.35
G11000100088,STCTY-11001 TRACT-    0088     IN WASHINGTON DC,12533,10252,2281,9572,2260,5658,43.93
G11000100089,STCTY-11001 TRACT-    0089     IN WASHINGTON DC,3944,2738,1206,2602,1206,5660,41.47
G11000100090,STCTY-11001 TRACT-    0090     IN WASHINGTON DC,2333,2207,126,2122,126,6827,46.22
G11000100091,STCTY-11001 TRACT-    0091     IN WASHINGTON DC,5861,5828,33,5590,32,7099,49.09
G11000100092,STCTY-11001 TRACT-    0092     IN WASHINGTON DC,7032,6996,36,6608,34,6907,53.02
G11000100093,STCTY-11001 TRACT-    0093     IN WASHINGTON DC,7758,6997,761,6583,754,7670,50.4
G11000100094,STCTY-11001 TRACT-    0094     IN WASHINGTON DC,5619,5605,14,5386,8,8539,55.93
G11000100095,STCTY-11001 TRACT-    0095     IN WASHINGTON DC,7764,7649,115,7191,110,9330,51.78
G11000100096,STCTY-11001 TRACT-    0096     IN WASHINGTON DC,6644,4641,2003,3906,1887,0,0
G13002100001,STCTY-13021 TRACT-    0001     IN MACON GA,5632,355,5277,350,5277,1103,9.96
G13002100002,STCTY-13021 TRACT-    0002     IN MACON GA,3899,2835,1064,2795,1064,5049,17.1
G13002100003,STCTY-13021 TRACT-    0003     IN MACON GA,5808,4853,955,4806,955,3624,16.98
G13002100004,STCTY-13021 TRACT-    0004     IN MACON GA,2030,1529,501,1518,501,2250,16.88
G13002100005,STCTY-13021 TRACT-    0005     IN MACON GA,1829,519,1310,515,1310,0,12.57
G13002100006,STCTY-13021 TRACT-    0006     IN MACON GA,4476,3172,1304,3135,1304,2563,15.47
G13002100007,STCTY-13021 TRACT-    0007     IN MACON GA,5162,4368,794,4274,793,3932,19.32
G13002100008,STCTY-13021 TRACT-    0008     IN MACON GA,4813,3009,1804,2951,1798,2706,14.55
G13002100009,STCTY-13021 TRACT-    0009     IN MACON GA,215,0,215,0,215,0,0
G13002100010,STCTY-13021 TRACT-    0010     IN MACON GA,3,3,0,3,0,0,0
G13002100011,STCTY-13021 TRACT-    0011     IN MACON GA,768,725,43,715,43,4500,0
G13002100012,STCTY-13021 TRACT-    0012     IN MACON GA,1918,276,1642,272,1642,1068,10.59
G13002100013,STCTY-13021 TRACT-    0013     IN MACON GA,2401,442,1959,433,1959,0,9.88
G13002100014,STCTY-13021 TRACT-    0014     IN MACON GA,6302,3411,2891,3385,2890,1958,10.92
G13002100015,STCTY-13021 TRACT-    0015     IN MACON GA,6027,4192,1835,4182,1835,1573,13.62
G13002100016,STCTY-13021 TRACT-    0016     IN MACON GA,3038,167,2871,164,2871,0,8.08
G13002100017,STCTY-13021 TRACT-    0017     IN MACON GA,3544,2397,1147,2389,1147,1634,11.66
G1300210C0001,STCTY-13021 TRACT-  C 0001     IN MACON GA ADJ AREA,3663,2416,1247,2401,1247,4000,11.54
G1300210C0002,STCTY-13021 TRACT-  C 0002     IN MACON GA ADJ AREA,1187,718,469,718,469,0,0
G1300210C0003,STCTY-13021 TRACT-  C 0003     IN MACON GA ADJ AREA,5446,4275,1171,4256,1171,2630,14.05
G1300210C0004,STCTY-13021 TRACT-  C 0004     IN MACON GA ADJ AREA,4687,2536,2151,2524,2151,1581,9.91
G1300210C0005,STCTY-13021 TRACT-  C 0005     IN MACON GA ADJ AREA,2300,1860,440,1858,440,2185,16.79
G1300210C0006,STCTY-13021 TRACT-  C 0006     IN MACON GA ADJ AREA,4532,2028,2504,2022,2504,1173,11.82
G1300210C0007,STCTY-13021 TRACT-  C 0007     IN MACON GA ADJ AREA,1751,889,862,889,862,0,0
G1300210C0008,STCTY-13021 TRACT-  C 0008     IN MACON GA ADJ AREA,2352,1264,1088,1261,1088,0,0
G13005100001,STCTY-13051 TRACT-    0001     IN SAVANNAH GA,1626,26,1600,20,1600,0,0
G13005100002,STCTY-13051 TRACT-    0002     IN SAVANNAH GA,2153,183,1970,174,1965,0,10.75
G13005100003,STCTY-13051 TRACT-    0003     IN SAVANNAH GA,2841,2565,276,2389,273,0,16.32
G13005100004,STCTY-13051 TRACT-    0004     IN SAVANNAH GA,2940,2529,411,2414,401,0,20.78
G13005100005,STCTY-13051 TRACT-    0005     IN SAVANNAH GA,4775,1344,3431,1277,3425,0,10.91
G13005100006,STCTY-13051 TRACT-    0006     IN SAVANNAH GA,4640,697,3943,676,3942,1089,10.63
G13005100007,STCTY-13051 TRACT-    0007     IN SAVANNAH GA,4568,43,4525,39,4525,0,11.2
G13005100008,STCTY-13051 TRACT-    0008     IN SAVANNAH GA,3745,2866,879,2820,871,0,14.18
G13005100009,STCTY-13051 TRACT-    0009     IN SAVANNAH GA,2770,2571,199,2452,197,5444,22.07
G13005100010,STCTY-13051 TRACT-    0010     IN SAVANNAH GA,3678,318,3360,280,3360,0,12.86
G13005100011,STCTY-13051 TRACT-    0011     IN SAVANNAH GA,3503,341,3162,318,3162,1811,12.39
G13005100012,STCTY-13051 TRACT-    0012     IN SAVANNAH GA,4049,37,4012,30,4012,0,13.72
G13005100013,STCTY-13051 TRACT-    0013     IN SAVANNAH GA,4075,2694,1381,2576,1374,0,17.67
G13005100014,STCTY-13051 TRACT-    0014     IN SAVANNAH GA,0,0,0,0,0,0,0
G13005100015,STCTY-13051 TRACT-    0015     IN SAVANNAH GA,2572,2338,234,2273,234,0,24.05
G13005100016,STCTY-13051 TRACT-    0016     IN SAVANNAH GA,9,9,0,9,0,0,0
G13005100017,STCTY-13051 TRACT-    0017     IN SAVANNAH GA,3248,337,2911,323,2911,0,14.63
G13005100018,STCTY-13051 TRACT-    0018     IN SAVANNAH GA,4062,3047,1015,2967,1012,2712,17.67
G13005100019,STCTY-13051 TRACT-    0019     IN SAVANNAH GA,3900,3689,211,3605,210,3711,21.08
G13005100020,STCTY-13051 TRACT-    0020     IN SAVANNAH GA,4138,1433,2705,1405,2705,1993,14.81
G13005100021,STCTY-13051 TRACT-    0021     IN SAVANNAH GA,3642,3202,440,3130,440,3246,34.29
G13005100022,STCTY-13051 TRACT-    0022     IN SAVANNAH GA,575,571,4,561,1,4692,0
G13005100023,STCTY-13051 TRACT-    0023     IN SAVANNAH GA,3691,1086,2605,1037,2605,2118,17.57
G13005100024,STCTY-13051 TRACT-    0024     IN SAVANNAH GA,3473,3367,106,3201,106,3750,28.63
G13005100025,STCTY-13051 TRACT-    0025     IN SAVANNAH GA,2296,2073,223,1983,223,3406,29.8
G13005100026,STCTY-13051 TRACT-    0026     IN SAVANNAH GA,2880,2780,100,2693,100,3558,31.4
G13005100027,STCTY-13051 TRACT-    0027     IN SAVANNAH GA,3501,3249,252,3145,248,3474,40.64
G13005100028,STCTY-13051 TRACT-    0028     IN SAVANNAH GA,2946,1449,1497,1423,1496,1836,15.14
G13005100029,STCTY-13051 TRACT-    0029     IN SAVANNAH GA,3033,2990,43,2882,43,7380,57.81
G13005100030,STCTY-13051 TRACT-    0030     IN SAVANNAH GA,2187,2173,14,2093,9,5841,55.31
G13005100031,STCTY-13051 TRACT-    0031     IN SAVANNAH GA,9,9,0,9,0,0,0
G13005100032,STCTY-13051 TRACT-    0032     IN SAVANNAH GA,1045,374,671,368,671,0,10.21
G13005100033,STCTY-13051 TRACT-    0033     IN SAVANNAH GA,530,4,526,4,526,0,0
G13005100034,STCTY-13051 TRACT-    0034     IN SAVANNAH GA,425,419,6,414,6,0,0
G13005100035,STCTY-13051 TRACT-    0035     IN SAVANNAH GA,406,172,234,172,234,0,0
G13005100036,STCTY-13051 TRACT-    0036     IN SAVANNAH GA,1215,865,350,852,350,1895,23.54
G13005100037,STCTY-13051 TRACT-    0037     IN SAVANNAH GA,850,850,0,830,0,2600,25.94
G1300510C0001,STCTY-13051 TRACT-  C 0001     IN SAVANNAH GA ADJ AREA,644,583,61,573,61,0,0
G1300510C0002,STCTY-13051 TRACT-  C 0002     IN SAVANNAH GA ADJ AREA,886,702,184,679,184,1574,20.04
G1300510C0003,STCTY-13051 TRACT-  C 0003     IN SAVANNAH GA ADJ AREA,5464,3623,1841,3551,1840,1790,12.2
G1300510C0004,STCTY-13051 TRACT-  C 0004     IN SAVANNAH GA ADJ AREA,4317,2002,2315,1973,2315,568,7.28
G1300510C0005,STCTY-13051 TRACT-  C 0005     IN SAVANNAH GA ADJ AREA,2575,1035,1540,1015,1540,418,7.57
G1300510C0006,STCTY-13051 TRACT-  C 0006     IN SAVANNAH GA ADJ AREA,736,648,88,646,88,0,0
G1300510C0007,STCTY-13051 TRACT-  C 0007     IN SAVANNAH GA ADJ AREA,7352,3734,3618,3690,3618,1167,7.06
G1300630CC0001,STCTY-13063 TRACT- CC 0001     IN ATLANTA GA ADJ AREA,338,338,0,334,0,0,0
G1300890D0001,STCTY-13089 TRACT-  D 0001     IN ATLANTA GA,1189,1143,46,1093,46,8533,0
G1300890D0002,STCTY-13089 TRACT-  D 0002     IN ATLANTA GA,2081,1945,136,1876,136,12092,46.91
G1300890D0003,STCTY-13089 TRACT-  D 0003     IN ATLANTA GA,3820,3751,69,3688,69,4452,33.82
G1300890D0004,STCTY-13089 TRACT-  D 0004     IN ATLANTA GA,4021,3781,240,3728,240,3364,31.48
G1300890D0005,STCTY-13089 TRACT-  D 0005     IN ATLANTA GA,3363,3357,6,3335,6,2394,25.21
G1300890D0006,STCTY-13089 TRACT-  D 0006     IN ATLANTA GA,2969,858,2111,850,2109,1963,14.23
G1300890D0007,STCTY-13089 TRACT-  D 0007     IN ATLANTA GA,2533,2512,21,2484,21,3014,30.71
G1300890D0008,STCTY-13089 TRACT-  D 0008     IN ATLANTA GA,4601,4526,75,4476,75,3564,34.61
G1300890D0009,STCTY-13089 TRACT-  D 0009     IN ATLANTA GA,4417,4375,42,4367,42,2676,24.78
G1300890DC0001,STCTY-13089 TRACT- DC 0001     IN ATLANTA GA ADJ AREA,694,540,154,537,154,0,0
G1300890DC0002,STCTY-13089 TRACT- DC 0002     IN ATLANTA GA ADJ AREA,1081,859,222,857,222,0,11.06
G1300890DC0003,STCTY-13089 TRACT- DC 0003     IN ATLANTA GA ADJ AREA,3394,2913,481,2889,477,1883,16.81
G1300890DC0004,STCTY-13089 TRACT- DC 0004     IN ATLANTA GA ADJ AREA,5867,5265,602,5149,602,7512,44.5
G1300890DC0005,STCTY-13089 TRACT- DC 0005     IN ATLANTA GA ADJ AREA,1848,1558,290,1554,290,1844,11.4
G1300890DC0006,STCTY-13089 TRACT- DC 0006     IN ATLANTA GA ADJ AREA,569,509,60,496,60,13900,0
G1300890DC0007,STCTY-13089 TRACT- DC 0007     IN ATLANTA GA ADJ AREA,5782,3054,2728,3020,2728,4379,18.46
G1300890DC0008,STCTY-13089 TRACT- DC 0008     IN ATLANTA GA ADJ AREA,4418,3991,427,3954,427,4977,36.28
G1300890DC0009,STCTY-13089 TRACT- DC 0009     IN ATLANTA GA ADJ AREA,4771,4741,30,4692,30,3528,36.8
G1300890DC0010,STCTY-13089 TRACT- DC 0010     IN ATLANTA GA ADJ AREA,1590,1469,121,1450,121,4315,42.17
G1300890DC0011,STCTY-13089 TRACT- DC 0011     IN ATLANTA GA ADJ AREA,569,543,26,533,26,0,0
G1300890DC0012,STCTY-13089 TRACT- DC 0012     IN ATLANTA GA ADJ AREA,4146,3037,1109,3025,1109,1556,11.88
G1300890DC0013,STCTY-13089 TRACT- DC 0013     IN ATLANTA GA ADJ AREA,156,143,13,142,13,0,0
G1300890DC0014,STCTY-13089 TRACT- DC 0014     IN ATLANTA GA ADJ AREA,1079,971,108,963,108,1313,0
G1300890DC0015,STCTY-13089 TRACT- DC 0015     IN ATLANTA GA ADJ AREA,2386,1806,580,1800,580,0,10.35
G1300890DC0016,STCTY-13089 TRACT- DC 0016     IN ATLANTA GA ADJ AREA,1385,1148,237,1147,237,0,0
G1301210F0001,STCTY-13121 TRACT-  F 0001     IN ATLANTA GA,4174,4121,53,3998,53,6768,54.21
G1301210F0002,STCTY-13121 TRACT-  F 0002     IN ATLANTA GA,6098,6006,92,5803,91,5754,56.79
G1301210F0003,STCTY-13121 TRACT-  F 0003     IN ATLANTA GA,108,104,4,104,4,0,0
G1301210F0004,STCTY-13121 TRACT-  F 0004     IN ATLANTA GA,4059,3834,225,3757,225,8854,52.04
G1301210F0005,STCTY-13121 TRACT-  F 0005     IN ATLANTA GA,3793,3635,158,3578,158,6711,55.03
G1301210F0006,STCTY-13121 TRACT-  F 0006     IN ATLANTA GA,4027,3726,301,3718,301,1512,19.68
G1301210F0007,STCTY-13121 TRACT-  F 0007     IN ATLANTA GA,2625,1996,629,1990,629,1720,16.55
G1301210F0008,STCTY-13121 TRACT-  F 0008     IN ATLANTA GA,5579,5183,396,5180,396,1614,15.21
G1301210F0009,STCTY-13121 TRACT-  F 0009     IN ATLANTA GA,3485,2870,615,2853,615,1441,14.74
G1301210F0010,STCTY-13121 TRACT-  F 0010     IN ATLANTA GA,3200,2931,269,2869,268,4136,24.01
G1301210F0011,STCTY-13121 TRACT-  F 0011     IN ATLANTA GA,3520,3284,236,3217,236,3897,40.3
G1301210F0012,STCTY-13121 TRACT-  F 0012     IN ATLANTA GA,6558,6146,412,6028,412,6092,44.02
G1301210F0013,STCTY-13121 TRACT-  F 0013     IN ATLANTA GA,6688,6396,292,6119,283,4303,39.76
G1301210F0014,STCTY-13121 TRACT-  F 0014     IN ATLANTA GA,2622,2571,51,2532,51,5202,45.17
G1301210F0015,STCTY-13121 TRACT-  F 0015     IN ATLANTA GA,6955,6752,203,6571,202,5093,45.01
G1301210F0016,STCTY-13121 TRACT-  F 0016     IN ATLANTA GA,3577,3473,104,3433,95,3837,36.13
G1301210F0017,STCTY-13121 TRACT-  F 0017     IN ATLANTA GA,6160,5408,752,5086,750,3008,29.88
G1301210F0018,STCTY-13121 TRACT-  F 0018     IN ATLANTA GA,9909,1684,8225,1577,8214,2282,14.43
G1301210F0019,STCTY-13121 TRACT-  F 0019     IN ATLANTA GA,4178,3188,990,3072,976,0,17.41
G1301210F0020,STCTY-13121 TRACT-  F 0020     IN ATLANTA GA,1929,1861,68,1848,68,0,0
G1301210F0021,STCTY-13121 TRACT-  F 0021     IN ATLANTA GA,3109,2803,306,2766,306,0,13.78
G1301210F0022,STCTY-13121 TRACT-  F 0022     IN ATLANTA GA,3422,535,2887,524,2887,0,12.81
G1301210F0023,STCTY-13121 TRACT-  F 0023     IN ATLANTA GA,3350,1182,2168,1174,2168,1732,17.63
G1301210F0024,STCTY-13121 TRACT-  F 0024     IN ATLANTA GA,2721,0,2721,0,2721,3134,19.47
G1301210F0025,STCTY-13121 TRACT-  F 0025     IN ATLANTA GA,4883,40,4843,36,4843,2308,16.16
G1301210F0026,STCTY-13121 TRACT-  F 0026     IN ATLANTA GA,6758,154,6604,144,6604,1880,12
G1301210F0027,STCTY-13121 TRACT-  F 0027     IN ATLANTA GA,1960,1563,397,1480,396,0,0
G1301210F0028,STCTY-13121 TRACT-  F 0028     IN ATLANTA GA,9767,51,9716,42,9712,2631,14.29
G1301210F0029,STCTY-13121 TRACT-  F 0029     IN ATLANTA GA,5430,290,5140,278,5139,2253,16.46
G1301210F0030,STCTY-13121 TRACT-  F 0030     IN ATLANTA GA,5133,4787,346,4741,346,2802,27.46
G1301210F0031,STCTY-13121 TRACT-  F 0031     IN ATLANTA GA,2733,2511,222,2498,222,2020,20.63
G1301210F0032,STCTY-13121 TRACT-  F 0032     IN ATLANTA GA,4522,3896,626,3885,626,0,13.12
G1301210F0033,STCTY-13121 TRACT-  F 0033     IN ATLANTA GA,4968,283,4685,270,4685,0,12.39
G1301210F0034,STCTY-13121 TRACT-  F 0034     IN ATLANTA GA,878,456,422,445,422,0,12
G1301210F0035,STCTY-13121 TRACT-  F 0035     IN ATLANTA GA,1675,1289,386,1250,380,0,12.94
G1301210F0036,STCTY-13121 TRACT-  F 0036     IN ATLANTA GA,4396,11,4385,9,4384,0,14.86
G1301210F0037,STCTY-13121 TRACT-  F 0037     IN ATLANTA GA,2041,5,2036,5,2036,0,0
G1301210F0038,STCTY-13121 TRACT-  F 0038     IN ATLANTA GA,5749,15,5734,10,5734,2125,18.49
G1301210F0039,STCTY-13121 TRACT-  F 0039     IN ATLANTA GA,3037,407,2630,403,2629,2973,16.87
G1301210F0040,STCTY-13121 TRACT-  F 0040     IN ATLANTA GA,3332,3013,319,2990,319,3129,27.86
G1301210F0041,STCTY-13121 TRACT-  F 0041     IN ATLANTA GA,5044,4971,73,4915,73,3117,29.62
G1301210F0042,STCTY-13121 TRACT-  F 0042     IN ATLANTA GA,4051,3943,108,3917,108,2756,27
G1301210F0043,STCTY-13121 TRACT-  F 0043     IN ATLANTA GA,3017,535,2482,524,2482,0,15.99
G1301210F0044,STCTY-13121 TRACT-  F 0044     IN ATLANTA GA,6114,1616,4498,1606,4498,0,11.53
G1301210F0045,STCTY-13121 TRACT-  F 0045     IN ATLANTA GA,6521,6007,514,5632,514,2272,14.1
G1301210F0046,STCTY-13121 TRACT-  F 0046     IN ATLANTA GA,5577,4602,975,4225,974,2165,15.85
G1301210F0047,STCTY-13121 TRACT-  F 0047     IN ATLANTA GA,4623,586,4037,556,4037,0,13.63
G1301210F0048,STCTY-13121 TRACT-  F 0048     IN ATLANTA GA,4390,436,3954,400,3954,0,12.56
G1301210F0049,STCTY-13121 TRACT-  F 0049     IN ATLANTA GA,4965,4676,289,4577,289,2129,19.47
G1301210F0050,STCTY-13121 TRACT-  F 0050     IN ATLANTA GA,4596,4580,16,4546,16,2265,20.49
G1301210F0051,STCTY-13121 TRACT-  F 0051     IN ATLANTA GA,756,754,2,749,2,0,23.15
G1301210F0052,STCTY-13121 TRACT-  F 0052     IN ATLANTA GA,3220,3204,16,3192,16,2916,29.16
G1301210F0053,STCTY-13121 TRACT-  F 0053     IN ATLANTA GA,5000,4939,61,4819,61,2341,24.29
G1301210F0054,STCTY-13121 TRACT-  F 0054     IN ATLANTA GA,0,0,0,0,0,0,0
G1301210F0055,STCTY-13121 TRACT-  F 0055     IN ATLANTA GA,8437,2788,5649,2649,5648,1803,14.58
G1301210F0056,STCTY-13121 TRACT-  F 0056     IN ATLANTA GA,6172,5829,343,5581,343,1711,18.03
G1301210F0057,STCTY-13121 TRACT-  F 0057     IN ATLANTA GA,3529,737,2792,731,2792,1343,15.11
G1301210F0058,STCTY-13121 TRACT-  F 0058     IN ATLANTA GA,3161,3152,9,3143,8,2618,23.76
G1301210F0059,STCTY-13121 TRACT-  F 0059     IN ATLANTA GA,2560,2218,342,2199,340,2750,23.77
G1301210F0060,STCTY-13121 TRACT-  F 0060     IN ATLANTA GA,3733,3697,36,3662,36,4215,40.49
G1301210F0061,STCTY-13121 TRACT-  F 0061     IN ATLANTA GA,2414,2192,222,2169,222,4246,33.91
G1301210F0062,STCTY-13121 TRACT-  F 0062     IN ATLANTA GA,2643,2261,382,2243,382,2898,22.88
G1301210F0063,STCTY-13121 TRACT-  F 0063     IN ATLANTA GA,4468,574,3894,562,3894,1171,13.8
G1301210F0064,STCTY-13121 TRACT-  F 0064     IN ATLANTA GA,1396,1396,0,1392,0,1947,22.66
G1301210F0065,STCTY-13121 TRACT-  F 0065     IN ATLANTA GA,3399,3395,4,3369,4,3164,30.35
G1301210F0066,STCTY-13121 TRACT-  F 0066     IN ATLANTA GA,4400,3890,510,3855,510,3277,23.24
G1301210FC0001,STCTY-13121 TRACT- FC 0001     IN ATLANTA GA ADJ AREA,11855,10497,1358,10338,1357,6493,48.98
G1301210FC0002,STCTY-13121 TRACT- FC 0002     IN ATLANTA GA ADJ AREA,4959,4236,723,4186,722,15990,36.88
G1301210FC0003,STCTY-13121 TRACT- FC 0003     IN ATLANTA GA ADJ AREA,1248,888,360,884,360,10690,11.87
G1301210FC0004,STCTY-13121 TRACT- FC 0004     IN ATLANTA GA ADJ AREA,3312,2701,611,2669,609,7209,55.19
G1301210FC0005,STCTY-13121 TRACT- FC 0005     IN ATLANTA GA ADJ AREA,4767,4104,663,4087,663,1989,16.42
G1301210FC0006,STCTY-13121 TRACT- FC 0006     IN ATLANTA GA ADJ AREA,5759,4618,1141,4613,1141,1431,12.77
G1301210FC0007,STCTY-13121 TRACT- FC 0007     IN ATLANTA GA ADJ AREA,12155,9608,2547,9575,2547,1682,14.56
G1301210FC0008,STCTY-13121 TRACT- FC 0008     IN ATLANTA GA ADJ AREA,1940,1635,305,1625,305,1325,14
G1301210FC0009,STCTY-13121 TRACT- FC 0009     IN ATLANTA GA ADJ AREA,2403,1849,554,1831,554,4299,15.25
G1301210FC0010,STCTY-13121 TRACT- FC 0010     IN ATLANTA GA ADJ AREA,2481,1930,551,1922,551,1352,8.8
G1301210FC0011,STCTY-13121 TRACT- FC 0011     IN ATLANTA GA ADJ AREA,3544,3209,335,3164,335,1683,15.65
G1301210FC0012,STCTY-13121 TRACT- FC 0012     IN ATLANTA GA ADJ AREA,4341,2514,1827,2506,1827,2292,12.04
G1301210FC0013,STCTY-13121 TRACT- FC 0013     IN ATLANTA GA ADJ AREA,8062,7906,156,7879,156,2512,23.45
G1301210FC0014,STCTY-13121 TRACT- FC 0014     IN ATLANTA GA ADJ AREA,232,220,12,219,12,0,0
G1301210FC0015,STCTY-13121 TRACT- FC 0015     IN ATLANTA GA ADJ AREA,4575,2287,2288,2276,2288,2762,12.21
G1301210FC0016,STCTY-13121 TRACT- FC 0016     IN ATLANTA GA ADJ AREA,3300,3207,93,3192,93,2606,24.31
G1301210FC0017,STCTY-13121 TRACT- FC 0017     IN ATLANTA GA ADJ AREA,2354,2092,262,2090,262,731,11.44
G1301210FC0018,STCTY-13121 TRACT- FC 0018     IN ATLANTA GA ADJ AREA,1402,1226,176,1225,176,0,14.21
G1301210FC0019,STCTY-13121 TRACT- FC 0019     IN ATLANTA GA ADJ AREA,5059,4974,85,4950,85,2488,24.29
G1301210FC0020,STCTY-13121 TRACT- FC 0020     IN ATLANTA GA ADJ AREA,12258,9035,3223,8861,3214,1710,14.22
G13024500001,STCTY-13245 TRACT-    0001     IN AUGUSTA GA,2771,1156,1615,1133,1612,3536,12.23
G13024500002,STCTY-13245 TRACT-    0002     IN AUGUSTA GA,4067,3881,186,3873,186,1850,16.43
G13024500003,STCTY-13245 TRACT-    0003     IN AUGUSTA GA,7254,6768,486,6747,486,1799,14.31
G13024500004,STCTY-13245 TRACT-    0004     IN AUGUSTA GA,2290,930,1360,900,1357,0,9.54
G13024500005,STCTY-13245 TRACT-    0005     IN AUGUSTA GA,5022,4768,254,4623,248,3939,29.15
G13024500006,STCTY-13245 TRACT-    0006     IN AUGUSTA GA,3780,1818,1962,1794,1950,1667,11.84
G13024500007,STCTY-13245 TRACT-    0007     IN AUGUSTA GA,6843,1665,5178,1644,5128,1546,11.48
G13024500008,STCTY-13245 TRACT-    0008     IN AUGUSTA GA,6791,6136,655,6031,647,2250,14.61
G13024500009,STCTY-13245 TRACT-    0009     IN AUGUSTA GA,6134,220,5914,205,5827,833,9.8
G13024500010,STCTY-13245 TRACT-    0010     IN AUGUSTA GA,4757,4545,212,4496,212,3429,31.06
G13024500011,STCTY-13245 TRACT-    0011     IN AUGUSTA GA,2563,2433,130,2385,130,7301,44.32
G13024500012,STCTY-13245 TRACT-    0012     IN AUGUSTA GA,3408,3389,19,3329,19,3831,37.03
G13024500013,STCTY-13245 TRACT-    0013     IN AUGUSTA GA,875,373,502,371,502,0,11.89
G13024500014,STCTY-13245 TRACT-    0014     IN AUGUSTA GA,3572,335,3237,332,3214,1269,11.19
G13024500015,STCTY-13245 TRACT-    0015     IN AUGUSTA GA,5792,274,5518,272,5486,1012,9.16
G17003100001,STCTY-17031 TRACT-    0001     IN CHICAGO IL,4606,4600,6,3784,4,5630,45.65
G17003100002,STCTY-17031 TRACT-    0002     IN CHICAGO IL,1619,1617,2,1317,2,0,57.49
G17003100003,STCTY-17031 TRACT-    0003     IN CHICAGO IL,7391,7370,21,6128,21,6971,51.52
G17003100004,STCTY-17031 TRACT-    0004     IN CHICAGO IL,8901,8867,34,7554,19,4922,50.81
G17003100005,STCTY-17031 TRACT-    0005     IN CHICAGO IL,16447,16392,55,13531,39,5978,51.07
G17003100006,STCTY-17031 TRACT-    0006     IN CHICAGO IL,7859,7846,13,6780,12,5229,53
G17003100007,STCTY-17031 TRACT-    0007     IN CHICAGO IL,5716,5694,22,5024,13,11277,54.66
G17003100008,STCTY-17031 TRACT-    0008     IN CHICAGO IL,8026,7984,42,6833,20,0,45.3
G17003100009,STCTY-17031 TRACT-    0009     IN CHICAGO IL,12139,12113,26,10094,16,5979,58.29
G17003100010,STCTY-17031 TRACT-    0010     IN CHICAGO IL,4018,3991,27,3364,27,7600,61.65
G17003100011,STCTY-17031 TRACT-    0011     IN CHICAGO IL,6305,6275,30,5435,20,4930,58.63
G17003100012,STCTY-17031 TRACT-    0012     IN CHICAGO IL,7337,7318,19,6272,13,7118,56.97
G17003100013,STCTY-17031 TRACT-    0013     IN CHICAGO IL,3586,3585,1,3070,1,4697,55.65
G17003100014,STCTY-17031 TRACT-    0014     IN CHICAGO IL,3942,3928,14,3479,11,9591,67.96
G17003100015,STCTY-17031 TRACT-    0015     IN CHICAGO IL,2858,2841,17,2444,17,6667,63.32
G17003100016,STCTY-17031 TRACT-    0016     IN CHICAGO IL,1190,1188,2,1016,2,7552,55.19
G17003100017,STCTY-17031 TRACT-    0017     IN CHICAGO IL,2178,2174,4,1899,4,6708,64.84
G17003100018,STCTY-17031 TRACT-    0018     IN CHICAGO IL,3647,3646,1,3144,1,0,45.95
G17003100019,STCTY-17031 TRACT-    0019     IN CHICAGO IL,2123,2086,37,1861,3,0,31.45
G17003100020,STCTY-17031 TRACT-    0020     IN CHICAGO IL,11074,11026,48,9210,24,0,35.27
G17003100021,STCTY-17031 TRACT-    0021     IN CHICAGO IL,3227,3198,29,2661,27,0,60.73
G17003100022,STCTY-17031 TRACT-    0022     IN CHICAGO IL,11058,11030,28,9321,14,4850,38.51
G17003100023,STCTY-17031 TRACT-    0023     IN CHICAGO IL,5775,5444,331,4490,268,0,25.81
G17003100024,STCTY-17031 TRACT-    0024     IN CHICAGO IL,11288,11184,104,9420,39,0,35.26
G17003100025,STCTY-17031 TRACT-    0025     IN CHICAGO IL,0,0,0,0,0,0,0
G17003100026,STCTY-17031 TRACT-    0026     IN CHICAGO IL,7266,7256,10,5605,2,3529,44.55
G17003100027,STCTY-17031 TRACT-    0027     IN CHICAGO IL,7928,7885,43,6313,32,0,33.86
G17003100028,STCTY-17031 TRACT-    0028     IN CHICAGO IL,6051,6028,23,4647,14,0,53.92
G17003100029,STCTY-17031 TRACT-    0029     IN CHICAGO IL,2472,2469,3,2131,1,0,42.87
G17003100030,STCTY-17031 TRACT-    0030     IN CHICAGO IL,5768,5767,1,4284,1,3567,44.57
G17003100031,STCTY-17031 TRACT-    0031     IN CHICAGO IL,4635,4632,3,3408,0,3452,45.1
G17003100032,STCTY-17031 TRACT-    0032     IN CHICAGO IL,3194,3194,0,2508,0,4405,43.19
G17003100033,STCTY-17031 TRACT-    0033     IN CHICAGO IL,2994,2993,1,2514,1,4586,45.6
G17003100034,STCTY-17031 TRACT-    0034     IN CHICAGO IL,7334,7320,14,5788,12,4870,50.65
G17003100035,STCTY-17031 TRACT-    0035     IN CHICAGO IL,8681,8662,19,7256,16,0,49.09
G17003100036,STCTY-17031 TRACT-    0036     IN CHICAGO IL,9555,9530,25,7695,20,3858,47.79
G17003100037,STCTY-17031 TRACT-    0037     IN CHICAGO IL,4786,4752,34,4129,33,0,46.5
G17003100038,STCTY-17031 TRACT-    0038     IN CHICAGO IL,8863,8851,12,7433,6,5739,53.22
G17003100039,STCTY-17031 TRACT-    0039     IN CHICAGO IL,5461,5430,31,4785,23,0,49.3
G17003100040,STCTY-17031 TRACT-    0040     IN CHICAGO IL,2796,2795,1,2375,1,3955,45.53
G17003100041,STCTY-17031 TRACT-    0041     IN CHICAGO IL,3050,3049,1,2569,1,4393,41
G17003100042,STCTY-17031 TRACT-    0042     IN CHICAGO IL,2474,2474,0,2139,0,0,43.89
G17003100043,STCTY-17031 TRACT-    0043     IN CHICAGO IL,5085,5073,12,4083,6,4179,44.67
G17003100044,STCTY-17031 TRACT-    0044     IN CHICAGO IL,4270,4269,1,3464,0,3718,40.88
G17003100045,STCTY-17031 TRACT-    0045     IN CHICAGO IL,1633,1629,4,1379,0,0,43.52
G17003100046,STCTY-17031 TRACT-    0046     IN CHICAGO IL,11757,11754,3,9620,2,3937,44.72
G17003100047,STCTY-17031 TRACT-    0047     IN CHICAGO IL,10195,10176,19,7980,7,4495,47.57
G17003100048,STCTY-17031 TRACT-    0048     IN CHICAGO IL,1221,1221,0,1029,0,5871,61.8
G17003100049,STCTY-17031 TRACT-    0049     IN CHICAGO IL,4632,4631,1,3685,1,3697,42.96
G17003100050,STCTY-17031 TRACT-    0050     IN CHICAGO IL,66,66,0,44,0,0,0
G17003100051,STCTY-17031 TRACT-    0051     IN CHICAGO IL,3616,3616,0,2815,0,3379,37.38
G17003100052,STCTY-17031 TRACT-    0052     IN CHICAGO IL,3731,3730,1,3002,0,3474,41.04
G17003100053,STCTY-17031 TRACT-    0053     IN CHICAGO IL,6799,6799,0,5235,0,3112,36.15
G17003100054,STCTY-17031 TRACT-    0054     IN CHICAGO IL,8007,8002,5,6151,1,3564,42.17
G17003100055,STCTY-17031 TRACT-    0055     IN CHICAGO IL,3092,3088,4,2372,2,3408,41.7
G17003100056,STCTY-17031 TRACT-    0056     IN CHICAGO IL,2022,2021,1,1551,1,2750,30.34
G17003100057,STCTY-17031 TRACT-    0057     IN CHICAGO IL,1731,1731,0,1267,0,3632,37.79
G17003100058,STCTY-17031 TRACT-    0058     IN CHICAGO IL,912,912,0,740,0,5514,45.65
G17003100059,STCTY-17031 TRACT-    0059     IN CHICAGO IL,2153,2153,0,1685,0,1869,28.24
G17003100060,STCTY-17031 TRACT-    0060     IN CHICAGO IL,4314,4308,6,3465,0,2506,23.33
G17003100061,STCTY-17031 TRACT-    0061     IN CHICAGO IL,3258,3244,14,2552,14,3040,32.79
G17003100062,STCTY-17031 TRACT-    0062     IN CHICAGO IL,1904,1904,0,1429,0,2336,32.91
G17003100063,STCTY-17031 TRACT-    0063     IN CHICAGO IL,2298,2297,1,1688,1,2332,28.44
G17003100064,STCTY-17031 TRACT-    0064     IN CHICAGO IL,2491,2491,0,1905,0,1875,31.43
G17003100065,STCTY-17031 TRACT-    0065     IN CHICAGO IL,2431,2430,1,1814,0,3353,40.23
G17003100066,STCTY-17031 TRACT-    0066     IN CHICAGO IL,4045,4045,0,3295,0,4840,45.32
G17003100067,STCTY-17031 TRACT-    0067     IN CHICAGO IL,3232,3230,2,2702,2,4870,44.54
G17003100068,STCTY-17031 TRACT-    0068     IN CHICAGO IL,4566,4554,12,3516,3,2949,35.95
G17003100069,STCTY-17031 TRACT-    0069     IN CHICAGO IL,4584,4581,3,3508,0,2913,39.16
G17003100070,STCTY-17031 TRACT-    0070     IN CHICAGO IL,2285,2283,2,1806,0,3313,43.53
G17003100071,STCTY-17031 TRACT-    0071     IN CHICAGO IL,2095,2095,0,1651,0,2900,36.54
G17003100072,STCTY-17031 TRACT-    0072     IN CHICAGO IL,2260,2244,16,1766,16,2667,31.92
G17003100073,STCTY-17031 TRACT-    0073     IN CHICAGO IL,4107,4107,0,3208,0,2214,29.48
G17003100074,STCTY-17031 TRACT-    0074     IN CHICAGO IL,4944,4929,15,3657,0,1982,28.91
G17003100075,STCTY-17031 TRACT-    0075     IN CHICAGO IL,2273,2268,5,1786,3,2779,32.34
G17003100076,STCTY-17031 TRACT-    0076     IN CHICAGO IL,2378,2378,0,1785,0,2214,30.6
G17003100077,STCTY-17031 TRACT-    0077     IN CHICAGO IL,2279,2279,0,1680,0,1842,27.51
G17003100078,STCTY-17031 TRACT-    0078     IN CHICAGO IL,3689,3650,39,2756,4,0,37.22
G17003100079,STCTY-17031 TRACT-    0079     IN CHICAGO IL,5827,5799,28,4841,21,0,59.5
G17003100080,STCTY-17031 TRACT-    0080     IN CHICAGO IL,6019,6012,7,4307,6,2583,32.46
G17003100081,STCTY-17031 TRACT-    0081     IN CHICAGO IL,5923,5914,9,4361,4,3176,38.92
G17003100082,STCTY-17031 TRACT-    0082     IN CHICAGO IL,3456,3447,9,2590,0,0,42.14
G17003100083,STCTY-17031 TRACT-    0083     IN CHICAGO IL,3800,3756,44,3072,44,0,68.76
G17003100084,STCTY-17031 TRACT-    0084     IN CHICAGO IL,3862,3861,1,2544,1,3028,30.93
G17003100085,STCTY-17031 TRACT-    0085     IN CHICAGO IL,4968,4890,78,3112,6,2581,35.51
G17003100086,STCTY-17031 TRACT-    0086     IN CHICAGO IL,4862,4839,23,3484,14,0,45.47
G17003100087,STCTY-17031 TRACT-    0087     IN CHICAGO IL,6501,6449,52,5211,50,0,63.5
G17003100088,STCTY-17031 TRACT-    0088     IN CHICAGO IL,3012,3009,3,2216,1,3236,45.55
G17003100089,STCTY-17031 TRACT-    0089     IN CHICAGO IL,937,936,1,687,0,0,38.35
G17003100090,STCTY-17031 TRACT-    0090     IN CHICAGO IL,2035,2029,6,1446,0,0,35.95
G17003100091,STCTY-17031 TRACT-    0091     IN CHICAGO IL,1940,1934,6,1415,1,0,44.28
G17003100092,STCTY-17031 TRACT-    0092     IN CHICAGO IL,6700,6656,44,5198,40,0,53.34
G17003100093,STCTY-17031 TRACT-    0093     IN CHICAGO IL,3315,3315,0,2446,0,3199,43.4
G17003100094,STCTY-17031 TRACT-    0094     IN CHICAGO IL,2220,2213,7,1623,1,0,37.66
G17003100095,STCTY-17031 TRACT-    0095     IN CHICAGO IL,2913,2904,9,2171,2,0,41.85
G17003100096,STCTY-17031 TRACT-    0096     IN CHICAGO IL,1373,1371,2,1018,0,0,34.94
G17003100097,STCTY-17031 TRACT-    0097     IN CHICAGO IL,2037,2031,6,1658,3,0,36.93
G17003100098,STCTY-17031 TRACT-    0098     IN CHICAGO IL,3687,3673,14,3050,4,0,30.63
G17003100099,STCTY-17031 TRACT-    0099     IN CHICAGO IL,3331,3302,29,2723,8,0,48.09
G17003100100,STCTY-17031 TRACT-    0100     IN CHICAGO IL,4738,4730,8,3673,0,1770,22.32
G17003100101,STCTY-17031 TRACT-    0101     IN CHICAGO IL,3535,3535,0,2686,0,1658,24.66
G17003100102,STCTY-17031 TRACT-    0102     IN CHICAGO IL,3890,3888,2,3062,0,1967,28.06
G17003100103,STCTY-17031 TRACT-    0103     IN CHICAGO IL,2520,2515,5,1829,5,1363,21.26
G17003100104,STCTY-17031 TRACT-    0104     IN CHICAGO IL,2587,2587,0,1926,0,1685,26.13
G17003100105,STCTY-17031 TRACT-    0105     IN CHICAGO IL,6641,6639,2,4731,0,2475,29.77
G17003100106,STCTY-17031 TRACT-    0106     IN CHICAGO IL,5569,5560,9,3956,1,2288,26.48
G17003100107,STCTY-17031 TRACT-    0107     IN CHICAGO IL,5252,5247,5,3860,1,4520,29.79
G17003100108,STCTY-17031 TRACT-    0108     IN CHICAGO IL,7006,6973,33,5420,18,5806,33.19
G17003100109,STCTY-17031 TRACT-    0109     IN CHICAGO IL,5508,5469,39,4513,17,0,46.48
G17003100110,STCTY-17031 TRACT-    0110     IN CHICAGO IL,5225,5198,27,3996,23,2558,29.8
G17003100111,STCTY-17031 TRACT-    0111     IN CHICAGO IL,5129,5105,24,3814,2,2157,32.41
G17003100112,STCTY-17031 TRACT-    0112     IN CHICAGO IL,6897,6884,13,5442,3,3208,36.66
G17003100113,STCTY-17031 TRACT-    0113     IN CHICAGO IL,8913,8861,52,7405,45,0,53.56
G17003100114,STCTY-17031 TRACT-    0114     IN CHICAGO IL,1598,1584,14,1171,14,0,23.36
G17003100115,STCTY-17031 TRACT-    0115     IN CHICAGO IL,6234,6234,0,4160,0,1610,24.99
G17003100116,STCTY-17031 TRACT-    0116     IN CHICAGO IL,6209,6209,0,4233,0,2155,26.96
G17003100117,STCTY-17031 TRACT-    0117     IN CHICAGO IL,3531,3526,5,2528,0,2684,25.7
G17003100118,STCTY-17031 TRACT-    0118     IN CHICAGO IL,2682,2680,2,1869,0,1841,26.14
G17003100119,STCTY-17031 TRACT-    0119     IN CHICAGO IL,7162,7140,22,5249,3,3176,28.07
G17003100120,STCTY-17031 TRACT-    0120     IN CHICAGO IL,314,313,1,201,0,0,0
G17003100121,STCTY-17031 TRACT-    0121     IN CHICAGO IL,4842,4622,220,3391,218,1838,20.55
G17003100122,STCTY-17031 TRACT-    0122     IN CHICAGO IL,6286,6017,269,4629,269,2385,27.04
G17003100123,STCTY-17031 TRACT-    0123     IN CHICAGO IL,6499,6131,368,4656,310,2365,25.11
G17003100124,STCTY-17031 TRACT-    0124     IN CHICAGO IL,7823,7741,82,6262,35,0,42.77
G17003100125,STCTY-17031 TRACT-    0125     IN CHICAGO IL,4043,3971,72,3207,66,20000,98.52
G17003100126,STCTY-17031 TRACT-    0126     IN CHICAGO IL,707,514,193,386,193,0,24.31
G17003100127,STCTY-17031 TRACT-    0127     IN CHICAGO IL,5552,3742,1810,2568,1799,2250,19.95
G17003100128,STCTY-17031 TRACT-    0128     IN CHICAGO IL,2613,1669,944,1138,797,0,23.65
G17003100129,STCTY-17031 TRACT-    0129     IN CHICAGO IL,7614,7412,202,5967,24,0,35.45
G17003100130,STCTY-17031 TRACT-    0130     IN CHICAGO IL,3512,3481,31,2975,3,0,52.6
G17003100131,STCTY-17031 TRACT-    0131     IN CHICAGO IL,5789,5702,87,4775,46,0,65.97
G17003100132,STCTY-17031 TRACT-    0132     IN CHICAGO IL,6656,6578,78,5686,56,0,88.56
G17003100133,STCTY-17031 TRACT-    0133     IN CHICAGO IL,2333,1827,506,1293,506,0,19.27
G17003100134,STCTY-17031 TRACT-    0134     IN CHICAGO IL,2171,1444,727,881,723,0,18.71
G17003100135,STCTY-17031 TRACT-    0135     IN CHICAGO IL,4916,4720,196,3362,38,0,28.83
G17003100136,STCTY-17031 TRACT-    0136     IN CHICAGO IL,2627,2535,92,2019,22,0,15.35
G17003100137,STCTY-17031 TRACT-    0137     IN CHICAGO IL,2657,2584,73,2179,53,0,53.68
G17003100138,STCTY-17031 TRACT-    0138     IN CHICAGO IL,105,105,0,95,0,0,0
G17003100139,STCTY-17031 TRACT-    0139     IN CHICAGO IL,5050,5048,2,4605,0,7019,53.23
G17003100140,STCTY-17031 TRACT-    0140     IN CHICAGO IL,844,844,0,743,0,6268,0
G17003100141,STCTY-17031 TRACT-    0141     IN CHICAGO IL,237,237,0,204,0,0,0
G17003100142,STCTY-17031 TRACT-    0142     IN CHICAGO IL,1018,1018,0,899,0,3440,0
G17003100143,STCTY-17031 TRACT-    0143     IN CHICAGO IL,3701,3700,1,3181,1,6500,51.32
G17003100144,STCTY-17031 TRACT-    0144     IN CHICAGO IL,5086,5082,4,4373,2,5830,44.66
G17003100145,STCTY-17031 TRACT-    0145     IN CHICAGO IL,2412,2409,3,1957,1,3844,32.47
G17003100146,STCTY-17031 TRACT-    0146     IN CHICAGO IL,4012,4012,0,3432,0,5485,47.01
G17003100147,STCTY-17031 TRACT-    0147     IN CHICAGO IL,2683,2683,0,2178,0,3680,34.08
G17003100148,STCTY-17031 TRACT-    0148     IN CHICAGO IL,2376,2375,1,2029,0,4256,41.69
G17003100149,STCTY-17031 TRACT-    0149     IN CHICAGO IL,3165,3165,0,2583,0,5072,45.35
G17003100150,STCTY-17031 TRACT-    0150     IN CHICAGO IL,8711,8698,13,6941,6,4595,39.68
G17003100151,STCTY-17031 TRACT-    0151     IN CHICAGO IL,4602,4602,0,3869,0,5423,43.35
G17003100152,STCTY-17031 TRACT-    0152     IN CHICAGO IL,1031,1029,2,920,2,10610,0
G17003100153,STCTY-17031 TRACT-    0153     IN CHICAGO IL,2833,2831,2,2279,1,5548,36.35
G17003100154,STCTY-17031 TRACT-    0154     IN CHICAGO IL,885,885,0,776,0,9771,0
G17003100155,STCTY-17031 TRACT-    0155     IN CHICAGO IL,1881,1871,10,1697,10,13225,0
G17003100156,STCTY-17031 TRACT-    0156     IN CHICAGO IL,921,912,9,711,9,4150,34.29
G17003100157,STCTY-17031 TRACT-    0157     IN CHICAGO IL,6158,6153,5,4499,5,6323,52.17
G17003100158,STCTY-17031 TRACT-    0158     IN CHICAGO IL,251,251,0,190,0,0,0
G17003100159,STCTY-17031 TRACT-    0159     IN CHICAGO IL,4941,4806,135,3841,135,7400,58.87
G17003100160,STCTY-17031 TRACT-    0160     IN CHICAGO IL,6988,6981,7,5631,5,5750,45.71
G17003100161,STCTY-17031 TRACT-    0161     IN CHICAGO IL,4002,3988,14,3106,11,3950,41.16
G17003100162,STCTY-17031 TRACT-    0162     IN CHICAGO IL,8880,8867,13,5989,7,3918,46.05
G17003100163,STCTY-17031 TRACT-    0163     IN CHICAGO IL,9361,9344,17,6259,8,3674,44.39
G17003100164,STCTY-17031 TRACT-    0164     IN CHICAGO IL,8612,8601,11,6443,5,6105,45.33
G17003100165,STCTY-17031 TRACT-    0165     IN CHICAGO IL,7553,7542,11,5025,8,5537,47.87
G17003100166,STCTY-17031 TRACT-    0166     IN CHICAGO IL,6796,6775,21,4441,9,5129,44.04
G17003100167,STCTY-17031 TRACT-    0167     IN CHICAGO IL,4500,4495,5,2819,3,3905,45.11
G17003100168,STCTY-17031 TRACT-    0168     IN CHICAGO IL,6072,6070,2,4820,2,3812,37
G17003100169,STCTY-17031 TRACT-    0169     IN CHICAGO IL,7966,7960,6,6414,0,5564,45.43
G17003100170,STCTY-17031 TRACT-    0170     IN CHICAGO IL,7829,7828,1,6634,0,5597,47.73
G17003100171,STCTY-17031 TRACT-    0171     IN CHICAGO IL,4405,4400,5,3366,5,4874,42.14
G17003100172,STCTY-17031 TRACT-    0172     IN CHICAGO IL,5012,5009,3,4065,0,4889,45.83
G17003100173,STCTY-17031 TRACT-    0173     IN CHICAGO IL,5546,5546,0,4476,0,4362,42.78
G17003100174,STCTY-17031 TRACT-    0174     IN CHICAGO IL,10248,10247,1,8627,1,4982,42.73
G17003100175,STCTY-17031 TRACT-    0175     IN CHICAGO IL,708,708,0,592,0,0,40.82
G17003100176,STCTY-17031 TRACT-    0176     IN CHICAGO IL,1997,1997,0,1575,0,5400,37.61
G17003100177,STCTY-17031 TRACT-    0177     IN CHICAGO IL,3470,3465,5,2840,0,5518,46.53
G17003100178,STCTY-17031 TRACT-    0178     IN CHICAGO IL,5343,5343,0,4290,0,5463,45.41
G17003100179,STCTY-17031 TRACT-    0179     IN CHICAGO IL,7761,7757,4,6197,0,4269,42.54
G17003100180,STCTY-17031 TRACT-    0180     IN CHICAGO IL,4969,4965,4,4154,3,4486,39.04
G17003100181,STCTY-17031 TRACT-    0181     IN CHICAGO IL,3865,3862,3,3173,0,4665,41.61
G17003100182,STCTY-17031 TRACT-    0182     IN CHICAGO IL,2414,2413,1,2036,1,5614,43.57
G17003100183,STCTY-17031 TRACT-    0183     IN CHICAGO IL,3999,3999,0,3480,0,4541,44.03
G17003100184,STCTY-17031 TRACT-    0184     IN CHICAGO IL,2897,2892,5,2538,0,4745,44.13
G17003100185,STCTY-17031 TRACT-    0185     IN CHICAGO IL,4248,4244,4,3600,0,5572,44.68
G17003100186,STCTY-17031 TRACT-    0186     IN CHICAGO IL,6534,6533,1,5244,0,3616,40.7
G17003100187,STCTY-17031 TRACT-    0187     IN CHICAGO IL,6706,6704,2,5331,1,3433,40.42
G17003100188,STCTY-17031 TRACT-    0188     IN CHICAGO IL,6071,6071,0,4872,0,4267,40.89
G17003100189,STCTY-17031 TRACT-    0189     IN CHICAGO IL,8449,8442,7,6500,0,3119,41.52
G17003100190,STCTY-17031 TRACT-    0190     IN CHICAGO IL,8477,8470,7,6650,7,3831,43.14
G17003100191,STCTY-17031 TRACT-    0191     IN CHICAGO IL,2624,2623,1,2118,1,3206,37.57
G17003100192,STCTY-17031 TRACT-    0192     IN CHICAGO IL,5300,5291,9,4376,1,3891,40.57
G17003100193,STCTY-17031 TRACT-    0193     IN CHICAGO IL,1380,1380,0,1040,0,3188,0
G17003100194,STCTY-17031 TRACT-    0194     IN CHICAGO IL,2539,2536,3,2067,0,3329,33.03
G17003100195,STCTY-17031 TRACT-    0195     IN CHICAGO IL,775,775,0,620,0,2821,0
G17003100196,STCTY-17031 TRACT-    0196     IN CHICAGO IL,1649,1649,0,1322,0,2571,22.93
G17003100197,STCTY-17031 TRACT-    0197     IN CHICAGO IL,2038,2026,12,1609,4,3228,32.26
G17003100198,STCTY-17031 TRACT-    0198     IN CHICAGO IL,756,756,0,618,0,3142,0
G17003100199,STCTY-17031 TRACT-    0199     IN CHICAGO IL,3588,3588,0,2844,0,3965,39.55
G17003100200,STCTY-17031 TRACT-    0200     IN CHICAGO IL,3800,3799,1,3167,1,5819,46.48
G17003100201,STCTY-17031 TRACT-    0201     IN CHICAGO IL,3618,3616,2,2922,1,5169,39.55
G17003100202,STCTY-17031 TRACT-    0202     IN CHICAGO IL,3185,3181,4,2612,0,5494,44.4
G17003100203,STCTY-17031 TRACT-    0203     IN CHICAGO IL,3568,3568,0,2724,0,5314,40.19
G17003100204,STCTY-17031 TRACT-    0204     IN CHICAGO IL,5093,5091,2,4006,2,4368,40.01
G17003100205,STCTY-17031 TRACT-    0205     IN CHICAGO IL,1032,1027,5,908,0,0,45.28
G17003100206,STCTY-17031 TRACT-    0206     IN CHICAGO IL,1115,1115,0,841,0,4389,43.18
G17003100207,STCTY-17031 TRACT-    0207     IN CHICAGO IL,7014,7014,0,5790,0,6069,46.61
G17003100208,STCTY-17031 TRACT-    0208     IN CHICAGO IL,5211,5211,0,4287,0,6500,45.16
G17003100209,STCTY-17031 TRACT-    0209     IN CHICAGO IL,5167,5163,4,4140,1,5438,46.79
G17003100210,STCTY-17031 TRACT-    0210     IN CHICAGO IL,1985,1984,1,1601,0,4967,46.98
G17003100211,STCTY-17031 TRACT-    0211     IN CHICAGO IL,0,0,0,0,0,0,0
G17003100212,STCTY-17031 TRACT-    0212     IN CHICAGO IL,7027,7026,1,5371,1,4194,40.09
G17003100213,STCTY-17031 TRACT-    0213     IN CHICAGO IL,6841,6840,1,5149,1,3581,41.05
G17003100214,STCTY-17031 TRACT-    0214     IN CHICAGO IL,5956,5947,9,4776,0,5254,44.79
G17003100215,STCTY-17031 TRACT-    0215     IN CHICAGO IL,1754,1754,0,1434,0,5549,45.65
G17003100216,STCTY-17031 TRACT-    0216     IN CHICAGO IL,730,730,0,567,0,3419,0
G17003100217,STCTY-17031 TRACT-    0217     IN CHICAGO IL,7715,7714,1,5539,0,3163,30.65
G17003100218,STCTY-17031 TRACT-    0218     IN CHICAGO IL,3590,3590,0,2732,0,3107,28.7
G17003100219,STCTY-17031 TRACT-    0219     IN CHICAGO IL,6913,6910,3,5326,1,3714,39.55
G17003100220,STCTY-17031 TRACT-    0220     IN CHICAGO IL,2284,2284,0,1818,0,4078,37.64
G17003100221,STCTY-17031 TRACT-    0221     IN CHICAGO IL,3661,3661,0,2979,0,6265,45.34
G17003100222,STCTY-17031 TRACT-    0222     IN CHICAGO IL,4621,4617,4,3661,0,4396,44.18
G17003100223,STCTY-17031 TRACT-    0223     IN CHICAGO IL,1948,1947,1,1522,0,3421,39.74
G17003100224,STCTY-17031 TRACT-    0224     IN CHICAGO IL,7500,7500,0,5812,0,3173,36.46
G17003100225,STCTY-17031 TRACT-    0225     IN CHICAGO IL,4343,4341,2,3436,0,2476,33.79
G17003100226,STCTY-17031 TRACT-    0226     IN CHICAGO IL,821,821,0,643,0,0,36.59
G17003100227,STCTY-17031 TRACT-    0227     IN CHICAGO IL,4352,4352,0,3587,0,2561,33.42
G17003100228,STCTY-17031 TRACT-    0228     IN CHICAGO IL,7659,7659,0,6143,0,3360,40.84
G17003100229,STCTY-17031 TRACT-    0229     IN CHICAGO IL,1827,1827,0,1452,0,2558,31.53
G17003100230,STCTY-17031 TRACT-    0230     IN CHICAGO IL,2833,2827,6,2250,6,4632,45.27
G17003100231,STCTY-17031 TRACT-    0231     IN CHICAGO IL,9628,9627,1,7595,0,2566,33.5
G17003100232,STCTY-17031 TRACT-    0232     IN CHICAGO IL,9128,9112,16,7237,4,2347,33.3
G17003100233,STCTY-17031 TRACT-    0233     IN CHICAGO IL,6243,6242,1,4978,1,2784,36.31
G17003100234,STCTY-17031 TRACT-    0234     IN CHICAGO IL,1877,1875,2,1511,1,3859,34.87
G17003100235,STCTY-17031 TRACT-    0235     IN CHICAGO IL,4137,4135,2,3225,0,3112,31.75
G17003100236,STCTY-17031 TRACT-    0236     IN CHICAGO IL,131,131,0,101,0,0,0
G17003100237,STCTY-17031 TRACT-    0237     IN CHICAGO IL,8839,8831,8,6685,1,2799,37.45
G17003100238,STCTY-17031 TRACT-    0238     IN CHICAGO IL,10172,10160,12,7977,1,3427,39.54
G17003100239,STCTY-17031 TRACT-    0239     IN CHICAGO IL,4067,4064,3,3158,1,3612,43.64
G17003100240,STCTY-17031 TRACT-    0240     IN CHICAGO IL,4145,4142,3,3156,2,3516,41.8
G17003100241,STCTY-17031 TRACT-    0241     IN CHICAGO IL,3897,3896,1,3122,1,3207,38.2
G17003100242,STCTY-17031 TRACT-    0242     IN CHICAGO IL,3148,3148,0,2491,0,2364,29.71
G17003100243,STCTY-17031 TRACT-    0243     IN CHICAGO IL,1536,1536,0,1221,0,2407,27.46
G17003100244,STCTY-17031 TRACT-    0244     IN CHICAGO IL,4495,4486,9,3328,5,2434,36.55
G17003100245,STCTY-17031 TRACT-    0245     IN CHICAGO IL,4171,4171,0,3281,0,1953,28.87
G17003100246,STCTY-17031 TRACT-    0246     IN CHICAGO IL,4401,4400,1,3478,0,2667,32.33
G17003100247,STCTY-17031 TRACT-    0247     IN CHICAGO IL,6050,6049,1,4637,0,1996,26.31
G17003100248,STCTY-17031 TRACT-    0248     IN CHICAGO IL,5892,5891,1,4475,0,1835,22.19
G17003100249,STCTY-17031 TRACT-    0249     IN CHICAGO IL,7171,7165,6,5455,4,3104,37.64
G17003100250,STCTY-17031 TRACT-    0250     IN CHICAGO IL,3594,3591,3,2637,2,2300,35.95
G17003100251,STCTY-17031 TRACT-    0251     IN CHICAGO IL,1325,1325,0,1030,0,2414,31.28
G17003100252,STCTY-17031 TRACT-    0252     IN CHICAGO IL,1177,1177,0,930,0,0,28.41
G17003100253,STCTY-17031 TRACT-    0253     IN CHICAGO IL,6686,6681,5,4886,5,3176,40.07
G17003100254,STCTY-17031 TRACT-    0254     IN CHICAGO IL,4179,4171,8,3064,5,3230,41.59
G17003100255,STCTY-17031 TRACT-    0255     IN CHICAGO IL,2758,2757,1,2002,1,2081,29.84
G17003100256,STCTY-17031 TRACT-    0256     IN CHICAGO IL,2725,2725,0,2018,0,1971,31.24
G17003100257,STCTY-17031 TRACT-    0257     IN CHICAGO IL,2289,2288,1,1700,1,2027,29.78
G17003100258,STCTY-17031 TRACT-    0258     IN CHICAGO IL,2600,2600,0,2076,0,1808,28.19
G17003100259,STCTY-17031 TRACT-    0259     IN CHICAGO IL,1772,1772,0,1460,0,1445,25.17
G17003100260,STCTY-17031 TRACT-    0260     IN CHICAGO IL,3385,3370,15,2620,10,1991,25.77
G17003100261,STCTY-17031 TRACT-    0261     IN CHICAGO IL,3832,3832,0,2893,0,1954,26.44
G17003100262,STCTY-17031 TRACT-    0262     IN CHICAGO IL,1294,1294,0,1000,0,2052,29.65
G17003100263,STCTY-17031 TRACT-    0263     IN CHICAGO IL,2635,2635,0,2060,0,1944,24.35
G17003100264,STCTY-17031 TRACT-    0264     IN CHICAGO IL,1644,1644,0,1304,0,1711,22.95
G17003100265,STCTY-17031 TRACT-    0265     IN CHICAGO IL,3516,3509,7,2747,7,2348,35
G17003100266,STCTY-17031 TRACT-    0266     IN CHICAGO IL,2697,2696,1,2068,1,3173,38.33
G17003100267,STCTY-17031 TRACT-    0267     IN CHICAGO IL,1144,1144,0,912,0,0,28.62
G17003100268,STCTY-17031 TRACT-    0268     IN CHICAGO IL,6765,6764,1,5143,0,3012,34.79
G17003100269,STCTY-17031 TRACT-    0269     IN CHICAGO IL,1514,1514,0,1141,0,3286,32.86
G17003100270,STCTY-17031 TRACT-    0270     IN CHICAGO IL,9378,9378,0,6894,0,3008,36.31
G17003100271,STCTY-17031 TRACT-    0271     IN CHICAGO IL,1646,1646,0,1184,0,3147,34.5
G17003100272,STCTY-17031 TRACT-    0272     IN CHICAGO IL,2830,2829,1,2181,0,2201,32.78
G17003100273,STCTY-17031 TRACT-    0273     IN CHICAGO IL,2851,2850,1,2039,1,2111,32.48
G17003100274,STCTY-17031 TRACT-    0274     IN CHICAGO IL,8340,8332,8,5424,7,2677,40.13
G17003100275,STCTY-17031 TRACT-    0275     IN CHICAGO IL,4754,4749,5,3255,5,3478,38.27
G17003100276,STCTY-17031 TRACT-    0276     IN CHICAGO IL,612,612,0,397,0,0,34.32
G17003100277,STCTY-17031 TRACT-    0277     IN CHICAGO IL,7955,7951,4,6288,0,3074,36.62
G17003100278,STCTY-17031 TRACT-    0278     IN CHICAGO IL,7783,7778,5,5836,5,3169,33.68
G17003100279,STCTY-17031 TRACT-    0279     IN CHICAGO IL,0,0,0,0,0,0,0
G17003100280,STCTY-17031 TRACT-    0280     IN CHICAGO IL,12430,12418,12,9240,6,2693,37.59
G17003100281,STCTY-17031 TRACT-    0281     IN CHICAGO IL,3260,3260,0,2502,0,2744,38.34
G17003100282,STCTY-17031 TRACT-    0282     IN CHICAGO IL,1854,1854,0,1474,0,2614,35.84
G17003100283,STCTY-17031 TRACT-    0283     IN CHICAGO IL,2669,2668,1,1874,1,2056,30.64
G17003100284,STCTY-17031 TRACT-    0284     IN CHICAGO IL,2429,2429,0,1854,0,1872,26.23
G17003100285,STCTY-17031 TRACT-    0285     IN CHICAGO IL,3965,3954,11,2441,11,2235,34.2
G17003100286,STCTY-17031 TRACT-    0286     IN CHICAGO IL,4715,4706,9,2979,8,1926,29.02
G17003100287,STCTY-17031 TRACT-    0287     IN CHICAGO IL,2786,2758,28,1991,28,1895,26.82
G17003100288,STCTY-17031 TRACT-    0288     IN CHICAGO IL,3801,3703,98,2543,98,2168,26.11
G17003100289,STCTY-17031 TRACT-    0289     IN CHICAGO IL,4816,4745,71,3390,69,1811,22.59
G17003100290,STCTY-17031 TRACT-    0290     IN CHICAGO IL,4758,4561,197,3235,197,1701,21.95
G17003100291,STCTY-17031 TRACT-    0291     IN CHICAGO IL,4980,4976,4,3709,4,1454,21.6
G17003100292,STCTY-17031 TRACT-    0292     IN CHICAGO IL,5915,5911,4,3965,3,2648,29.98
G17003100293,STCTY-17031 TRACT-    0293     IN CHICAGO IL,6993,6993,0,4898,0,1707,24.31
G17003100294,STCTY-17031 TRACT-    0294     IN CHICAGO IL,7017,7006,11,4936,0,1513,22.03
G17003100295,STCTY-17031 TRACT-    0295     IN CHICAGO IL,2207,2207,0,1711,0,1369,25.63
G17003100296,STCTY-17031 TRACT-    0296     IN CHICAGO IL,1956,1948,8,1448,0,2154,27.93
G17003100297,STCTY-17031 TRACT-    0297     IN CHICAGO IL,142,142,0,106,0,0,0
G17003100298,STCTY-17031 TRACT-    0298     IN CHICAGO IL,7708,7621,87,5145,82,2078,27.22
G17003100299,STCTY-17031 TRACT-    0299     IN CHICAGO IL,5751,5670,81,3884,73,2058,29.21
G17003100300,STCTY-17031 TRACT-    0300     IN CHICAGO IL,4201,4197,4,2804,0,2114,26.96
G17003100301,STCTY-17031 TRACT-    0301     IN CHICAGO IL,11496,11470,26,7553,26,2070,30.98
G17003100302,STCTY-17031 TRACT-    0302     IN CHICAGO IL,3406,3404,2,2295,2,2389,34.31
G17003100303,STCTY-17031 TRACT-    0303     IN CHICAGO IL,5770,5750,20,3929,20,2108,29.12
G17003100304,STCTY-17031 TRACT-    0304     IN CHICAGO IL,6453,6445,8,4334,4,3333,34.51
G17003100305,STCTY-17031 TRACT-    0305     IN CHICAGO IL,919,918,1,718,1,0,24.72
G17003100306,STCTY-17031 TRACT-    0306     IN CHICAGO IL,2825,2821,4,2143,0,1771,22.51
G17003100307,STCTY-17031 TRACT-    0307     IN CHICAGO IL,2116,2111,5,1653,0,1647,22.13
G17003100308,STCTY-17031 TRACT-    0308     IN CHICAGO IL,1383,1383,0,1132,0,0,21.9
G17003100309,STCTY-17031 TRACT-    0309     IN CHICAGO IL,8963,8956,7,5888,5,1972,25.7
G17003100310,STCTY-17031 TRACT-    0310     IN CHICAGO IL,5607,5607,0,4270,0,1472,21.9
G17003100311,STCTY-17031 TRACT-    0311     IN CHICAGO IL,7374,7373,1,5570,0,1271,19.88
G17003100312,STCTY-17031 TRACT-    0312     IN CHICAGO IL,2959,2958,1,2262,0,1019,19.09
G17003100313,STCTY-17031 TRACT-    0313     IN CHICAGO IL,7299,7299,0,5107,0,1490,19.41
G17003100314,STCTY-17031 TRACT-    0314     IN CHICAGO IL,4385,4382,3,3160,0,1049,18.42
G17003100315,STCTY-17031 TRACT-    0315     IN CHICAGO IL,2158,2155,3,1502,3,0,18.39
G17003100316,STCTY-17031 TRACT-    0316     IN CHICAGO IL,5495,5456,39,3850,39,2172,23.52
G17003100317,STCTY-17031 TRACT-    0317     IN CHICAGO IL,6663,6656,7,4473,7,924,18.78
G17003100318,STCTY-17031 TRACT-    0318     IN CHICAGO IL,5074,5074,0,3335,0,0,22.73
G17003100319,STCTY-17031 TRACT-    0319     IN CHICAGO IL,2396,2381,15,1434,15,0,16.13
G17003100320,STCTY-17031 TRACT-    0320     IN CHICAGO IL,374,373,1,269,1,0,0
G17003100321,STCTY-17031 TRACT-    0321     IN CHICAGO IL,4263,4263,0,3684,0,8722,51.96
G17003100322,STCTY-17031 TRACT-    0322     IN CHICAGO IL,6661,6661,0,5597,0,4864,46.09
G17003100323,STCTY-17031 TRACT-    0323     IN CHICAGO IL,5079,5075,4,4238,0,4214,45.19
G17003100324,STCTY-17031 TRACT-    0324     IN CHICAGO IL,2820,2820,0,2303,0,5171,40.74
G17003100325,STCTY-17031 TRACT-    0325     IN CHICAGO IL,637,636,1,503,0,0,34.26
G17003100326,STCTY-17031 TRACT-    0326     IN CHICAGO IL,5032,5029,3,4282,0,6243,50.58
G17003100327,STCTY-17031 TRACT-    0327     IN CHICAGO IL,7205,7202,3,6005,0,5368,50.44
G17003100328,STCTY-17031 TRACT-    0328     IN CHICAGO IL,3160,3156,4,2578,0,5040,46.14
G17003100329,STCTY-17031 TRACT-    0329     IN CHICAGO IL,1026,1026,0,823,0,4121,37.45
G17003100330,STCTY-17031 TRACT-    0330     IN CHICAGO IL,6448,6442,6,5208,0,4140,44.83
G17003100331,STCTY-17031 TRACT-    0331     IN CHICAGO IL,5226,5225,1,4451,0,5652,45.88
G17003100332,STCTY-17031 TRACT-    0332     IN CHICAGO IL,6217,6217,0,5184,0,3842,45.86
G17003100333,STCTY-17031 TRACT-    0333     IN CHICAGO IL,1964,1958,6,1598,6,4155,42.89
G17003100334,STCTY-17031 TRACT-    0334     IN CHICAGO IL,6416,6413,3,5645,0,4711,43.94
G17003100335,STCTY-17031 TRACT-    0335     IN CHICAGO IL,5709,5702,7,4964,7,4634,44.69
G17003100336,STCTY-17031 TRACT-    0336     IN CHICAGO IL,5658,5655,3,4602,1,3684,37.41
G17003100337,STCTY-17031 TRACT-    0337     IN CHICAGO IL,3708,3694,14,2984,12,2926,32.91
G17003100338,STCTY-17031 TRACT-    0338     IN CHICAGO IL,7672,7668,4,6749,3,6418,50.5
G17003100339,STCTY-17031 TRACT-    0339     IN CHICAGO IL,8598,8587,11,7367,10,5713,47.2
G17003100340,STCTY-17031 TRACT-    0340     IN CHICAGO IL,10841,10835,6,9397,5,3786,42.78
G17003100341,STCTY-17031 TRACT-    0341     IN CHICAGO IL,11078,11068,10,8807,9,4948,51.76
G17003100342,STCTY-17031 TRACT-    0342     IN CHICAGO IL,3364,3364,0,2733,0,5690,43.61
G17003100343,STCTY-17031 TRACT-    0343     IN CHICAGO IL,11029,11012,17,9198,7,3802,44.3
G17003100344,STCTY-17031 TRACT-    0344     IN CHICAGO IL,2296,2296,0,1848,0,3527,34.05
G17003100345,STCTY-17031 TRACT-    0345     IN CHICAGO IL,3245,3244,1,2851,0,3122,44.28
G17003100346,STCTY-17031 TRACT-    0346     IN CHICAGO IL,3743,3742,1,3128,1,3344,36.19
G17003100347,STCTY-17031 TRACT-    0347     IN CHICAGO IL,3666,3660,6,3115,6,3262,37.7
G17003100348,STCTY-17031 TRACT-    0348     IN CHICAGO IL,4450,4440,10,3453,2,3408,42.22
G17003100349,STCTY-17031 TRACT-    0349     IN CHICAGO IL,6376,6374,2,5048,1,2956,42.05
G17003100350,STCTY-17031 TRACT-    0350     IN CHICAGO IL,6324,6321,3,4866,0,2823,38.9
G17003100351,STCTY-17031 TRACT-    0351     IN CHICAGO IL,3294,3287,7,2691,1,0,34.46
G17003100352,STCTY-17031 TRACT-    0352     IN CHICAGO IL,7025,7006,19,4853,7,3474,52.33
G17003100353,STCTY-17031 TRACT-    0353     IN CHICAGO IL,6555,6553,2,4951,2,3066,40.55
G17003100354,STCTY-17031 TRACT-    0354     IN CHICAGO IL,3769,3765,4,2679,4,2342,42.75
G17003100355,STCTY-17031 TRACT-    0355     IN CHICAGO IL,2193,2186,7,1828,7,2728,36.4
G17003100356,STCTY-17031 TRACT-    0356     IN CHICAGO IL,1230,1226,4,875,1,0,41.33
G17003100357,STCTY-17031 TRACT-    0357     IN CHICAGO IL,1769,1758,11,1480,5,0,40.66
G17003100358,STCTY-17031 TRACT-    0358     IN CHICAGO IL,4220,4220,0,3640,0,2867,31.8
G17003100359,STCTY-17031 TRACT-    0359     IN CHICAGO IL,4488,3743,745,3211,742,1831,27.3
G17003100360,STCTY-17031 TRACT-    0360     IN CHICAGO IL,2371,472,1899,404,1892,0,26.86
G17003100361,STCTY-17031 TRACT-    0361     IN CHICAGO IL,1128,815,313,719,308,0,27
G17003100362,STCTY-17031 TRACT-    0362     IN CHICAGO IL,3170,3141,29,2663,10,1900,26.38
G17003100363,STCTY-17031 TRACT-    0363     IN CHICAGO IL,3093,3090,3,1990,3,3620,45.47
G17003100364,STCTY-17031 TRACT-    0364     IN CHICAGO IL,2521,2521,0,1745,0,2792,39.22
G17003100365,STCTY-17031 TRACT-    0365     IN CHICAGO IL,3132,3130,2,2207,2,2636,39.04
G17003100366,STCTY-17031 TRACT-    0366     IN CHICAGO IL,3848,3841,7,2756,7,2223,32.25
G17003100367,STCTY-17031 TRACT-    0367     IN CHICAGO IL,3504,3504,0,2526,0,2102,30.57
G17003100368,STCTY-17031 TRACT-    0368     IN CHICAGO IL,7575,7560,15,5877,5,3128,36.79
G17003100369,STCTY-17031 TRACT-    0369     IN CHICAGO IL,4737,4732,5,3706,1,2724,34.77
G17003100370,STCTY-17031 TRACT-    0370     IN CHICAGO IL,1675,1674,1,1462,1,0,26.39
G17003100371,STCTY-17031 TRACT-    0371     IN CHICAGO IL,1726,1719,7,1469,0,0,23.75
G17003100372,STCTY-17031 TRACT-    0372     IN CHICAGO IL,5469,5457,12,4498,5,1815,29.75
G17003100373,STCTY-17031 TRACT-    0373     IN CHICAGO IL,5443,5418,25,4479,1,2250,27.83
G17003100374,STCTY-17031 TRACT-    0374     IN CHICAGO IL,538,538,0,416,0,0,0
G17003100375,STCTY-17031 TRACT-    0375     IN CHICAGO IL,1959,1959,0,1462,0,0,29.2
G17003100376,STCTY-17031 TRACT-    0376     IN CHICAGO IL,1654,96,1558,80,1557,0,25.75
G17003100377,STCTY-17031 TRACT-    0377     IN CHICAGO IL,4211,673,3538,554,3537,2145,25.71
G17003100378,STCTY-17031 TRACT-    0378     IN CHICAGO IL,3454,906,2548,765,2501,0,22.31
G17003100379,STCTY-17031 TRACT-    0379     IN CHICAGO IL,858,292,566,252,565,0,27.07
G17003100380,STCTY-17031 TRACT-    0380     IN CHICAGO IL,454,198,256,157,255,0,20.19
G17003100381,STCTY-17031 TRACT-    0381     IN CHICAGO IL,610,552,58,474,55,0,11.58
G17003100382,STCTY-17031 TRACT-    0382     IN CHICAGO IL,3205,3139,66,2664,39,2000,26.63
G17003100383,STCTY-17031 TRACT-    0383     IN CHICAGO IL,1762,1744,18,1515,16,0,19.25
G17003100384,STCTY-17031 TRACT-    0384     IN CHICAGO IL,1311,1281,30,1128,23,0,21.73
G17003100385,STCTY-17031 TRACT-    0385     IN CHICAGO IL,323,17,306,12,306,0,0
G17003100386,STCTY-17031 TRACT-    0386     IN CHICAGO IL,502,1,501,1,501,0,26.5
G17003100387,STCTY-17031 TRACT-    0387     IN CHICAGO IL,170,4,166,4,166,0,0
G17003100388,STCTY-17031 TRACT-    0388     IN CHICAGO IL,1047,1021,26,853,0,0,22.65
G17003100389,STCTY-17031 TRACT-    0389     IN CHICAGO IL,663,661,2,527,1,0,25.67
G17003100390,STCTY-17031 TRACT-    0390     IN CHICAGO IL,3097,3096,1,2565,0,2280,23.12
G17003100391,STCTY-17031 TRACT-    0391     IN CHICAGO IL,206,206,0,147,0,0,0
G17003100392,STCTY-17031 TRACT-    0392     IN CHICAGO IL,2300,2300,0,1706,0,0,29.97
G17003100393,STCTY-17031 TRACT-    0393     IN CHICAGO IL,1891,1891,0,1384,0,2285,24.44
G17003100394,STCTY-17031 TRACT-    0394     IN CHICAGO IL,733,642,91,508,91,0,0
G17003100395,STCTY-17031 TRACT-    0395     IN CHICAGO IL,2095,2076,19,1683,19,2034,22.71
G17003100396,STCTY-17031 TRACT-    0396     IN CHICAGO IL,936,936,0,671,0,0,23.34
G17003100397,STCTY-17031 TRACT-    0397     IN CHICAGO IL,4497,4102,395,2933,376,2244,26.21
G17003100398,STCTY-17031 TRACT-    0398     IN CHICAGO IL,429,428,1,363,0,0,0
G17003100399,STCTY-17031 TRACT-    0399     IN CHICAGO IL,583,579,4,486,3,0,23.67
G17003100400,STCTY-17031 TRACT-    0400     IN CHICAGO IL,261,259,2,215,0,0,0
G17003100401,STCTY-17031 TRACT-    0401     IN CHICAGO IL,2230,1961,269,1684,266,0,25.54
G17003100402,STCTY-17031 TRACT-    0402     IN CHICAGO IL,2434,1345,1089,927,1089,0,25.28
G17003100403,STCTY-17031 TRACT-    0403     IN CHICAGO IL,2914,2793,121,2189,119,1362,23.82
G17003100404,STCTY-17031 TRACT-    0404     IN CHICAGO IL,453,443,10,350,0,0,0
G17003100405,STCTY-17031 TRACT-    0405     IN CHICAGO IL,885,878,7,647,4,0,27.22
G17003100406,STCTY-17031 TRACT-    0406     IN CHICAGO IL,404,399,5,276,5,0,0
G17003100407,STCTY-17031 TRACT-    0407     IN CHICAGO IL,3858,3840,18,2791,1,1414,22.12
G17003100408,STCTY-17031 TRACT-    0408     IN CHICAGO IL,1913,1908,5,1271,0,0,28.49
G17003100409,STCTY-17031 TRACT-    0409     IN CHICAGO IL,838,838,0,618,0,0,20.66
G17003100410,STCTY-17031 TRACT-    0410     IN CHICAGO IL,3874,3809,65,3214,7,2207,17.87
G17003100411,STCTY-17031 TRACT-    0411     IN CHICAGO IL,917,917,0,787,0,0,15.24
G17003100412,STCTY-17031 TRACT-    0412     IN CHICAGO IL,1360,1149,211,965,181,0,16.06
G17003100413,STCTY-17031 TRACT-    0413     IN CHICAGO IL,4072,3888,184,3259,167,1984,18.13
G17003100414,STCTY-17031 TRACT-    0414     IN CHICAGO IL,4652,4584,68,3769,2,0,15.27
G17003100415,STCTY-17031 TRACT-    0415     IN CHICAGO IL,2466,2128,338,1459,325,0,10.87
G17003100416,STCTY-17031 TRACT-    0416     IN CHICAGO IL,1771,1725,46,1048,40,0,6.08
G17003100417,STCTY-17031 TRACT-    0417     IN CHICAGO IL,844,834,10,503,0,0,0
G17003100418,STCTY-17031 TRACT-    0418     IN CHICAGO IL,5694,5663,31,4495,16,0,10.67
G17003100419,STCTY-17031 TRACT-    0419     IN CHICAGO IL,3321,3289,32,2181,20,0,12.52
G17003100420,STCTY-17031 TRACT-    0420     IN CHICAGO IL,3465,3457,8,1976,4,0,12.56
G17003100421,STCTY-17031 TRACT-    0421     IN CHICAGO IL,3838,3830,8,2599,8,1773,22.3
G17003100422,STCTY-17031 TRACT-    0422     IN CHICAGO IL,3549,3533,16,2180,16,0,23.04
G17003100423,STCTY-17031 TRACT-    0423     IN CHICAGO IL,831,738,93,241,89,0,13.55
G17003100424,STCTY-17031 TRACT-    0424     IN CHICAGO IL,51,51,0,50,0,0,0
G17003100425,STCTY-17031 TRACT-    0425     IN CHICAGO IL,792,558,234,400,234,0,21.31
G17003100426,STCTY-17031 TRACT-    0426     IN CHICAGO IL,853,812,41,556,41,0,19.12
G17003100427,STCTY-17031 TRACT-    0427     IN CHICAGO IL,628,623,5,456,5,0,28.5
G17003100428,STCTY-17031 TRACT-    0428     IN CHICAGO IL,4995,4861,134,3310,134,2108,25.47
G17003100429,STCTY-17031 TRACT-    0429     IN CHICAGO IL,4691,4509,182,3518,162,0,24.15
G17003100430,STCTY-17031 TRACT-    0430     IN CHICAGO IL,277,277,0,193,0,0,0
G17003100431,STCTY-17031 TRACT-    0431     IN CHICAGO IL,2335,1710,625,1143,619,0,26.06
G17003100432,STCTY-17031 TRACT-    0432     IN CHICAGO IL,4129,3728,401,2671,401,1375,19.25
G17003100433,STCTY-17031 TRACT-    0433     IN CHICAGO IL,1838,1038,800,759,800,0,20.79
G17003100434,STCTY-17031 TRACT-    0434     IN CHICAGO IL,5774,1071,4703,749,4703,0,21.51
G17003100435,STCTY-17031 TRACT-    0435     IN CHICAGO IL,2311,2045,266,1368,259,0,22.47
G17003100436,STCTY-17031 TRACT-    0436     IN CHICAGO IL,1856,1853,3,1247,2,0,23.82
G17003100437,STCTY-17031 TRACT-    0437     IN CHICAGO IL,1043,1002,41,666,41,0,21.79
G17003100438,STCTY-17031 TRACT-    0438     IN CHICAGO IL,1181,1181,0,836,0,0,24.23
G17003100439,STCTY-17031 TRACT-    0439     IN CHICAGO IL,652,590,62,415,62,0,18.97
G17003100440,STCTY-17031 TRACT-    0440     IN CHICAGO IL,2602,212,2390,128,2379,0,19.37
G17003100441,STCTY-17031 TRACT-    0441     IN CHICAGO IL,4329,2296,2033,1302,2028,0,21.41
G17003100442,STCTY-17031 TRACT-    0442     IN CHICAGO IL,2042,685,1357,396,1355,0,18.84
G17003100443,STCTY-17031 TRACT-    0443     IN CHICAGO IL,304,123,181,91,179,0,0
G17003100444,STCTY-17031 TRACT-    0444     IN CHICAGO IL,2840,2839,1,1851,1,2654,41.05
G17003100445,STCTY-17031 TRACT-    0445     IN CHICAGO IL,2063,2063,0,1363,0,0,38.64
G17003100446,STCTY-17031 TRACT-    0446     IN CHICAGO IL,1268,1265,3,728,1,0,42.98
G17003100447,STCTY-17031 TRACT-    0447     IN CHICAGO IL,2308,2272,36,1395,33,0,41.17
G17003100448,STCTY-17031 TRACT-    0448     IN CHICAGO IL,1361,1314,47,756,47,0,34.55
G17003100449,STCTY-17031 TRACT-    0449     IN CHICAGO IL,1792,1792,0,1137,0,0,28.68
G17003100450,STCTY-17031 TRACT-    0450     IN CHICAGO IL,19829,19766,63,10549,59,2044,39.64
G17003100451,STCTY-17031 TRACT-    0451     IN CHICAGO IL,8721,8683,38,5182,24,2236,39.98
G17003100452,STCTY-17031 TRACT-    0452     IN CHICAGO IL,8033,7956,77,4464,77,2089,34.6
G17003100453,STCTY-17031 TRACT-    0453     IN CHICAGO IL,1746,1741,5,1047,5,0,33.6
G17003100454,STCTY-17031 TRACT-    0454     IN CHICAGO IL,4291,4219,72,2336,65,0,34.92
G17003100455,STCTY-17031 TRACT-    0455     IN CHICAGO IL,2802,2795,7,1732,6,0,29.5
G17003100456,STCTY-17031 TRACT-    0456     IN CHICAGO IL,116,80,36,61,36,0,0
G17003100457,STCTY-17031 TRACT-    0457     IN CHICAGO IL,4171,4170,1,2953,0,1857,27.26
G17003100458,STCTY-17031 TRACT-    0458     IN CHICAGO IL,0,0,0,0,0,0,0
G17003100459,STCTY-17031 TRACT-    0459     IN CHICAGO IL,1808,1808,0,1297,0,2022,28.08
G17003100460,STCTY-17031 TRACT-    0460     IN CHICAGO IL,13930,13926,4,9173,2,2167,40.62
G17003100461,STCTY-17031 TRACT-    0461     IN CHICAGO IL,3915,3905,10,2283,10,0,39.41
G17003100462,STCTY-17031 TRACT-    0462     IN CHICAGO IL,5506,5504,2,4023,1,3544,36.31
G17003100463,STCTY-17031 TRACT-    0463     IN CHICAGO IL,5988,5982,6,3822,4,2461,39.47
G17003100464,STCTY-17031 TRACT-    0464     IN CHICAGO IL,2401,2395,6,1892,5,2524,33.62
G17003100465,STCTY-17031 TRACT-    0465     IN CHICAGO IL,0,0,0,0,0,0,0
G17003100466,STCTY-17031 TRACT-    0466     IN CHICAGO IL,1490,1490,0,1212,0,0,38.37
G17003100467,STCTY-17031 TRACT-    0467     IN CHICAGO IL,1539,1539,0,1247,0,2702,33.47
G17003100468,STCTY-17031 TRACT-    0468     IN CHICAGO IL,1549,1545,4,1108,4,0,29.44
G17003100469,STCTY-17031 TRACT-    0469     IN CHICAGO IL,1793,1793,0,1164,0,2682,34.08
G17003100470,STCTY-17031 TRACT-    0470     IN CHICAGO IL,1210,1206,4,914,0,0,34.5
G17003100471,STCTY-17031 TRACT-    0471     IN CHICAGO IL,2437,2437,0,1854,0,1888,22.07
G17003100472,STCTY-17031 TRACT-    0472     IN CHICAGO IL,1253,1253,0,946,0,0,23.76
G17003100473,STCTY-17031 TRACT-    0473     IN CHICAGO IL,1496,1496,0,1173,0,2197,26.01
G17003100474,STCTY-17031 TRACT-    0474     IN CHICAGO IL,4937,4937,0,3730,0,2101,26.14
G17003100475,STCTY-17031 TRACT-    0475     IN CHICAGO IL,0,0,0,0,0,0,0
G17003100476,STCTY-17031 TRACT-    0476     IN CHICAGO IL,2927,2927,0,2193,0,2753,32.67
G17003100477,STCTY-17031 TRACT-    0477     IN CHICAGO IL,11335,11333,2,8991,0,2796,31.78
G17003100478,STCTY-17031 TRACT-    0478     IN CHICAGO IL,7377,7372,5,5190,4,2701,28.8
G17003100479,STCTY-17031 TRACT-    0479     IN CHICAGO IL,1301,1301,0,969,0,3450,26.43
G17003100480,STCTY-17031 TRACT-    0480     IN CHICAGO IL,2587,2587,0,1869,0,3124,27.66
G17003100481,STCTY-17031 TRACT-    0481     IN CHICAGO IL,3107,3106,1,2246,1,3487,33.57
G17003100482,STCTY-17031 TRACT-    0482     IN CHICAGO IL,449,448,1,314,1,0,0
G17003100483,STCTY-17031 TRACT-    0483     IN CHICAGO IL,4193,4189,4,3012,0,2413,30.69
G17003100484,STCTY-17031 TRACT-    0484     IN CHICAGO IL,5051,5051,0,3618,0,2370,26.6
G17003100485,STCTY-17031 TRACT-    0485     IN CHICAGO IL,344,344,0,275,0,0,0
G17003100486,STCTY-17031 TRACT-    0486     IN CHICAGO IL,225,225,0,175,0,0,0
G17003100487,STCTY-17031 TRACT-    0487     IN CHICAGO IL,1701,1698,3,1280,0,0,28.9
G17003100488,STCTY-17031 TRACT-    0488     IN CHICAGO IL,6053,6052,1,4491,0,1913,23.58
G17003100489,STCTY-17031 TRACT-    0489     IN CHICAGO IL,2995,2995,0,2325,0,2112,24.29
G17003100490,STCTY-17031 TRACT-    0490     IN CHICAGO IL,4259,4259,0,2919,0,2425,28.12
G17003100491,STCTY-17031 TRACT-    0491     IN CHICAGO IL,3251,3251,0,2324,0,2274,27.93
G17003100492,STCTY-17031 TRACT-    0492     IN CHICAGO IL,1151,1151,0,866,0,1742,22.52
G17003100493,STCTY-17031 TRACT-    0493     IN CHICAGO IL,2452,1660,792,1411,784,0,0
G17003100494,STCTY-17031 TRACT-    0494     IN CHICAGO IL,34,34,0,26,0,0,0
G17003100495,STCTY-17031 TRACT-    0495     IN CHICAGO IL,2686,2685,1,1975,1,1351,18.02
G17003100496,STCTY-17031 TRACT-    0496     IN CHICAGO IL,8363,8362,1,5670,0,1130,19
G17003100497,STCTY-17031 TRACT-    0497     IN CHICAGO IL,2411,2406,5,1682,0,1854,17.49
G17003100498,STCTY-17031 TRACT-    0498     IN CHICAGO IL,19,19,0,12,0,0,0
G17003100499,STCTY-17031 TRACT-    0499     IN CHICAGO IL,2341,2341,0,1675,0,902,16.47
G17003100500,STCTY-17031 TRACT-    0500     IN CHICAGO IL,3191,3183,8,2326,1,1425,18.92
G17003100501,STCTY-17031 TRACT-    0501     IN CHICAGO IL,4835,4832,3,3312,0,1350,18.36
G17003100502,STCTY-17031 TRACT-    0502     IN CHICAGO IL,877,875,2,603,1,0,17.96
G17003100503,STCTY-17031 TRACT-    0503     IN CHICAGO IL,19,19,0,12,0,0,0
G17003100504,STCTY-17031 TRACT-    0504     IN CHICAGO IL,123,123,0,101,0,0,0
G17003100505,STCTY-17031 TRACT-    0505     IN CHICAGO IL,7419,7419,0,5652,0,1684,20.54
G17003100506,STCTY-17031 TRACT-    0506     IN CHICAGO IL,5998,5995,3,3754,3,2175,28.94
G17003100507,STCTY-17031 TRACT-    0507     IN CHICAGO IL,473,473,0,319,0,0,0
G17003100508,STCTY-17031 TRACT-    0508     IN CHICAGO IL,7911,7911,0,6001,0,1426,19.98
G17003100509,STCTY-17031 TRACT-    0509     IN CHICAGO IL,7643,7639,4,5671,0,1582,19.82
G17003100510,STCTY-17031 TRACT-    0510     IN CHICAGO IL,3599,3599,0,2566,0,1673,22.69
G17003100511,STCTY-17031 TRACT-    0511     IN CHICAGO IL,605,594,11,509,6,0,0
G17003100512,STCTY-17031 TRACT-    0512     IN CHICAGO IL,12,12,0,10,0,0,0
G17003100513,STCTY-17031 TRACT-    0513     IN CHICAGO IL,448,448,0,370,0,0,0
G17003100514,STCTY-17031 TRACT-    0514     IN CHICAGO IL,2256,2188,68,1693,7,0,0
G17003100515,STCTY-17031 TRACT-    0515     IN CHICAGO IL,553,534,19,432,0,0,0
G17003100516,STCTY-17031 TRACT-    0516     IN CHICAGO IL,2347,2339,8,1896,1,0,41.57
G17003100517,STCTY-17031 TRACT-    0517     IN CHICAGO IL,3278,3139,139,2615,135,0,22.32
G17003100518,STCTY-17031 TRACT-    0518     IN CHICAGO IL,0,0,0,0,0,0,0
G17003100519,STCTY-17031 TRACT-    0519     IN CHICAGO IL,1366,1271,95,1018,69,0,17.99
G17003100520,STCTY-17031 TRACT-    0520     IN CHICAGO IL,1294,790,504,654,492,0,25.22
G17003100521,STCTY-17031 TRACT-    0521     IN CHICAGO IL,881,84,797,77,797,0,28.06
G17003100522,STCTY-17031 TRACT-    0522     IN CHICAGO IL,487,86,401,59,397,0,14.9
G17003100523,STCTY-17031 TRACT-    0523     IN CHICAGO IL,262,27,235,21,18,0,0
G17003100524,STCTY-17031 TRACT-    0524     IN CHICAGO IL,5091,4287,804,3095,138,1397,22.79
G17003100525,STCTY-17031 TRACT-    0525     IN CHICAGO IL,486,486,0,385,0,0,18.82
G17003100526,STCTY-17031 TRACT-    0526     IN CHICAGO IL,1700,1700,0,1273,0,1558,23.39
G17003100527,STCTY-17031 TRACT-    0527     IN CHICAGO IL,1601,1572,29,1172,29,0,24.18
G17003100528,STCTY-17031 TRACT-    0528     IN CHICAGO IL,1033,1033,0,715,0,0,27.87
G17003100529,STCTY-17031 TRACT-    0529     IN CHICAGO IL,205,194,11,135,10,0,0
G17003100530,STCTY-17031 TRACT-    0530     IN CHICAGO IL,368,368,0,269,0,0,0
G17003100531,STCTY-17031 TRACT-    0531     IN CHICAGO IL,197,197,0,133,0,0,0
G17003100532,STCTY-17031 TRACT-    0532     IN CHICAGO IL,954,952,2,657,2,0,26.85
G17003100533,STCTY-17031 TRACT-    0533     IN CHICAGO IL,733,579,154,393,152,0,23.25
G17003100534,STCTY-17031 TRACT-    0534     IN CHICAGO IL,1774,1482,292,1094,292,2839,26.94
G17003100535,STCTY-17031 TRACT-    0535     IN CHICAGO IL,1059,379,680,284,676,0,21.38
G17003100536,STCTY-17031 TRACT-    0536     IN CHICAGO IL,377,94,283,63,283,0,0
G17003100537,STCTY-17031 TRACT-    0537     IN CHICAGO IL,475,44,431,26,431,0,22.86
G17003100538,STCTY-17031 TRACT-    0538     IN CHICAGO IL,2157,124,2033,92,2031,0,22.49
G17003100539,STCTY-17031 TRACT-    0539     IN CHICAGO IL,1525,191,1334,154,1334,0,21.73
G17003100540,STCTY-17031 TRACT-    0540     IN CHICAGO IL,385,6,379,6,379,0,25.67
G17003100541,STCTY-17031 TRACT-    0541     IN CHICAGO IL,1766,53,1713,35,1710,0,26.98
G17003100542,STCTY-17031 TRACT-    0542     IN CHICAGO IL,3087,45,3042,29,3039,0,23.38
G17003100543,STCTY-17031 TRACT-    0543     IN CHICAGO IL,2958,441,2517,352,2516,0,24.06
G17003100544,STCTY-17031 TRACT-    0544     IN CHICAGO IL,1340,32,1308,21,1304,0,21.06
G17003100545,STCTY-17031 TRACT-    0545     IN CHICAGO IL,1412,8,1404,5,1403,0,21.15
G17003100546,STCTY-17031 TRACT-    0546     IN CHICAGO IL,1987,64,1923,48,1921,0,19.99
G17003100547,STCTY-17031 TRACT-    0547     IN CHICAGO IL,4235,32,4203,16,4203,0,25.83
G17003100548,STCTY-17031 TRACT-    0548     IN CHICAGO IL,3471,614,2857,471,2856,0,22.72
G17003100549,STCTY-17031 TRACT-    0549     IN CHICAGO IL,3660,834,2826,737,2822,0,27.23
G17003100550,STCTY-17031 TRACT-    0550     IN CHICAGO IL,1372,19,1353,14,1346,0,17.96
G17003100551,STCTY-17031 TRACT-    0551     IN CHICAGO IL,654,3,651,3,651,0,23.55
G17003100552,STCTY-17031 TRACT-    0552     IN CHICAGO IL,4080,23,4057,17,4055,0,24.51
G17003100553,STCTY-17031 TRACT-    0553     IN CHICAGO IL,5101,47,5054,33,5054,2647,25.54
G17003100554,STCTY-17031 TRACT-    0554     IN CHICAGO IL,5283,173,5110,133,5107,0,28.38
G17003100555,STCTY-17031 TRACT-    0555     IN CHICAGO IL,4476,664,3812,559,3810,2911,25.76
G17003100556,STCTY-17031 TRACT-    0556     IN CHICAGO IL,1570,29,1541,18,1540,0,26.06
G17003100557,STCTY-17031 TRACT-    0557     IN CHICAGO IL,4762,8,4754,7,4754,2583,21.83
G17003100558,STCTY-17031 TRACT-    0558     IN CHICAGO IL,1222,1179,43,959,6,0,23.76
G17003100559,STCTY-17031 TRACT-    0559     IN CHICAGO IL,2660,370,2290,298,2278,0,27.88
G17003100560,STCTY-17031 TRACT-    0560     IN CHICAGO IL,3665,2834,831,2352,760,0,25.96
G17003100561,STCTY-17031 TRACT-    0561     IN CHICAGO IL,3183,3014,169,2606,162,3024,25.48
G17003100562,STCTY-17031 TRACT-    0562     IN CHICAGO IL,3770,3756,14,3280,3,3424,28.49
G17003100563,STCTY-17031 TRACT-    0563     IN CHICAGO IL,668,656,12,537,0,0,22.91
G17003100564,STCTY-17031 TRACT-    0564     IN CHICAGO IL,1647,1441,206,1110,206,1818,20.89
G17003100565,STCTY-17031 TRACT-    0565     IN CHICAGO IL,3048,3038,10,2201,10,1661,25.33
G17003100566,STCTY-17031 TRACT-    0566     IN CHICAGO IL,843,580,263,403,262,0,21.04
G17003100567,STCTY-17031 TRACT-    0567     IN CHICAGO IL,3293,3114,179,2377,179,1653,25.21
G17003100568,STCTY-17031 TRACT-    0568     IN CHICAGO IL,0,0,0,0,0,0,0
G17003100569,STCTY-17031 TRACT-    0569     IN CHICAGO IL,3549,3533,16,2669,4,1923,24.73
G17003100570,STCTY-17031 TRACT-    0570     IN CHICAGO IL,1078,445,633,341,632,0,27.98
G17003100571,STCTY-17031 TRACT-    0571     IN CHICAGO IL,357,341,16,271,16,0,0
G17003100572,STCTY-17031 TRACT-    0572     IN CHICAGO IL,611,482,129,360,129,0,22
G17003100573,STCTY-17031 TRACT-    0573     IN CHICAGO IL,1234,23,1211,17,1211,0,27.78
G17003100574,STCTY-17031 TRACT-    0574     IN CHICAGO IL,2925,323,2602,237,2600,0,29.31
G17003100575,STCTY-17031 TRACT-    0575     IN CHICAGO IL,8938,284,8654,219,8651,2303,24.26
G17003100576,STCTY-17031 TRACT-    0576     IN CHICAGO IL,5939,113,5826,93,5822,3429,24.13
G17003100577,STCTY-17031 TRACT-    0577     IN CHICAGO IL,6389,14,6375,10,6373,3331,30.44
G17003100578,STCTY-17031 TRACT-    0578     IN CHICAGO IL,4442,42,4400,23,4392,0,31.44
G17003100579,STCTY-17031 TRACT-    0579     IN CHICAGO IL,1401,5,1396,3,1395,0,23.31
G17003100580,STCTY-17031 TRACT-    0580     IN CHICAGO IL,1235,13,1222,10,1222,0,25.76
G17003100581,STCTY-17031 TRACT-    0581     IN CHICAGO IL,5238,67,5171,59,5168,0,25.69
G17003100582,STCTY-17031 TRACT-    0582     IN CHICAGO IL,8496,36,8460,27,8453,4067,22.17
G17003100583,STCTY-17031 TRACT-    0583     IN CHICAGO IL,8024,48,7976,33,7971,3650,26.86
G17003100584,STCTY-17031 TRACT-    0584     IN CHICAGO IL,5912,74,5838,43,5838,0,30.96
G17003100585,STCTY-17031 TRACT-    0585     IN CHICAGO IL,3641,19,3622,9,3621,0,31.03
G17003100586,STCTY-17031 TRACT-    0586     IN CHICAGO IL,8727,37,8690,19,8687,0,25.73
G17003100587,STCTY-17031 TRACT-    0587     IN CHICAGO IL,6351,147,6204,125,6203,0,26.05
G17003100588,STCTY-17031 TRACT-    0588     IN CHICAGO IL,1565,8,1557,3,1556,0,29.43
G17003100589,STCTY-17031 TRACT-    0589     IN CHICAGO IL,6471,182,6289,133,6288,0,40.85
G17003100590,STCTY-17031 TRACT-    0590     IN CHICAGO IL,2291,60,2231,43,2231,0,34.82
G17003100591,STCTY-17031 TRACT-    0591     IN CHICAGO IL,8740,349,8391,272,8383,2833,31.86
G17003100592,STCTY-17031 TRACT-    0592     IN CHICAGO IL,5297,20,5277,13,5274,0,26.04
G17003100593,STCTY-17031 TRACT-    0593     IN CHICAGO IL,5059,4969,90,4083,84,0,38.1
G17003100594,STCTY-17031 TRACT-    0594     IN CHICAGO IL,5103,5087,16,4335,12,4097,33.09
G17003100595,STCTY-17031 TRACT-    0595     IN CHICAGO IL,4726,4714,12,4027,5,4571,33.65
G17003100596,STCTY-17031 TRACT-    0596     IN CHICAGO IL,3962,3927,35,3144,30,0,44.15
G17003100597,STCTY-17031 TRACT-    0597     IN CHICAGO IL,2658,2589,69,2078,64,20000,43.26
G17003100598,STCTY-17031 TRACT-    0598     IN CHICAGO IL,3397,3336,61,2799,60,14286,54.61
G17003100599,STCTY-17031 TRACT-    0599     IN CHICAGO IL,4706,4673,33,3966,23,0,44.68
G17003100600,STCTY-17031 TRACT-    0600     IN CHICAGO IL,2663,11,2652,8,2652,0,27.7
G17003100601,STCTY-17031 TRACT-    0601     IN CHICAGO IL,7266,309,6957,135,6954,0,35.38
G17003100602,STCTY-17031 TRACT-    0602     IN CHICAGO IL,9122,189,8933,128,8931,0,34.28
G17003100603,STCTY-17031 TRACT-    0603     IN CHICAGO IL,7061,56,7005,38,7001,3250,42.47
G17003100604,STCTY-17031 TRACT-    0604     IN CHICAGO IL,11663,123,11540,76,11530,0,36.39
G17003100605,STCTY-17031 TRACT-    0605     IN CHICAGO IL,4077,51,4026,28,4025,0,43.24
G17003100606,STCTY-17031 TRACT-    0606     IN CHICAGO IL,3678,68,3610,34,3607,2533,31.29
G17003100607,STCTY-17031 TRACT-    0607     IN CHICAGO IL,7206,623,6583,469,6581,0,41.99
G17003100608,STCTY-17031 TRACT-    0608     IN CHICAGO IL,1043,1030,13,790,13,0,69.85
G17003100609,STCTY-17031 TRACT-    0609     IN CHICAGO IL,1372,1361,11,1076,11,0,58.08
G17003100610,STCTY-17031 TRACT-    0610     IN CHICAGO IL,1935,1925,10,1621,10,0,55.72
G17003100611,STCTY-17031 TRACT-    0611     IN CHICAGO IL,2691,2674,17,2291,7,0,48.97
G17003100612,STCTY-17031 TRACT-    0612     IN CHICAGO IL,5272,5231,41,4363,41,0,64.53
G17003100613,STCTY-17031 TRACT-    0613     IN CHICAGO IL,5615,5501,114,4481,109,0,41.9
G17003100614,STCTY-17031 TRACT-    0614     IN CHICAGO IL,5451,5380,71,4115,54,3864,46.39
G17003100615,STCTY-17031 TRACT-    0615     IN CHICAGO IL,4421,4411,10,3141,5,0,49.27
G17003100616,STCTY-17031 TRACT-    0616     IN CHICAGO IL,6082,6007,75,4340,59,0,46.16
G17003100617,STCTY-17031 TRACT-    0617     IN CHICAGO IL,3858,3734,124,2911,54,0,44.14
G17003100618,STCTY-17031 TRACT-    0618     IN CHICAGO IL,1218,1193,25,925,17,0,34.61
G17003100619,STCTY-17031 TRACT-    0619     IN CHICAGO IL,3432,3364,68,2889,23,12685,44.67
G17003100620,STCTY-17031 TRACT-    0620     IN CHICAGO IL,4275,4081,194,3502,145,0,38.61
G17003100621,STCTY-17031 TRACT-    0621     IN CHICAGO IL,3087,3060,27,2618,25,0,71.87
G17003100622,STCTY-17031 TRACT-    0622     IN CHICAGO IL,798,798,0,705,0,0,53.07
G17003100623,STCTY-17031 TRACT-    0623     IN CHICAGO IL,5325,4476,849,3324,814,2602,39.84
G17003100624,STCTY-17031 TRACT-    0624     IN CHICAGO IL,3284,3279,5,2417,3,2763,44.23
G17003100625,STCTY-17031 TRACT-    0625     IN CHICAGO IL,9601,726,8875,593,8866,3284,39.2
G17003100626,STCTY-17031 TRACT-    0626     IN CHICAGO IL,3143,3134,9,2590,2,0,41.42
G17003100627,STCTY-17031 TRACT-    0627     IN CHICAGO IL,7773,7753,20,6575,9,2955,32.99
G17003100628,STCTY-17031 TRACT-    0628     IN CHICAGO IL,4937,4924,13,4322,2,0,30.57
G17003100629,STCTY-17031 TRACT-    0629     IN CHICAGO IL,6866,6861,5,6003,0,5268,39.79
G17003100630,STCTY-17031 TRACT-    0630     IN CHICAGO IL,7240,7223,17,6300,2,0,31.94
G17003100631,STCTY-17031 TRACT-    0631     IN CHICAGO IL,6683,6674,9,5999,7,4921,37.22
G17003100632,STCTY-17031 TRACT-    0632     IN CHICAGO IL,5091,5084,7,4467,2,0,28.39
G17003100633,STCTY-17031 TRACT-    0633     IN CHICAGO IL,9055,9016,39,7905,1,0,34.6
G17003100634,STCTY-17031 TRACT-    0634     IN CHICAGO IL,2687,288,2399,221,0,3300,38.22
G17003100635,STCTY-17031 TRACT-    0635     IN CHICAGO IL,8416,8374,42,7105,39,18333,49.16
G17003100636,STCTY-17031 TRACT-    0636     IN CHICAGO IL,12599,12495,104,10569,95,11935,62.18
G17003100637,STCTY-17031 TRACT-    0637     IN CHICAGO IL,2124,2110,14,1899,14,0,57.42
G17003100638,STCTY-17031 TRACT-    0638     IN CHICAGO IL,2954,2941,13,2614,13,13464,52.02
G17003100639,STCTY-17031 TRACT-    0639     IN CHICAGO IL,6298,6285,13,5549,13,5417,49.46
G17003100640,STCTY-17031 TRACT-    0640     IN CHICAGO IL,2271,2271,0,2002,0,9444,53.02
G17003100641,STCTY-17031 TRACT-    0641     IN CHICAGO IL,2768,2760,8,2416,8,9971,57.63
G17003100642,STCTY-17031 TRACT-    0642     IN CHICAGO IL,19328,19265,63,16450,62,5740,53.54
G17003100643,STCTY-17031 TRACT-    0643     IN CHICAGO IL,3729,3729,0,3235,0,7102,57.26
G17003100644,STCTY-17031 TRACT-    0644     IN CHICAGO IL,6719,6716,3,5879,3,6384,52.38
G17003100645,STCTY-17031 TRACT-    0645     IN CHICAGO IL,5478,5463,15,4622,2,3844,45.84
G17003100646,STCTY-17031 TRACT-    0646     IN CHICAGO IL,4870,4869,1,4080,0,3731,43.9
G17003100647,STCTY-17031 TRACT-    0647     IN CHICAGO IL,2039,2039,0,1569,0,2713,36.7
G17003100648,STCTY-17031 TRACT-    0648     IN CHICAGO IL,4459,4453,6,3896,4,6313,49.85
G17003100649,STCTY-17031 TRACT-    0649     IN CHICAGO IL,10122,10120,2,8672,2,6101,55.1
G17003100650,STCTY-17031 TRACT-    0650     IN CHICAGO IL,9878,9871,7,8654,2,4821,52.15
G17003100651,STCTY-17031 TRACT-    0651     IN CHICAGO IL,655,648,7,530,3,0,0
G17003100652,STCTY-17031 TRACT-    0652     IN CHICAGO IL,2642,2642,0,2081,0,5052,42.46
G17003100653,STCTY-17031 TRACT-    0653     IN CHICAGO IL,831,831,0,714,0,5250,0
G17003100654,STCTY-17031 TRACT-    0654     IN CHICAGO IL,8,8,0,8,0,0,0
G17003100655,STCTY-17031 TRACT-    0655     IN CHICAGO IL,6,6,0,5,0,0,0
G17003100656,STCTY-17031 TRACT-    0656     IN CHICAGO IL,4476,4476,0,3770,0,5101,44.23
G17003100657,STCTY-17031 TRACT-    0657     IN CHICAGO IL,3842,3833,9,2878,9,3803,37.6
G17003100658,STCTY-17031 TRACT-    0658     IN CHICAGO IL,869,869,0,702,0,0,36.3
G17003100659,STCTY-17031 TRACT-    0659     IN CHICAGO IL,4165,4161,4,3671,2,5962,49.55
G17003100660,STCTY-17031 TRACT-    0660     IN CHICAGO IL,608,608,0,463,0,0,34.78
G17003100661,STCTY-17031 TRACT-    0661     IN CHICAGO IL,5691,5689,2,5007,2,6619,47.37
G17003100662,STCTY-17031 TRACT-    0662     IN CHICAGO IL,7534,7521,13,6568,8,6857,53.94
G17003100663,STCTY-17031 TRACT-    0663     IN CHICAGO IL,4223,4214,9,3411,9,4552,54.25
G17003100664,STCTY-17031 TRACT-    0664     IN CHICAGO IL,11868,11867,1,9517,1,3700,36.57
G17003100665,STCTY-17031 TRACT-    0665     IN CHICAGO IL,6327,6315,12,5141,12,3280,31.57
G17003100666,STCTY-17031 TRACT-    0666     IN CHICAGO IL,6514,6500,14,4968,0,2146,26.05
G17003100667,STCTY-17031 TRACT-    0667     IN CHICAGO IL,5805,5672,133,4275,133,2014,26.25
G17003100668,STCTY-17031 TRACT-    0668     IN CHICAGO IL,2391,2391,0,1945,0,3117,34.63
G17003100669,STCTY-17031 TRACT-    0669     IN CHICAGO IL,3826,3799,27,2966,27,2568,31.79
G17003100670,STCTY-17031 TRACT-    0670     IN CHICAGO IL,2801,2113,688,1250,686,0,25.91
G17003100671,STCTY-17031 TRACT-    0671     IN CHICAGO IL,3801,3765,36,2662,31,0,26.29
G17003100672,STCTY-17031 TRACT-    0672     IN CHICAGO IL,2,2,0,2,0,0,0
G17003100673,STCTY-17031 TRACT-    0673     IN CHICAGO IL,3565,3556,9,2464,4,2735,28.91
G17003100674,STCTY-17031 TRACT-    0674     IN CHICAGO IL,0,0,0,0,0,0,0
G17003100675,STCTY-17031 TRACT-    0675     IN CHICAGO IL,262,262,0,220,0,0,0
G17003100676,STCTY-17031 TRACT-    0676     IN CHICAGO IL,794,794,0,707,0,0,61.12
G17003100677,STCTY-17031 TRACT-    0677     IN CHICAGO IL,1423,1423,0,1205,0,3286,52.13
G17003100678,STCTY-17031 TRACT-    0678     IN CHICAGO IL,1781,1780,1,1473,1,3664,34.97
G17003100679,STCTY-17031 TRACT-    0679     IN CHICAGO IL,2874,2874,0,2238,0,4206,38.75
G17003100680,STCTY-17031 TRACT-    0680     IN CHICAGO IL,283,279,4,205,3,0,0
G17003100681,STCTY-17031 TRACT-    0681     IN CHICAGO IL,958,425,533,326,533,2375,0
G17003100682,STCTY-17031 TRACT-    0682     IN CHICAGO IL,832,832,0,703,0,0,41.82
G17003100683,STCTY-17031 TRACT-    0683     IN CHICAGO IL,483,14,469,8,469,0,0
G17003100684,STCTY-17031 TRACT-    0684     IN CHICAGO IL,19,19,0,15,0,0,0
G17003100685,STCTY-17031 TRACT-    0685     IN CHICAGO IL,851,29,822,25,821,2299,0
G17003100686,STCTY-17031 TRACT-    0686     IN CHICAGO IL,244,244,0,190,0,0,0
G17003100687,STCTY-17031 TRACT-    0687     IN CHICAGO IL,3189,3189,0,2531,0,4722,42.94
G17003100688,STCTY-17031 TRACT-    0688     IN CHICAGO IL,8697,8696,1,6430,1,3858,40.14
G17003100689,STCTY-17031 TRACT-    0689     IN CHICAGO IL,5720,5718,2,4410,2,3909,41.06
G17003100690,STCTY-17031 TRACT-    0690     IN CHICAGO IL,2823,2823,0,2159,0,4634,42.91
G17003100691,STCTY-17031 TRACT-    0691     IN CHICAGO IL,9066,9065,1,6715,1,3742,34.79
G17003100692,STCTY-17031 TRACT-    0692     IN CHICAGO IL,4664,4660,4,3576,1,3529,36.15
G17003100693,STCTY-17031 TRACT-    0693     IN CHICAGO IL,2481,2481,0,2046,0,5980,47.42
G17003100694,STCTY-17031 TRACT-    0694     IN CHICAGO IL,2676,2676,0,2228,0,4990,47
G17003100695,STCTY-17031 TRACT-    0695     IN CHICAGO IL,1305,1305,0,1003,0,4907,42.43
G17003100696,STCTY-17031 TRACT-    0696     IN CHICAGO IL,1,1,0,1,0,0,0
G17003100697,STCTY-17031 TRACT-    0697     IN CHICAGO IL,379,379,0,342,0,0,0
G17003100698,STCTY-17031 TRACT-    0698     IN CHICAGO IL,2259,2259,0,1648,0,2234,24.03
G17003100699,STCTY-17031 TRACT-    0699     IN CHICAGO IL,3885,3883,2,2562,2,3031,26.38
G17003100700,STCTY-17031 TRACT-    0700     IN CHICAGO IL,190,190,0,144,0,0,0
G17003100701,STCTY-17031 TRACT-    0701     IN CHICAGO IL,4939,4939,0,3862,0,3241,29.04
G17003100702,STCTY-17031 TRACT-    0702     IN CHICAGO IL,87,87,0,61,0,0,0
G17003100703,STCTY-17031 TRACT-    0703     IN CHICAGO IL,3843,3843,0,2899,0,3285,33.18
G17003100704,STCTY-17031 TRACT-    0704     IN CHICAGO IL,603,603,0,459,0,0,0
G17003100705,STCTY-17031 TRACT-    0705     IN CHICAGO IL,2623,2622,1,2144,0,3880,35.76
G17003100706,STCTY-17031 TRACT-    0706     IN CHICAGO IL,4711,4711,0,3644,0,2842,31.01
G17003100707,STCTY-17031 TRACT-    0707     IN CHICAGO IL,4221,4221,0,3411,0,3096,31.18
G17003100708,STCTY-17031 TRACT-    0708     IN CHICAGO IL,3769,3769,0,3115,0,4500,40.95
G17003100709,STCTY-17031 TRACT-    0709     IN CHICAGO IL,691,691,0,598,0,0,0
G17003100710,STCTY-17031 TRACT-    0710     IN CHICAGO IL,498,498,0,410,0,0,0
G17003100711,STCTY-17031 TRACT-    0711     IN CHICAGO IL,1943,1935,8,1367,8,2491,23.13
G17003100712,STCTY-17031 TRACT-    0712     IN CHICAGO IL,5051,4947,104,3414,94,2795,27.21
G17003100713,STCTY-17031 TRACT-    0713     IN CHICAGO IL,2495,2495,0,1829,0,2341,28.96
G17003100714,STCTY-17031 TRACT-    0714     IN CHICAGO IL,8534,8534,0,6495,0,3559,33.73
G17003100715,STCTY-17031 TRACT-    0715     IN CHICAGO IL,9811,9808,3,7681,1,4381,35.6
G17003100716,STCTY-17031 TRACT-    0716     IN CHICAGO IL,0,0,0,0,0,0,0
G17003100717,STCTY-17031 TRACT-    0717     IN CHICAGO IL,1509,1503,6,1159,6,2893,26.81
G17003100718,STCTY-17031 TRACT-    0718     IN CHICAGO IL,6654,6654,0,4956,0,2418,25.53
G17003100719,STCTY-17031 TRACT-    0719     IN CHICAGO IL,855,855,0,686,0,3682,0
G17003100720,STCTY-17031 TRACT-    0720     IN CHICAGO IL,163,163,0,117,0,0,0
G17003100721,STCTY-17031 TRACT-    0721     IN CHICAGO IL,108,108,0,78,0,0,0
G17003100722,STCTY-17031 TRACT-    0722     IN CHICAGO IL,14,14,0,8,0,0,0
G17003100723,STCTY-17031 TRACT-    0723     IN CHICAGO IL,0,0,0,0,0,0,0
G17003100724,STCTY-17031 TRACT-    0724     IN CHICAGO IL,7,7,0,7,0,0,0
G17003100725,STCTY-17031 TRACT-    0725     IN CHICAGO IL,894,894,0,648,0,3321,0
G17003100726,STCTY-17031 TRACT-    0726     IN CHICAGO IL,957,957,0,746,0,3300,0
G17003100727,STCTY-17031 TRACT-    0727     IN CHICAGO IL,1922,1921,1,1560,1,3949,28.12
G17003100728,STCTY-17031 TRACT-    0728     IN CHICAGO IL,634,634,0,456,0,0,0
G17003100729,STCTY-17031 TRACT-    0729     IN CHICAGO IL,1573,1573,0,1198,0,3387,28.21
G17003100730,STCTY-17031 TRACT-    0730     IN CHICAGO IL,5,5,0,5,0,0,0
G17003100731,STCTY-17031 TRACT-    0731     IN CHICAGO IL,8,8,0,8,0,0,0
G17003100732,STCTY-17031 TRACT-    0732     IN CHICAGO IL,526,526,0,373,0,0,0
G17003100733,STCTY-17031 TRACT-    0733     IN CHICAGO IL,2,2,0,1,0,0,0
G17003100734,STCTY-17031 TRACT-    0734     IN CHICAGO IL,535,535,0,391,0,0,0
G17003100735,STCTY-17031 TRACT-    0735     IN CHICAGO IL,1688,1688,0,1286,0,3596,31.57
G17003100736,STCTY-17031 TRACT-    0736     IN CHICAGO IL,546,546,0,378,0,0,0
G17003100737,STCTY-17031 TRACT-    0737     IN CHICAGO IL,4341,4340,1,3169,1,4298,34.85
G17003100738,STCTY-17031 TRACT-    0738     IN CHICAGO IL,1106,1106,0,818,0,3045,27.51
G17003100739,STCTY-17031 TRACT-    0739     IN CHICAGO IL,3039,3039,0,2608,0,2428,31.97
G17003100740,STCTY-17031 TRACT-    0740     IN CHICAGO IL,3538,3537,1,2799,0,2542,29.43
G17003100741,STCTY-17031 TRACT-    0741     IN CHICAGO IL,2385,2385,0,1744,0,2073,26.79
G17003100742,STCTY-17031 TRACT-    0742     IN CHICAGO IL,1709,1709,0,1382,0,3297,36.51
G17003100743,STCTY-17031 TRACT-    0743     IN CHICAGO IL,2073,2073,0,1550,0,3657,34.99
G17003100744,STCTY-17031 TRACT-    0744     IN CHICAGO IL,0,0,0,0,0,0,0
G17003100745,STCTY-17031 TRACT-    0745     IN CHICAGO IL,11733,11733,0,8662,0,2643,33.05
G17003100746,STCTY-17031 TRACT-    0746     IN CHICAGO IL,6426,6425,1,4657,1,2662,32.02
G17003100747,STCTY-17031 TRACT-    0747     IN CHICAGO IL,5450,5450,0,3958,0,3102,31.89
G17003100748,STCTY-17031 TRACT-    0748     IN CHICAGO IL,5542,5509,33,3947,33,2850,32.59
G17003100749,STCTY-17031 TRACT-    0749     IN CHICAGO IL,2063,2063,0,1431,0,2368,28.83
G17003100750,STCTY-17031 TRACT-    0750     IN CHICAGO IL,1065,1065,0,782,0,0,28.71
G17003100751,STCTY-17031 TRACT-    0751     IN CHICAGO IL,7,7,0,4,0,0,0
G17003100752,STCTY-17031 TRACT-    0752     IN CHICAGO IL,4289,4286,3,3646,0,2891,30.35
G17003100753,STCTY-17031 TRACT-    0753     IN CHICAGO IL,451,451,0,386,0,0,0
G17003100754,STCTY-17031 TRACT-    0754     IN CHICAGO IL,4378,4377,1,3439,1,2123,23.92
G17003100755,STCTY-17031 TRACT-    0755     IN CHICAGO IL,5015,5015,0,4034,0,2423,26.54
G17003100756,STCTY-17031 TRACT-    0756     IN CHICAGO IL,1533,1533,0,1290,0,3388,36.77
G17003100757,STCTY-17031 TRACT-    0757     IN CHICAGO IL,748,746,2,623,0,0,31.07
G17003100758,STCTY-17031 TRACT-    0758     IN CHICAGO IL,3225,3225,0,2678,0,2672,30.85
G17003100759,STCTY-17031 TRACT-    0759     IN CHICAGO IL,790,790,0,683,0,0,27.6
G17003100760,STCTY-17031 TRACT-    0760     IN CHICAGO IL,1275,1275,0,1002,0,0,21.34
G17003100761,STCTY-17031 TRACT-    0761     IN CHICAGO IL,2172,2171,1,1713,0,1343,20.29
G17003100762,STCTY-17031 TRACT-    0762     IN CHICAGO IL,2477,2476,1,2040,1,1831,25.12
G17003100763,STCTY-17031 TRACT-    0763     IN CHICAGO IL,239,239,0,219,0,0,0
G17003100764,STCTY-17031 TRACT-    0764     IN CHICAGO IL,863,863,0,711,0,0,21.79
G17003100765,STCTY-17031 TRACT-    0765     IN CHICAGO IL,5461,5460,1,4221,1,2042,23
G17003100766,STCTY-17031 TRACT-    0766     IN CHICAGO IL,234,233,1,187,1,0,0
G17003100767,STCTY-17031 TRACT-    0767     IN CHICAGO IL,2311,2311,0,1872,0,1955,23.79
G17003100768,STCTY-17031 TRACT-    0768     IN CHICAGO IL,4950,4950,0,4067,0,1817,22.22
G17003100769,STCTY-17031 TRACT-    0769     IN CHICAGO IL,3829,3829,0,3187,0,1856,22.21
G17003100770,STCTY-17031 TRACT-    0770     IN CHICAGO IL,5973,5971,2,4568,0,1829,23.26
G17003100771,STCTY-17031 TRACT-    0771     IN CHICAGO IL,6137,6137,0,4441,0,1948,23.38
G17003100772,STCTY-17031 TRACT-    0772     IN CHICAGO IL,665,665,0,440,0,0,21.59
G17003100773,STCTY-17031 TRACT-    0773     IN CHICAGO IL,2709,2708,1,1945,1,1863,28.41
G17003100774,STCTY-17031 TRACT-    0774     IN CHICAGO IL,500,500,0,394,0,0,0
G17003100775,STCTY-17031 TRACT-    0775     IN CHICAGO IL,99,99,0,88,0,0,0
G17003100776,STCTY-17031 TRACT-    0776     IN CHICAGO IL,555,555,0,454,0,0,23.8
G17003100777,STCTY-17031 TRACT-    0777     IN CHICAGO IL,1223,1223,0,837,0,2339,30.4
G17003100778,STCTY-17031 TRACT-    0778     IN CHICAGO IL,396,396,0,277,0,0,0
G17003100779,STCTY-17031 TRACT-    0779     IN CHICAGO IL,1437,1435,2,1076,2,0,26.65
G17003100780,STCTY-17031 TRACT-    0780     IN CHICAGO IL,4880,4878,2,3880,0,1865,24.81
G17003100781,STCTY-17031 TRACT-    0781     IN CHICAGO IL,724,724,0,619,0,0,23.25
G17003100782,STCTY-17031 TRACT-    0782     IN CHICAGO IL,7038,7037,1,5028,1,1271,21.11
G17003100783,STCTY-17031 TRACT-    0783     IN CHICAGO IL,2974,2972,2,1916,0,1926,23.35
G17003100784,STCTY-17031 TRACT-    0784     IN CHICAGO IL,32,32,0,21,0,0,0
G17003100785,STCTY-17031 TRACT-    0785     IN CHICAGO IL,1140,1139,1,768,0,0,17.86
G17003100786,STCTY-17031 TRACT-    0786     IN CHICAGO IL,0,0,0,0,0,0,0
G17003100787,STCTY-17031 TRACT-    0787     IN CHICAGO IL,752,743,9,511,5,0,17.24
G17003100788,STCTY-17031 TRACT-    0788     IN CHICAGO IL,437,437,0,328,0,0,0
G17003100789,STCTY-17031 TRACT-    0789     IN CHICAGO IL,3216,3216,0,2438,0,1940,24.71
G17003100790,STCTY-17031 TRACT-    0790     IN CHICAGO IL,4863,4857,6,3689,0,1750,25.34
G17003100791,STCTY-17031 TRACT-    0791     IN CHICAGO IL,5181,5181,0,3974,0,1837,22.69
G17003100792,STCTY-17031 TRACT-    0792     IN CHICAGO IL,5076,5076,0,3812,0,2077,25.75
G17003100793,STCTY-17031 TRACT-    0793     IN CHICAGO IL,437,437,0,369,0,0,0
G17003100794,STCTY-17031 TRACT-    0794     IN CHICAGO IL,1142,1142,0,1050,0,0,23.53
G17003100795,STCTY-17031 TRACT-    0795     IN CHICAGO IL,310,309,1,276,1,0,0
G17003100796,STCTY-17031 TRACT-    0796     IN CHICAGO IL,550,550,0,431,0,0,0
G17003100797,STCTY-17031 TRACT-    0797     IN CHICAGO IL,4370,4365,5,3610,0,2015,26.04
G17003100798,STCTY-17031 TRACT-    0798     IN CHICAGO IL,2785,2785,0,2420,0,1756,26.79
G17003100799,STCTY-17031 TRACT-    0799     IN CHICAGO IL,5817,5817,0,4406,0,1713,21.3
G17003100800,STCTY-17031 TRACT-    0800     IN CHICAGO IL,2317,2312,5,1850,0,2661,29.92
G17003100801,STCTY-17031 TRACT-    0801     IN CHICAGO IL,2290,2290,0,1913,0,2039,27.45
G17003100802,STCTY-17031 TRACT-    0802     IN CHICAGO IL,924,924,0,711,0,0,30.61
G17003100803,STCTY-17031 TRACT-    0803     IN CHICAGO IL,4365,4365,0,3477,0,2609,32.82
G17003100804,STCTY-17031 TRACT-    0804     IN CHICAGO IL,4491,4491,0,3676,0,2663,32.68
G17003100805,STCTY-17031 TRACT-    0805     IN CHICAGO IL,3719,3659,60,3049,60,2019,31.88
G17003100806,STCTY-17031 TRACT-    0806     IN CHICAGO IL,2292,2292,0,1734,0,2250,26.21
G17003100807,STCTY-17031 TRACT-    0807     IN CHICAGO IL,4635,4635,0,3557,0,2155,27.73
G17003100808,STCTY-17031 TRACT-    0808     IN CHICAGO IL,4472,4471,1,3478,1,2691,28.89
G17003100809,STCTY-17031 TRACT-    0809     IN CHICAGO IL,5100,5100,0,3981,0,2424,28.41
G17003100810,STCTY-17031 TRACT-    0810     IN CHICAGO IL,0,0,0,0,0,0,0
G17003100811,STCTY-17031 TRACT-    0811     IN CHICAGO IL,224,224,0,144,0,0,0
G17003100812,STCTY-17031 TRACT-    0812     IN CHICAGO IL,969,969,0,739,0,3900,0
G17003100813,STCTY-17031 TRACT-    0813     IN CHICAGO IL,1595,1595,0,1204,0,2219,27.73
G17003100814,STCTY-17031 TRACT-    0814     IN CHICAGO IL,467,467,0,349,0,0,0
G17003100815,STCTY-17031 TRACT-    0815     IN CHICAGO IL,169,169,0,147,0,0,0
G17003100816,STCTY-17031 TRACT-    0816     IN CHICAGO IL,960,959,1,703,0,0,28.5
G17003100817,STCTY-17031 TRACT-    0817     IN CHICAGO IL,844,844,0,611,0,3206,34.5
G17003100818,STCTY-17031 TRACT-    0818     IN CHICAGO IL,628,628,0,487,0,0,0
G17003100819,STCTY-17031 TRACT-    0819     IN CHICAGO IL,3336,3336,0,2663,0,4690,40.73
G17003100820,STCTY-17031 TRACT-    0820     IN CHICAGO IL,3884,3882,2,3315,0,5085,44.25
G17003100821,STCTY-17031 TRACT-    0821     IN CHICAGO IL,5366,5366,0,3891,0,4500,34.95
G17003100822,STCTY-17031 TRACT-    0822     IN CHICAGO IL,5251,5249,2,4302,0,5471,45.21
G17003100823,STCTY-17031 TRACT-    0823     IN CHICAGO IL,4916,4916,0,3705,0,3954,34.14
G17003100824,STCTY-17031 TRACT-    0824     IN CHICAGO IL,4313,4310,3,3493,1,5120,43.56
G17003100825,STCTY-17031 TRACT-    0825     IN CHICAGO IL,286,286,0,245,0,0,0
G17003100826,STCTY-17031 TRACT-    0826     IN CHICAGO IL,390,390,0,311,0,0,0
G17003100827,STCTY-17031 TRACT-    0827     IN CHICAGO IL,130,130,0,96,0,0,0
G17003100828,STCTY-17031 TRACT-    0828     IN CHICAGO IL,82,82,0,68,0,0,0
G17003100829,STCTY-17031 TRACT-    0829     IN CHICAGO IL,2264,2264,0,1895,0,3895,35.95
G17003100830,STCTY-17031 TRACT-    0830     IN CHICAGO IL,1152,1152,0,932,0,0,34.23
G17003100831,STCTY-17031 TRACT-    0831     IN CHICAGO IL,700,700,0,578,0,0,0
G17003100832,STCTY-17031 TRACT-    0832     IN CHICAGO IL,927,927,0,790,0,5729,45.06
G17003100833,STCTY-17031 TRACT-    0833     IN CHICAGO IL,51,49,2,46,1,0,0
G17003100834,STCTY-17031 TRACT-    0834     IN CHICAGO IL,762,756,6,656,5,0,30.91
G17003100835,STCTY-17031 TRACT-    0835     IN CHICAGO IL,2955,2955,0,2369,0,4428,38.27
G17003100836,STCTY-17031 TRACT-    0836     IN CHICAGO IL,3597,3596,1,2971,1,5179,38.37
G17003100837,STCTY-17031 TRACT-    0837     IN CHICAGO IL,3105,3102,3,2629,3,4987,42.7
G17003100838,STCTY-17031 TRACT-    0838     IN CHICAGO IL,632,631,1,550,1,5091,0
G17003100839,STCTY-17031 TRACT-    0839     IN CHICAGO IL,4492,4489,3,3788,1,5067,42.31
G17003100840,STCTY-17031 TRACT-    0840     IN CHICAGO IL,4091,4090,1,3562,1,5334,44.72
G17003100841,STCTY-17031 TRACT-    0841     IN CHICAGO IL,6883,6883,0,5807,0,5853,45.69
G17003100842,STCTY-17031 TRACT-    0842     IN CHICAGO IL,7528,7527,1,6353,0,5114,45.33
G17003100843,STCTY-17031 TRACT-    0843     IN CHICAGO IL,6460,6460,0,5486,0,5403,46.37
G17003100844,STCTY-17031 TRACT-    0844     IN CHICAGO IL,222,222,0,192,0,0,0
G17003100845,STCTY-17031 TRACT-    0845     IN CHICAGO IL,2485,2485,0,2046,0,4400,40.54
G17003100846,STCTY-17031 TRACT-    0846     IN CHICAGO IL,11632,11629,3,8903,3,4960,44.7
G17003100847,STCTY-17031 TRACT-    0847     IN CHICAGO IL,5498,5497,1,4368,1,5105,43.58
G17003100848,STCTY-17031 TRACT-    0848     IN CHICAGO IL,1541,1541,0,1345,0,3985,33.67
G17003100849,STCTY-17031 TRACT-    0849     IN CHICAGO IL,247,247,0,217,0,0,0
G17003100850,STCTY-17031 TRACT-    0850     IN CHICAGO IL,2441,2441,0,2014,0,3838,36.7
G17003100851,STCTY-17031 TRACT-    0851     IN CHICAGO IL,4492,4490,2,3634,0,3392,38.48
G17003100852,STCTY-17031 TRACT-    0852     IN CHICAGO IL,2968,2968,0,2391,0,3426,35.57
G17003100853,STCTY-17031 TRACT-    0853     IN CHICAGO IL,2841,2841,0,2308,0,4109,43.05
G17003100854,STCTY-17031 TRACT-    0854     IN CHICAGO IL,3409,3408,1,2710,1,3053,36.26
G17003100855,STCTY-17031 TRACT-    0855     IN CHICAGO IL,3428,3425,3,2695,0,3575,37.28
G17003100856,STCTY-17031 TRACT-    0856     IN CHICAGO IL,3025,3024,1,2717,0,3460,37.42
G17003100857,STCTY-17031 TRACT-    0857     IN CHICAGO IL,3549,3548,1,2888,0,2837,36.24
G17003100858,STCTY-17031 TRACT-    0858     IN CHICAGO IL,3411,3269,142,2634,138,3370,36.41
G17003100859,STCTY-17031 TRACT-    0859     IN CHICAGO IL,2880,2877,3,2343,0,2736,37.58
G17003100860,STCTY-17031 TRACT-    0860     IN CHICAGO IL,3336,3333,3,2732,1,3153,36.7
G17003100861,STCTY-17031 TRACT-    0861     IN CHICAGO IL,3567,1228,2339,993,2339,2215,30.51
G17003100862,STCTY-17031 TRACT-    0862     IN CHICAGO IL,787,787,0,662,0,0,44.65
G17003100863,STCTY-17031 TRACT-    0863     IN CHICAGO IL,923,923,0,738,0,3629,0
G17003100864,STCTY-17031 TRACT-    0864     IN CHICAGO IL,1008,1008,0,836,0,0,41.19
G17003100865,STCTY-17031 TRACT-    0865     IN CHICAGO IL,5042,5042,0,3951,0,3461,34.01
G17003100866,STCTY-17031 TRACT-    0866     IN CHICAGO IL,3817,3813,4,3070,0,4043,40.96
G17003100867,STCTY-17031 TRACT-    0867     IN CHICAGO IL,3473,3471,2,2813,0,3420,36.22
G17003100868,STCTY-17031 TRACT-    0868     IN CHICAGO IL,3596,3592,4,2927,0,3117,35.96
G17003100869,STCTY-17031 TRACT-    0869     IN CHICAGO IL,1800,1800,0,1489,0,3908,38.2
G17003100870,STCTY-17031 TRACT-    0870     IN CHICAGO IL,2590,2590,0,2073,0,3513,35.69
G17003100871,STCTY-17031 TRACT-    0871     IN CHICAGO IL,4345,4343,2,3378,2,2682,35.99
G17003100872,STCTY-17031 TRACT-    0872     IN CHICAGO IL,5160,3818,1342,2908,1342,1948,30.45
G17003100873,STCTY-17031 TRACT-    0873     IN CHICAGO IL,4698,4691,7,3792,2,2985,38.67
G17003100874,STCTY-17031 TRACT-    0874     IN CHICAGO IL,4743,4688,55,3665,53,2493,32.28
G17003100875,STCTY-17031 TRACT-    0875     IN CHICAGO IL,3385,3385,0,2829,0,2593,35.1
G17003100876,STCTY-17031 TRACT-    0876     IN CHICAGO IL,4142,4134,8,3295,8,2740,33.29
G17003100877,STCTY-17031 TRACT-    0877     IN CHICAGO IL,13036,12635,401,10753,388,2750,29.39
G17003100878,STCTY-17031 TRACT-    0878     IN CHICAGO IL,2050,2043,7,1709,7,2278,28.38
G17003100879,STCTY-17031 TRACT-    0879     IN CHICAGO IL,8376,8368,8,7309,7,3704,39.46
G17003100880,STCTY-17031 TRACT-    0880     IN CHICAGO IL,13861,13834,27,12324,14,3888,33.86
G17003100881,STCTY-17031 TRACT-    0881     IN CHICAGO IL,9007,8837,170,7137,167,2878,38.31
G17003100882,STCTY-17031 TRACT-    0882     IN CHICAGO IL,8561,8556,5,6923,1,3174,40.25
G17003100883,STCTY-17031 TRACT-    0883     IN CHICAGO IL,6055,6047,8,4897,8,3475,35.3
G17003100884,STCTY-17031 TRACT-    0884     IN CHICAGO IL,5430,5420,10,4652,9,4787,44.26
G17003100885,STCTY-17031 TRACT-    0885     IN CHICAGO IL,6646,6644,2,5680,2,4324,43.55
G17003100886,STCTY-17031 TRACT-    0886     IN CHICAGO IL,2658,2655,3,2259,3,4012,41.65
G17003100887,STCTY-17031 TRACT-    0887     IN CHICAGO IL,1039,1026,13,878,13,0,41.75
G17003100888,STCTY-17031 TRACT-    0888     IN CHICAGO IL,4194,4194,0,3637,0,5776,48.64
G17003100889,STCTY-17031 TRACT-    0889     IN CHICAGO IL,7860,7854,6,6152,0,4048,44.26
G17003100890,STCTY-17031 TRACT-    0890     IN CHICAGO IL,4691,4689,2,3840,2,3433,36.07
G17003100891,STCTY-17031 TRACT-    0891     IN CHICAGO IL,449,439,10,382,10,0,0
G17003100892,STCTY-17031 TRACT-    0892     IN CHICAGO IL,3670,3668,2,3075,2,6092,48.23
G17003100893,STCTY-17031 TRACT-    0893     IN CHICAGO IL,6203,6193,10,4750,1,4812,44.23
G17003100894,STCTY-17031 TRACT-    0894     IN CHICAGO IL,3986,3983,3,3145,1,3241,35.91
G17003100895,STCTY-17031 TRACT-    0895     IN CHICAGO IL,1775,1653,122,1459,122,3380,30.1
G17003100896,STCTY-17031 TRACT-    0896     IN CHICAGO IL,120,65,55,59,55,0,0
G17003100897,STCTY-17031 TRACT-    0897     IN CHICAGO IL,681,659,22,556,22,0,26.08
G17003100898,STCTY-17031 TRACT-    0898     IN CHICAGO IL,4919,4894,25,4297,25,3724,39.86
G17003100899,STCTY-17031 TRACT-    0899     IN CHICAGO IL,8037,8025,12,7004,8,4735,41.93
G17003100900,STCTY-17031 TRACT-    0900     IN CHICAGO IL,4626,4616,10,3989,10,4677,42.72
G17003100901,STCTY-17031 TRACT-    0901     IN CHICAGO IL,10,10,0,8,0,0,0
G17003100902,STCTY-17031 TRACT-    0902     IN CHICAGO IL,721,721,0,627,0,0,0
G17003100903,STCTY-17031 TRACT-    0903     IN CHICAGO IL,6124,6123,1,5275,1,5688,47.42
G17003100904,STCTY-17031 TRACT-    0904     IN CHICAGO IL,5283,5283,0,4568,0,6056,50.66
G17003100905,STCTY-17031 TRACT-    0905     IN CHICAGO IL,5421,5419,2,4836,2,6930,51.13
G17003100906,STCTY-17031 TRACT-    0906     IN CHICAGO IL,2555,2554,1,2195,0,6443,47.27
G17003100907,STCTY-17031 TRACT-    0907     IN CHICAGO IL,1976,1976,0,1690,0,5966,44.84
G17003100908,STCTY-17031 TRACT-    0908     IN CHICAGO IL,2433,2430,3,2130,0,4610,41.51
G17003100909,STCTY-17031 TRACT-    0909     IN CHICAGO IL,2431,2430,1,2022,1,3345,34.85
G17003100910,STCTY-17031 TRACT-    0910     IN CHICAGO IL,2022,2022,0,1734,0,4795,38.67
G17003100911,STCTY-17031 TRACT-    0911     IN CHICAGO IL,2951,2945,6,2567,1,5857,48.39
G17003100912,STCTY-17031 TRACT-    0912     IN CHICAGO IL,21128,21126,2,18097,2,5791,48.41
G17003100913,STCTY-17031 TRACT-    0913     IN CHICAGO IL,3600,3600,0,3117,0,6688,48.27
G17003100914,STCTY-17031 TRACT-    0914     IN CHICAGO IL,1369,1363,6,1133,6,5704,44.57
G17003100915,STCTY-17031 TRACT-    0915     IN CHICAGO IL,2749,2720,29,2494,28,13051,77.13
G17003100916,STCTY-17031 TRACT-    0916     IN CHICAGO IL,3261,3253,8,3034,8,11525,81.93
G17003100917,STCTY-17031 TRACT-    0917     IN CHICAGO IL,4438,4416,22,4042,21,7891,56.28
G17003100918,STCTY-17031 TRACT-    0918     IN CHICAGO IL,1581,1578,3,1481,3,14167,0
G17003100919,STCTY-17031 TRACT-    0919     IN CHICAGO IL,3179,3173,6,2918,6,7509,56.49
G17003100920,STCTY-17031 TRACT-    0920     IN CHICAGO IL,19,19,0,15,0,0,0
G17003100921,STCTY-17031 TRACT-    0921     IN CHICAGO IL,683,682,1,608,1,8387,0
G17003100922,STCTY-17031 TRACT-    0922     IN CHICAGO IL,1170,1170,0,1037,0,6130,0
G17003100923,STCTY-17031 TRACT-    0923     IN CHICAGO IL,6281,6232,49,5384,49,5284,43.87
G17003100924,STCTY-17031 TRACT-    0924     IN CHICAGO IL,2476,2476,0,2134,0,4807,37.39
G17003100925,STCTY-17031 TRACT-    0925     IN CHICAGO IL,260,260,0,207,0,0,0
G17003100926,STCTY-17031 TRACT-    0926     IN CHICAGO IL,7274,7274,0,6515,0,6691,59.31
G17003100927,STCTY-17031 TRACT-    0927     IN CHICAGO IL,1909,1907,2,1630,0,4747,40.4
G17003100928,STCTY-17031 TRACT-    0928     IN CHICAGO IL,1610,1610,0,1372,0,2958,32.59
G17003100929,STCTY-17031 TRACT-    0929     IN CHICAGO IL,2780,2779,1,2236,0,3528,31.31
G17003100930,STCTY-17031 TRACT-    0930     IN CHICAGO IL,618,618,0,536,0,0,0
G17003100931,STCTY-17031 TRACT-    0931     IN CHICAGO IL,529,528,1,447,1,0,0
G17003100932,STCTY-17031 TRACT-    0932     IN CHICAGO IL,3371,3307,64,3028,60,8228,64.4
G17003100933,STCTY-17031 TRACT-    0933     IN CHICAGO IL,5806,4638,1168,4188,1165,6014,48.46
G17003100934,STCTY-17031 TRACT-    0934     IN CHICAGO IL,2459,207,2252,176,2252,3325,32.2
G17003100935,STCTY-17031 TRACT-    0935     IN CHICAGO IL,2862,153,2709,117,2707,3681,28.38
G1701190MC0001,STCTY-17119 TRACT- MC 0001     IN ST.LOUIS MO-IL ADJ AREA,8333,8332,1,7890,1,3735,28.13
G1701190MC0002,STCTY-17119 TRACT- MC 0002     IN ST.LOUIS MO-IL ADJ AREA,5260,5260,0,4642,0,1696,14.46
G1701190MC0003,STCTY-17119 TRACT- MC 0003     IN ST.LOUIS MO-IL ADJ AREA,2833,2830,3,2662,2,4067,24.22
G1701190MC0004,STCTY-17119 TRACT- MC 0004     IN ST.LOUIS MO-IL ADJ AREA,3930,3930,0,3521,0,2356,19.94
G1701190MC0005,STCTY-17119 TRACT- MC 0005     IN ST.LOUIS MO-IL ADJ AREA,2618,2617,1,2220,0,1730,17.72
G1701190MC0006,STCTY-17119 TRACT- MC 0006     IN ST.LOUIS MO-IL ADJ AREA,7782,6793,989,5611,989,2097,16.28
G1701190MC0007,STCTY-17119 TRACT- MC 0007     IN ST.LOUIS MO-IL ADJ AREA,5454,3574,1880,3469,1880,685,14.06
G1701190MC0008,STCTY-17119 TRACT- MC 0008     IN ST.LOUIS MO-IL ADJ AREA,2701,2701,0,2622,0,3035,22.36
G1701630SCC0001,STCTY-17163 TRACT-SCC 0001     IN ST.LOUIS MO-IL ADJ AREA,2158,7,2151,7,2151,502,13.59
G1701630SCC0002,STCTY-17163 TRACT-SCC 0002     IN ST.LOUIS MO-IL ADJ AREA,1047,572,475,517,464,0,12
G1701630SCC0003,STCTY-17163 TRACT-SCC 0003     IN ST.LOUIS MO-IL ADJ AREA,12285,10342,1943,9053,1935,2252,18.49
G1701630SCC0004,STCTY-17163 TRACT-SCC 0004     IN ST.LOUIS MO-IL ADJ AREA,5428,5417,11,5080,1,3344,28.91
G1701630SCC0005,STCTY-17163 TRACT-SCC 0005     IN ST.LOUIS MO-IL ADJ AREA,3634,3631,3,3411,3,4913,38.84
G1701630SCC0006,STCTY-17163 TRACT-SCC 0006     IN ST.LOUIS MO-IL ADJ AREA,5887,5885,2,5678,2,3693,31.55
G1701630SCC0007,STCTY-17163 TRACT-SCC 0007     IN ST.LOUIS MO-IL ADJ AREA,1604,1523,81,1474,81,0,18.32
G1701630SCC0008,STCTY-17163 TRACT-SCC 0008     IN ST.LOUIS MO-IL ADJ AREA,3326,3040,286,2938,286,1774,16.46
G1701630SCC0009,STCTY-17163 TRACT-SCC 0009     IN ST.LOUIS MO-IL ADJ AREA,12564,8554,4010,8160,4009,2529,19.96
G1701630SCC0010,STCTY-17163 TRACT-SCC 0010     IN ST.LOUIS MO-IL ADJ AREA,9730,1449,8281,1388,8281,831,15.54
G1701630SCC0011,STCTY-17163 TRACT-SCC 0011     IN ST.LOUIS MO-IL ADJ AREA,4629,2899,1730,2638,1730,2336,17.21
G1701630SCC0012,STCTY-17163 TRACT-SCC 0012     IN ST.LOUIS MO-IL ADJ AREA,9265,9261,4,8887,4,3619,30.99
G1701630SCC0013,STCTY-17163 TRACT-SCC 0013     IN ST.LOUIS MO-IL ADJ AREA,4321,4320,1,4196,1,3453,30.65
G1701630SCC0014,STCTY-17163 TRACT-SCC 0014     IN ST.LOUIS MO-IL ADJ AREA,1889,1888,1,1808,1,2910,25.38
G1701630SCC0015,STCTY-17163 TRACT-SCC 0015     IN ST.LOUIS MO-IL ADJ AREA,2162,2143,19,2066,19,5397,41.47
G1701630SCC0016,STCTY-17163 TRACT-SCC 0016     IN ST.LOUIS MO-IL ADJ AREA,8510,8488,22,8059,22,3021,22.49
G1701630SCC0017,STCTY-17163 TRACT-SCC 0017     IN ST.LOUIS MO-IL ADJ AREA,6789,6719,70,6445,70,2495,19
G1701630SCC0018,STCTY-17163 TRACT-SCC 0018     IN ST.LOUIS MO-IL ADJ AREA,6010,5978,32,5748,32,3380,23.32
G1701630SCC0019,STCTY-17163 TRACT-SCC 0019     IN ST.LOUIS MO-IL ADJ AREA,4934,4923,11,4789,11,3916,23.05
G1701630SCC0020,STCTY-17163 TRACT-SCC 0020     IN ST.LOUIS MO-IL ADJ AREA,244,206,38,202,38,0,0
G1701630SCC0021,STCTY-17163 TRACT-SCC 0021     IN ST.LOUIS MO-IL ADJ AREA,1905,1904,1,1534,1,2039,16.67
G1701630SCC0022,STCTY-17163 TRACT-SCC 0022     IN ST.LOUIS MO-IL ADJ AREA,4523,4520,3,4226,3,2125,19.9
G1701630SCC0023,STCTY-17163 TRACT-SCC 0023     IN ST.LOUIS MO-IL ADJ AREA,359,306,53,301,53,0,0
G18009700001,STCTY-18097 TRACT-    0001     IN INDIANAPOLIS IN,1804,1757,47,1735,47,1779,22.15
G18009700002,STCTY-18097 TRACT-    0002     IN INDIANAPOLIS IN,2734,2724,10,2690,10,2286,25.11
G18009700003,STCTY-18097 TRACT-    0003     IN INDIANAPOLIS IN,1041,976,65,961,65,2400,0
G18009700004,STCTY-18097 TRACT-    0004     IN INDIANAPOLIS IN,3504,3022,482,2960,482,2492,25.26
G18009700005,STCTY-18097 TRACT-    0005     IN INDIANAPOLIS IN,1056,1044,12,1036,12,1755,0
G18009700006,STCTY-18097 TRACT-    0006     IN INDIANAPOLIS IN,4188,4095,93,4012,93,4708,42.18
G18009700007,STCTY-18097 TRACT-    0007     IN INDIANAPOLIS IN,6803,6799,4,6645,4,3651,34.07
G18009700008,STCTY-18097 TRACT-    0008     IN INDIANAPOLIS IN,1911,626,1285,610,1285,1091,16.22
G18009700009,STCTY-18097 TRACT-    0009     IN INDIANAPOLIS IN,1603,771,832,760,832,1484,20.08
G18009700010,STCTY-18097 TRACT-    0010     IN INDIANAPOLIS IN,3577,3446,131,3386,131,2211,23.45
G18009700011,STCTY-18097 TRACT-    0011     IN INDIANAPOLIS IN,4988,4797,191,4647,191,3343,32.8
G18009700012,STCTY-18097 TRACT-    0012     IN INDIANAPOLIS IN,3686,2378,1308,2327,1308,2506,19.24
G18009700013,STCTY-18097 TRACT-    0013     IN INDIANAPOLIS IN,3033,193,2840,186,2839,1450,18.06
G18009700014,STCTY-18097 TRACT-    0014     IN INDIANAPOLIS IN,2899,33,2866,30,2866,1622,19.06
G18009700015,STCTY-18097 TRACT-    0015     IN INDIANAPOLIS IN,1627,1487,140,1460,140,2896,30.15
G18009700016,STCTY-18097 TRACT-    0016     IN INDIANAPOLIS IN,8384,7782,602,7614,601,3926,34.68
G18009700017,STCTY-18097 TRACT-    0017     IN INDIANAPOLIS IN,5372,3447,1925,3370,1924,2467,27.58
G18009700018,STCTY-18097 TRACT-    0018     IN INDIANAPOLIS IN,9176,9036,140,8866,137,3742,34.31
G18009700019,STCTY-18097 TRACT-    0019     IN INDIANAPOLIS IN,9636,9014,622,8772,618,5000,37.36
G18009700020,STCTY-18097 TRACT-    0020     IN INDIANAPOLIS IN,4093,581,3512,573,3512,2441,18.07
G18009700021,STCTY-18097 TRACT-    0021     IN INDIANAPOLIS IN,7985,6301,1684,6093,1684,3694,34.02
G18009700022,STCTY-18097 TRACT-    0022     IN INDIANAPOLIS IN,8577,65,8512,55,8512,1656,18.05
G18009700023,STCTY-18097 TRACT-    0023     IN INDIANAPOLIS IN,911,864,47,829,47,0,25.44
G18009700024,STCTY-18097 TRACT-    0024     IN INDIANAPOLIS IN,3451,3321,130,3263,130,3064,27.19
G18009700025,STCTY-18097 TRACT-    0025     IN INDIANAPOLIS IN,2526,1956,570,1878,570,2900,31.69
G18009700026,STCTY-18097 TRACT-    0026     IN INDIANAPOLIS IN,2256,7,2249,4,2249,1941,18.25
G18009700027,STCTY-18097 TRACT-    0027     IN INDIANAPOLIS IN,6044,3258,2786,3202,2783,2156,24.69
G18009700028,STCTY-18097 TRACT-    0028     IN INDIANAPOLIS IN,4028,4028,0,3969,0,3587,34.69
G18009700029,STCTY-18097 TRACT-    0029     IN INDIANAPOLIS IN,1597,1573,24,1536,18,4136,35.09
G18009700030,STCTY-18097 TRACT-    0030     IN INDIANAPOLIS IN,3811,527,3284,500,3284,3124,29.48
G18009700031,STCTY-18097 TRACT-    0031     IN INDIANAPOLIS IN,3432,3358,74,3189,74,4862,48.32
G18009700032,STCTY-18097 TRACT-    0032     IN INDIANAPOLIS IN,3504,3474,30,3193,28,5132,49.3
G18009700033,STCTY-18097 TRACT-    0033     IN INDIANAPOLIS IN,5962,5919,43,5707,43,4705,46.17
G18009700034,STCTY-18097 TRACT-    0034     IN INDIANAPOLIS IN,4240,4207,33,4047,33,7614,56.07
G18009700035,STCTY-18097 TRACT-    0035     IN INDIANAPOLIS IN,4349,4282,67,4148,67,4264,51.5
G18009700036,STCTY-18097 TRACT-    0036     IN INDIANAPOLIS IN,4272,4254,18,4072,17,6923,63.11
G18009700037,STCTY-18097 TRACT-    0037     IN INDIANAPOLIS IN,4273,3907,366,3802,366,4788,44.11
G18009700038,STCTY-18097 TRACT-    0038     IN INDIANAPOLIS IN,2280,2217,63,2178,58,1811,44.34
G18009700039,STCTY-18097 TRACT-    0039     IN INDIANAPOLIS IN,3059,3042,17,2943,17,7131,55.15
G18009700040,STCTY-18097 TRACT-    0040     IN INDIANAPOLIS IN,1902,1902,0,1874,0,3496,34.6
G18009700041,STCTY-18097 TRACT-    0041     IN INDIANAPOLIS IN,3674,3663,11,3540,9,5918,57.09
G18009700042,STCTY-18097 TRACT-    0042     IN INDIANAPOLIS IN,3569,3521,48,3418,44,9261,71.5
G18009700043,STCTY-18097 TRACT-    0043     IN INDIANAPOLIS IN,4402,4364,38,4241,38,8254,57.96
G18009700044,STCTY-18097 TRACT-    0044     IN INDIANAPOLIS IN,5432,5408,24,5281,24,8459,55.74
G18009700045,STCTY-18097 TRACT-    0045     IN INDIANAPOLIS IN,2714,2707,7,2632,7,5665,37.36
G18009700046,STCTY-18097 TRACT-    0046     IN INDIANAPOLIS IN,2792,2785,7,2733,7,6966,51.06
G18009700047,STCTY-18097 TRACT-    0047     IN INDIANAPOLIS IN,3889,3884,5,3816,5,4512,42.3
G18009700048,STCTY-18097 TRACT-    0048     IN INDIANAPOLIS IN,2394,2391,3,2347,3,3974,36.99
G18009700049,STCTY-18097 TRACT-    0049     IN INDIANAPOLIS IN,2529,2529,0,2459,0,3672,35.34
G18009700050,STCTY-18097 TRACT-    0050     IN INDIANAPOLIS IN,3874,3872,2,3682,2,3451,36.08
G18009700051,STCTY-18097 TRACT-    0051     IN INDIANAPOLIS IN,3897,3895,2,3779,2,3101,32.37
G18009700052,STCTY-18097 TRACT-    0052     IN INDIANAPOLIS IN,3909,3863,46,3737,46,3491,34.43
G18009700053,STCTY-18097 TRACT-    0053     IN INDIANAPOLIS IN,5225,5160,65,4975,65,2836,24.48
G18009700054,STCTY-18097 TRACT-    0054     IN INDIANAPOLIS IN,5055,4891,164,4736,164,2798,19.7
G18009700055,STCTY-18097 TRACT-    0055     IN INDIANAPOLIS IN,8373,7955,418,7739,402,0,21.97
G18009700056,STCTY-18097 TRACT-    0056     IN INDIANAPOLIS IN,7247,5604,1643,5412,1637,0,25.8
G18009700057,STCTY-18097 TRACT-    0057     IN INDIANAPOLIS IN,5001,974,4027,831,4026,1956,20.08
G18009700058,STCTY-18097 TRACT-    0058     IN INDIANAPOLIS IN,3867,2218,1649,2154,1649,1731,17.71
G18009700059,STCTY-18097 TRACT-    0059     IN INDIANAPOLIS IN,5056,4142,914,3918,913,2677,27.03
G18009700060,STCTY-18097 TRACT-    0060     IN INDIANAPOLIS IN,1252,1252,0,1203,0,2831,25.48
G18009700061,STCTY-18097 TRACT-    0061     IN INDIANAPOLIS IN,2188,2188,0,2135,0,2439,30.66
G18009700062,STCTY-18097 TRACT-    0062     IN INDIANAPOLIS IN,2480,2480,0,2065,0,2616,18.62
G18009700063,STCTY-18097 TRACT-    0063     IN INDIANAPOLIS IN,3932,3253,679,3131,679,2147,18.98
G18009700064,STCTY-18097 TRACT-    0064     IN INDIANAPOLIS IN,3761,3526,235,3393,234,2000,24.81
G18009700065,STCTY-18097 TRACT-    0065     IN INDIANAPOLIS IN,3198,3196,2,3105,2,3696,28.68
G18009700066,STCTY-18097 TRACT-    0066     IN INDIANAPOLIS IN,3038,3033,5,2985,5,1531,20.79
G18009700067,STCTY-18097 TRACT-    0067     IN INDIANAPOLIS IN,2944,2942,2,2889,2,6172,45.86
G18009700068,STCTY-18097 TRACT-    0068     IN INDIANAPOLIS IN,3203,3200,3,3125,3,4419,41.29
G18009700069,STCTY-18097 TRACT-    0069     IN INDIANAPOLIS IN,3116,3116,0,3048,0,3651,36.03
G18009700070,STCTY-18097 TRACT-    0070     IN INDIANAPOLIS IN,5054,5052,2,4857,2,3055,32.37
G18009700071,STCTY-18097 TRACT-    0071     IN INDIANAPOLIS IN,5654,5577,77,5459,77,4367,40.08
G18009700072,STCTY-18097 TRACT-    0072     IN INDIANAPOLIS IN,3486,3477,9,3414,9,3838,40.64
G18009700073,STCTY-18097 TRACT-    0073     IN INDIANAPOLIS IN,2779,2772,7,2721,7,2938,29.22
G18009700074,STCTY-18097 TRACT-    0074     IN INDIANAPOLIS IN,1173,565,608,555,608,1359,13.85
G18009700075,STCTY-18097 TRACT-    0075     IN INDIANAPOLIS IN,3770,3770,0,3709,0,2427,23.89
G18009700076,STCTY-18097 TRACT-    0076     IN INDIANAPOLIS IN,3103,3047,56,2976,56,1409,19.05
G18009700077,STCTY-18097 TRACT-    0077     IN INDIANAPOLIS IN,2486,2386,100,2290,100,0,16.34
G18009700078,STCTY-18097 TRACT-    0078     IN INDIANAPOLIS IN,3230,3083,147,2827,142,0,16.25
G18009700079,STCTY-18097 TRACT-    0079     IN INDIANAPOLIS IN,3225,3133,92,3100,92,1447,18.23
G18009700080,STCTY-18097 TRACT-    0080     IN INDIANAPOLIS IN,3552,3552,0,3465,0,2255,23.08
G18009700081,STCTY-18097 TRACT-    0081     IN INDIANAPOLIS IN,3208,3170,38,3143,38,2000,21.12
G18009700082,STCTY-18097 TRACT-    0082     IN INDIANAPOLIS IN,6048,5549,499,5421,499,2683,25.18
G18009700083,STCTY-18097 TRACT-    0083     IN INDIANAPOLIS IN,4494,4494,0,4394,0,2433,26.12
G18009700084,STCTY-18097 TRACT-    0084     IN INDIANAPOLIS IN,3359,3202,157,3121,151,1809,22
G18009700085,STCTY-18097 TRACT-    0085     IN INDIANAPOLIS IN,3235,3182,53,3079,53,2131,24.26
G18009700086,STCTY-18097 TRACT-    0086     IN INDIANAPOLIS IN,2419,2411,8,2268,7,2500,20.35
G18009700087,STCTY-18097 TRACT-    0087     IN INDIANAPOLIS IN,2348,1808,540,1430,537,4140,21.98
G18009700088,STCTY-18097 TRACT-    0088     IN INDIANAPOLIS IN,2433,2194,239,2078,239,1486,18.54
G18009700089,STCTY-18097 TRACT-    0089     IN INDIANAPOLIS IN,4152,4151,1,4076,1,1767,21.44
G18009700090,STCTY-18097 TRACT-    0090     IN INDIANAPOLIS IN,4610,4488,122,4366,121,2766,23.73
G18009700091,STCTY-18097 TRACT-    0091     IN INDIANAPOLIS IN,4829,4829,0,4583,0,2993,29.75
G18009700092,STCTY-18097 TRACT-    0092     IN INDIANAPOLIS IN,3983,3981,2,3787,2,2852,25.17
G18009700093,STCTY-18097 TRACT-    0093     IN INDIANAPOLIS IN,2978,2978,0,2744,0,2346,26.16
G18009700094,STCTY-18097 TRACT-    0094     IN INDIANAPOLIS IN,3698,3666,32,3544,32,2444,21.54
G18009700095,STCTY-18097 TRACT-    0095     IN INDIANAPOLIS IN,4263,3995,268,3945,268,2113,21.67
G18009700096,STCTY-18097 TRACT-    0096     IN INDIANAPOLIS IN,1947,1762,185,1749,185,1320,17.34
G18009700097,STCTY-18097 TRACT-    0097     IN INDIANAPOLIS IN,815,415,400,404,400,0,16.77
G18009700098,STCTY-18097 TRACT-    0098     IN INDIANAPOLIS IN,824,824,0,814,0,2770,0
G18009700099,STCTY-18097 TRACT-    0099     IN INDIANAPOLIS IN,4620,4489,131,4356,131,2954,26.57
G18009700100,STCTY-18097 TRACT-    0100     IN INDIANAPOLIS IN,3604,3596,8,3454,8,3542,29.47
G18009700101,STCTY-18097 TRACT-    0101     IN INDIANAPOLIS IN,2366,2273,93,2248,93,1860,20.92
G18009700102,STCTY-18097 TRACT-    0102     IN INDIANAPOLIS IN,1993,1993,0,1905,0,4332,36.65
G18009700103,STCTY-18097 TRACT-    0103     IN INDIANAPOLIS IN,1170,1168,2,1148,1,3719,30.5
G18009700104,STCTY-18097 TRACT-    0104     IN INDIANAPOLIS IN,1604,1370,234,1329,234,6176,41.44
G18009700105,STCTY-18097 TRACT-    0105     IN INDIANAPOLIS IN,83,82,1,78,1,0,0
G18009700106,STCTY-18097 TRACT-    0106     IN INDIANAPOLIS IN ADJ AREA,1624,1622,2,1590,2,4175,33.41
G18009700107,STCTY-18097 TRACT-    0107     IN INDIANAPOLIS IN,1168,1167,1,1142,1,5318,0
G18009700108,STCTY-18097 TRACT-    0108     IN INDIANAPOLIS IN,1434,1426,8,1381,8,6225,42.53
G18009700109,STCTY-18097 TRACT-    0109     IN INDIANAPOLIS IN ADJ AREA,46,46,0,46,0,0,0
G18009700110,STCTY-18097 TRACT-    0110     IN INDIANAPOLIS IN ADJ AREA,1686,1647,39,1611,39,2263,20.45
G18009700111,STCTY-18097 TRACT-    0111     IN INDIANAPOLIS IN ADJ AREA,1060,1060,0,1004,0,2940,0
G18009700112,STCTY-18097 TRACT-    0112     IN INDIANAPOLIS IN ADJ AREA,980,946,34,932,34,1844,0
G18009700113,STCTY-18097 TRACT-    0113     IN INDIANAPOLIS IN ADJ AREA,704,704,0,697,0,2440,0
G18009700114,STCTY-18097 TRACT-    0114     IN INDIANAPOLIS IN ADJ AREA,662,662,0,642,0,0,0
G18009700115,STCTY-18097 TRACT-    0115     IN INDIANAPOLIS IN ADJ AREA,727,727,0,720,0,2932,0
G18009700116,STCTY-18097 TRACT-    0116     IN INDIANAPOLIS IN ADJ AREA,2463,2457,6,2418,6,3466,22.16
G18009700117,STCTY-18097 TRACT-    0117     IN INDIANAPOLIS IN ADJ AREA,746,746,0,723,0,2375,0
G18009700118,STCTY-18097 TRACT-    0118     IN INDIANAPOLIS IN ADJ AREA,1234,1233,1,1204,1,3700,0
G18009700119,STCTY-18097 TRACT-    0119     IN INDIANAPOLIS IN ADJ AREA,1388,1352,36,1338,36,2929,0
G18009700120,STCTY-18097 TRACT-    0120     IN INDIANAPOLIS IN ADJ AREA,1614,1575,39,1541,39,1992,0
G18009700121,STCTY-18097 TRACT-    0121     IN INDIANAPOLIS IN ADJ AREA,4099,4094,5,4003,5,3414,27.71
G18009700122,STCTY-18097 TRACT-    0122     IN INDIANAPOLIS IN ADJ AREA,3907,3904,3,3733,1,3354,26.69
G18009700123,STCTY-18097 TRACT-    0123     IN INDIANAPOLIS IN ADJ AREA,3183,3181,2,3042,2,3668,27.66
G18009700124,STCTY-18097 TRACT-    0124     IN INDIANAPOLIS IN ADJ AREA,2054,2054,0,2034,0,1050,20.23
G18009700125,STCTY-18097 TRACT-    0125     IN INDIANAPOLIS IN ADJ AREA,3953,3942,11,3852,11,1779,19.4
G18009700126,STCTY-18097 TRACT-    0126     IN INDIANAPOLIS IN ADJ AREA,6207,6182,25,6074,25,2631,22.86
G18009700127,STCTY-18097 TRACT-    0127     IN INDIANAPOLIS IN ADJ AREA,4749,4681,68,4627,68,2377,22.82
G18009700128,STCTY-18097 TRACT-    0128     IN INDIANAPOLIS IN ADJ AREA,2672,2656,16,2600,16,4932,41.72
G18009700129,STCTY-18097 TRACT-    0129     IN INDIANAPOLIS IN ADJ AREA,1850,1844,6,1806,6,2551,29.67
G18009700130,STCTY-18097 TRACT-    0130     IN INDIANAPOLIS IN ADJ AREA,421,388,33,383,33,0,0
G18009700131,STCTY-18097 TRACT-    0131     IN INDIANAPOLIS IN ADJ AREA,1338,1299,39,1229,39,5967,0
G18009700132,STCTY-18097 TRACT-    0132     IN INDIANAPOLIS IN ADJ AREA,862,859,3,846,3,2930,0
G18009700133,STCTY-18097 TRACT-    0133     IN INDIANAPOLIS IN ADJ AREA,674,674,0,672,0,0,0
G18009700134,STCTY-18097 TRACT-    0134     IN INDIANAPOLIS IN ADJ AREA,595,573,22,556,17,14643,0
G18009700135,STCTY-18097 TRACT-    0135     IN INDIANAPOLIS IN ADJ AREA,1737,1729,8,1702,8,3440,26.84
G18009700136,STCTY-18097 TRACT-    0136     IN INDIANAPOLIS IN ADJ AREA,390,389,1,385,1,0,0
G18009700137,STCTY-18097 TRACT-    0137     IN INDIANAPOLIS IN ADJ AREA,1255,1231,24,1202,22,6632,0
G18009700138,STCTY-18097 TRACT-    0138     IN INDIANAPOLIS IN ADJ AREA,400,399,1,391,1,0,0
G18009700139,STCTY-18097 TRACT-    0139     IN INDIANAPOLIS IN ADJ AREA,383,374,9,370,9,0,0
G18009700140,STCTY-18097 TRACT-    0140     IN INDIANAPOLIS IN ADJ AREA,2298,2295,3,2274,2,2662,21.32
G18009700141,STCTY-18097 TRACT-    0141     IN INDIANAPOLIS IN ADJ AREA,2536,2526,10,2495,10,0,0
G19015300001,STCTY-19153 TRACT-    0001     IN DES MOINES IA,2910,2908,2,2794,2,1961,20.27
G19015300002,STCTY-19153 TRACT-    0002     IN DES MOINES IA,3416,3403,13,3278,13,1456,23.2
G19015300003,STCTY-19153 TRACT-    0003     IN DES MOINES IA,2226,2185,41,2066,40,2967,34.58
G19015300004,STCTY-19153 TRACT-    0004     IN DES MOINES IA,3222,3220,2,3117,2,2709,31.48
G19015300005,STCTY-19153 TRACT-    0005     IN DES MOINES IA,6145,6040,105,5691,105,2762,33.3
G19015300006,STCTY-19153 TRACT-    0006     IN DES MOINES IA,4006,3996,10,3870,10,2702,35.58
G19015300007,STCTY-19153 TRACT-    0007     IN DES MOINES IA,3771,3761,10,3629,10,3857,35.21
G19015300008,STCTY-19153 TRACT-    0008     IN DES MOINES IA,5048,5047,1,4923,1,4275,36.62
G19015300009,STCTY-19153 TRACT-    0009     IN DES MOINES IA,3765,3764,1,3618,1,4788,53.98
G19015300010,STCTY-19153 TRACT-    0010     IN DES MOINES IA,4671,4668,3,4529,3,4759,47.96
G19015300011,STCTY-19153 TRACT-    0011     IN DES MOINES IA,5542,5542,0,5347,0,2701,35.71
G19015300012,STCTY-19153 TRACT-    0012     IN DES MOINES IA,5216,5179,37,4894,37,2492,34.57
G19015300013,STCTY-19153 TRACT-    0013     IN DES MOINES IA,5777,5776,1,5463,1,2779,31.6
G19015300014,STCTY-19153 TRACT-    0014     IN DES MOINES IA,3621,3535,86,3302,86,2091,28.37
G19015300015,STCTY-19153 TRACT-    0015     IN DES MOINES IA,3562,3504,58,3247,58,3512,39.68
G19015300016,STCTY-19153 TRACT-    0016     IN DES MOINES IA,2476,2475,1,2333,1,2404,30.54
G19015300017,STCTY-19153 TRACT-    0017     IN DES MOINES IA,2345,1516,829,1436,828,1337,21.29
G19015300018,STCTY-19153 TRACT-    0018     IN DES MOINES IA,2666,2632,34,2509,34,1426,21.22
G19015300019,STCTY-19153 TRACT-    0019     IN DES MOINES IA,2719,2719,0,2659,0,1204,16.73
G19015300020,STCTY-19153 TRACT-    0020     IN DES MOINES IA,1414,1414,0,1374,0,958,0
G19015300021,STCTY-19153 TRACT-    0021     IN DES MOINES IA,6183,6162,21,5904,21,2189,28.87
G19015300022,STCTY-19153 TRACT-    0022     IN DES MOINES IA,3389,2760,629,2625,628,1280,25.99
G19015300023,STCTY-19153 TRACT-    0023     IN DES MOINES IA,5363,5301,62,4835,62,1935,24.68
G19015300024,STCTY-19153 TRACT-    0024     IN DES MOINES IA,4025,3735,290,3434,284,1451,21.8
G19015300025,STCTY-19153 TRACT-    0025     IN DES MOINES IA,6304,4731,1573,4526,1567,1495,21.17
G19015300026,STCTY-19153 TRACT-    0026     IN DES MOINES IA,3612,2700,912,2601,912,2176,25.61
G19015300027,STCTY-19153 TRACT-    0027     IN DES MOINES IA,5628,5523,105,5350,105,2854,34.85
G19015300028,STCTY-19153 TRACT-    0028     IN DES MOINES IA,4823,4817,6,4658,6,4443,52.29
G19015300029,STCTY-19153 TRACT-    0029     IN DES MOINES IA,4914,4910,4,4690,4,4374,52.41
G19015300030,STCTY-19153 TRACT-    0030     IN DES MOINES IA,5315,5289,26,5089,25,7369,58.07
G19015300031,STCTY-19153 TRACT-    0031     IN DES MOINES IA,1319,1309,10,1276,10,7413,0
G19015300032,STCTY-19153 TRACT-    0032     IN DES MOINES IA,1974,1948,26,1867,26,8446,58.2
G19015300033,STCTY-19153 TRACT-    0033     IN DES MOINES IA,4652,4317,335,4170,335,2359,30.95
G19015300034,STCTY-19153 TRACT-    0034     IN DES MOINES IA,5032,4962,70,4690,56,0,25.16
G19015300035,STCTY-19153 TRACT-    0035     IN DES MOINES IA,348,338,10,302,9,0,0
G19015300036,STCTY-19153 TRACT-    0036     IN DES MOINES IA,2301,1974,327,1850,326,660,12.99
G19015300037,STCTY-19153 TRACT-    0037     IN DES MOINES IA,3538,3521,17,3333,17,1886,25.06
G19015300038,STCTY-19153 TRACT-    0038     IN DES MOINES IA,2668,2043,625,1995,625,626,13.25
G19015300039,STCTY-19153 TRACT-    0039     IN DES MOINES IA,850,849,1,808,1,1542,0
G19015300040,STCTY-19153 TRACT-    0040     IN DES MOINES IA,1500,1468,32,1386,31,1327,17.74
G19015300041,STCTY-19153 TRACT-    0041     IN DES MOINES IA,2778,2772,6,2642,6,3190,36.43
G19015300042,STCTY-19153 TRACT-    0042     IN DES MOINES IA,2917,2856,61,2326,61,1172,21.43
G19015300043,STCTY-19153 TRACT-    0043     IN DES MOINES IA,3616,3608,8,3392,8,2223,25.81
G19015300044,STCTY-19153 TRACT-    0044     IN DES MOINES IA,2252,2249,3,2124,3,1348,21.85
G21011100001,STCTY-21111 TRACT-    0001     IN LOUISVILLE KY,2094,2049,45,2034,45,2274,22.25
G21011100002,STCTY-21111 TRACT-    0002     IN LOUISVILLE KY,4191,4050,141,4018,141,1818,19.24
G21011100003,STCTY-21111 TRACT-    0003     IN LOUISVILLE KY,2103,2103,0,2059,0,3382,33.1
G21011100004,STCTY-21111 TRACT-    0004     IN LOUISVILLE KY,3746,3746,0,3695,0,3813,37.51
G21011100005,STCTY-21111 TRACT-    0005     IN LOUISVILLE KY,2719,2719,0,2681,0,2143,20.17
G21011100006,STCTY-21111 TRACT-    0006     IN LOUISVILLE KY,4523,3960,563,3883,563,3115,25.4
G21011100007,STCTY-21111 TRACT-    0007     IN LOUISVILLE KY,4331,4326,5,4247,4,3573,35.56
G21011100008,STCTY-21111 TRACT-    0008     IN LOUISVILLE KY,3018,3016,2,2940,2,4469,41.33
G21011100009,STCTY-21111 TRACT-    0009     IN LOUISVILLE KY,2749,2747,2,2685,2,4427,42.18
G21011100010,STCTY-21111 TRACT-    0010     IN LOUISVILLE KY,6355,5321,1034,5237,1034,3100,29.63
G21011100011,STCTY-21111 TRACT-    0011     IN LOUISVILLE KY,4238,4213,25,4099,25,4553,41.5
G21011100012,STCTY-21111 TRACT-    0012     IN LOUISVILLE KY,1284,1284,0,1270,0,3130,35.11
G21011100013,STCTY-21111 TRACT-    0013     IN LOUISVILLE KY,2049,407,1642,403,1642,1065,15.33
G21011100014,STCTY-21111 TRACT-    0014     IN LOUISVILLE KY,882,244,638,241,638,694,12.99
G21011100015,STCTY-21111 TRACT-    0015     IN LOUISVILLE KY,3991,3991,0,3955,0,2921,26.59
G21011100016,STCTY-21111 TRACT-    0016     IN LOUISVILLE KY,5473,5429,44,5341,44,2946,26.39
G21011100017,STCTY-21111 TRACT-    0017     IN LOUISVILLE KY,4375,4374,1,4264,1,3425,31.96
G21011100018,STCTY-21111 TRACT-    0018     IN LOUISVILLE KY,4229,4184,45,4101,45,2627,25.93
G21011100019,STCTY-21111 TRACT-    0019     IN LOUISVILLE KY,4305,1491,2814,1452,2814,2428,20.75
G21011100020,STCTY-21111 TRACT-    0020     IN LOUISVILLE KY,4777,3043,1734,3005,1734,2365,22.24
G21011100021,STCTY-21111 TRACT-    0021     IN LOUISVILLE KY,5884,5799,85,5731,85,2018,20.16
G21011100022,STCTY-21111 TRACT-    0022     IN LOUISVILLE KY,5192,5179,13,5134,13,1515,16.35
G21011100023,STCTY-21111 TRACT-    0023     IN LOUISVILLE KY,7933,7848,85,7740,85,1920,18.19
G21011100024,STCTY-21111 TRACT-    0024     IN LOUISVILLE KY,4250,1207,3043,1171,3043,1922,16.83
G21011100025,STCTY-21111 TRACT-    0025     IN LOUISVILLE KY,4768,1050,3718,1011,3718,2204,14.18
G21011100026,STCTY-21111 TRACT-    0026     IN LOUISVILLE KY,4631,3858,773,3803,773,1996,20.05
G21011100027,STCTY-21111 TRACT-    0027     IN LOUISVILLE KY,6596,3891,2705,3809,2705,2235,18.98
G21011100028,STCTY-21111 TRACT-    0028     IN LOUISVILLE KY,2830,2825,5,2780,5,2443,23.33
G21011100029,STCTY-21111 TRACT-    0029     IN LOUISVILLE KY,1654,1181,473,1139,473,0,12.82
G21011100030,STCTY-21111 TRACT-    0030     IN LOUISVILLE KY,4470,477,3993,414,3993,0,12.98
G21011100031,STCTY-21111 TRACT-    0031     IN LOUISVILLE KY,2614,506,2108,484,2108,0,15.64
G21011100032,STCTY-21111 TRACT-    0032     IN LOUISVILLE KY,2488,537,1951,519,1951,0,16.54
G21011100033,STCTY-21111 TRACT-    0033     IN LOUISVILLE KY,3454,1464,1990,1450,1990,1302,12.61
G21011100034,STCTY-21111 TRACT-    0034     IN LOUISVILLE KY,2920,1963,957,1921,957,1708,16.71
G21011100035,STCTY-21111 TRACT-    0035     IN LOUISVILLE KY,2295,1794,501,1747,501,1625,17.67
G21011100036,STCTY-21111 TRACT-    0036     IN LOUISVILLE KY,4370,4189,181,4154,179,2635,23.2
G21011100037,STCTY-21111 TRACT-    0037     IN LOUISVILLE KY,4014,3436,578,3406,578,2434,24.86
G21011100038,STCTY-21111 TRACT-    0038     IN LOUISVILLE KY,3145,3118,27,3089,27,2426,23.87
G21011100039,STCTY-21111 TRACT-    0039     IN LOUISVILLE KY,3219,3219,0,3182,0,2613,25.24
G21011100040,STCTY-21111 TRACT-    0040     IN LOUISVILLE KY,2443,2440,3,2393,3,3153,30.71
G21011100041,STCTY-21111 TRACT-    0041     IN LOUISVILLE KY,3631,3631,0,3596,0,3370,28.59
G21011100042,STCTY-21111 TRACT-    0042     IN LOUISVILLE KY,821,821,0,820,0,2063,0
G21011100043,STCTY-21111 TRACT-    0043     IN LOUISVILLE KY,1704,1704,0,1683,0,2046,21.84
G21011100044,STCTY-21111 TRACT-    0044     IN LOUISVILLE KY,2974,2966,8,2924,8,4784,38.26
G21011100045,STCTY-21111 TRACT-    0045     IN LOUISVILLE KY,1592,1531,61,1518,61,2333,21.56
G21011100046,STCTY-21111 TRACT-    0046     IN LOUISVILLE KY,2076,2070,6,2022,6,3830,34.12
G21011100047,STCTY-21111 TRACT-    0047     IN LOUISVILLE KY,1038,985,53,913,35,0,17.66
G21011100048,STCTY-21111 TRACT-    0048     IN LOUISVILLE KY,1434,1144,290,1069,289,0,13.81
G21011100049,STCTY-21111 TRACT-    0049     IN LOUISVILLE KY,4486,3118,1368,2984,1356,0,15.3
G21011100050,STCTY-21111 TRACT-    0050     IN LOUISVILLE KY,6746,5742,1004,5627,1001,0,18.29
G21011100051,STCTY-21111 TRACT-    0051     IN LOUISVILLE KY,6366,6107,259,5935,258,3578,27.6
G21011100052,STCTY-21111 TRACT-    0052     IN LOUISVILLE KY,5226,5101,125,4902,124,4792,34.73
G21011100053,STCTY-21111 TRACT-    0053     IN LOUISVILLE KY,3445,3365,80,3207,80,4500,31.37
G21011100054,STCTY-21111 TRACT-    0054     IN LOUISVILLE KY,668,663,5,660,5,0,12.54
G21011100055,STCTY-21111 TRACT-    0055     IN LOUISVILLE KY,5366,4945,421,4925,421,1713,16.87
G21011100056,STCTY-21111 TRACT-    0056     IN LOUISVILLE KY,2123,2090,33,2076,33,2598,17.82
G21011100057,STCTY-21111 TRACT-    0057     IN LOUISVILLE KY,5830,5509,321,5417,321,1542,12.76
G21011100058,STCTY-21111 TRACT-    0058     IN LOUISVILLE KY,3474,2782,692,2533,692,0,13.68
G21011100059,STCTY-21111 TRACT-    0059     IN LOUISVILLE KY,4672,3320,1352,3125,1352,2110,15.16
G21011100060,STCTY-21111 TRACT-    0060     IN LOUISVILLE KY,4168,3699,469,3631,469,1625,15.17
G21011100061,STCTY-21111 TRACT-    0061     IN LOUISVILLE KY,3547,3080,467,2939,465,2654,17.29
G21011100062,STCTY-21111 TRACT-    0062     IN LOUISVILLE KY,6107,1746,4361,1693,4361,2289,16.35
G21011100063,STCTY-21111 TRACT-    0063     IN LOUISVILLE KY,7050,6944,106,6785,105,2490,21.94
G21011100064,STCTY-21111 TRACT-    0064     IN LOUISVILLE KY,3993,3914,79,3807,79,2934,29.35
G21011100065,STCTY-21111 TRACT-    0065     IN LOUISVILLE KY,3641,3424,217,3345,217,2795,22.16
G21011100066,STCTY-21111 TRACT-    0066     IN LOUISVILLE KY,5855,5519,336,5269,336,298,25.48
G21011100067,STCTY-21111 TRACT-    0067     IN LOUISVILLE KY,2775,1573,1202,1530,1202,1908,19.8
G21011100068,STCTY-21111 TRACT-    0068     IN LOUISVILLE KY,4347,4272,75,4179,75,2767,24.86
G21011100069,STCTY-21111 TRACT-    0069     IN LOUISVILLE KY,3299,3289,10,3205,10,2342,23.59
G21011100070,STCTY-21111 TRACT-    0070     IN LOUISVILLE KY,3176,3174,2,3066,2,4550,35.35
G21011100071,STCTY-21111 TRACT-    0071     IN LOUISVILLE KY,4996,4971,25,4883,24,2824,26.18
G21011100072,STCTY-21111 TRACT-    0072     IN LOUISVILLE KY,2821,1997,824,1894,823,2139,19.8
G21011100073,STCTY-21111 TRACT-    0073     IN LOUISVILLE KY,2109,2073,36,2061,36,1230,16.53
G21011100074,STCTY-21111 TRACT-    0074     IN LOUISVILLE KY,1742,1694,48,1683,48,1295,13.45
G21011100075,STCTY-21111 TRACT-    0075     IN LOUISVILLE KY,3321,3227,94,3170,94,3139,26.44
G21011100076,STCTY-21111 TRACT-    0076     IN LOUISVILLE KY,2511,2394,117,2362,117,5456,42.29
G21011100077,STCTY-21111 TRACT-    0077     IN LOUISVILLE KY,1428,1401,27,1375,26,6201,47.44
G21011100078,STCTY-21111 TRACT-    0078     IN LOUISVILLE KY,1757,1755,2,1711,2,5654,43.09
G21011100079,STCTY-21111 TRACT-    0079     IN LOUISVILLE KY,2664,2655,9,2602,9,4836,37.58
G21011100080,STCTY-21111 TRACT-    0080     IN LOUISVILLE KY,1630,1568,62,1535,62,2669,26.47
G21011100081,STCTY-21111 TRACT-    0081     IN LOUISVILLE KY,5763,5580,183,5471,179,2192,20.71
G21011100082,STCTY-21111 TRACT-    0082     IN LOUISVILLE KY,5372,5237,135,5091,134,6595,48.11
G21011100083,STCTY-21111 TRACT-    0083     IN LOUISVILLE KY,3658,3618,40,3536,40,6481,44.11
G21011100084,STCTY-21111 TRACT-    0084     IN LOUISVILLE KY,4681,4664,17,4512,17,4688,44.77
G21011100085,STCTY-21111 TRACT-    0085     IN LOUISVILLE KY,2705,2670,35,2549,35,6894,55.14
G21011100086,STCTY-21111 TRACT-    0086     IN LOUISVILLE KY,484,450,34,440,34,9097,0
G21011100087,STCTY-21111 TRACT-    0087     IN LOUISVILLE KY,1258,1203,55,1171,55,12750,0
G21011100088,STCTY-21111 TRACT-    0088     IN LOUISVILLE KY,3912,3829,83,3686,83,7951,58.15
G21011100089,STCTY-21111 TRACT-    0089     IN LOUISVILLE KY,4033,3975,58,3862,56,6823,54.95
G2101110J0001,STCTY-21111 TRACT-  J 0001     IN LOUISVILLE KY ADJ AREA,1008,1007,1,991,1,4279,0
G2101110J0002,STCTY-21111 TRACT-  J 0002     IN LOUISVILLE KY ADJ AREA,1751,1750,1,1708,1,3565,22.29
G2101110J0003,STCTY-21111 TRACT-  J 0003     IN LOUISVILLE KY ADJ AREA,1031,1031,0,1014,0,2775,0
G2101110J0004,STCTY-21111 TRACT-  J 0004     IN LOUISVILLE KY ADJ AREA,1471,1469,2,1434,2,3690,25
G2101110J0005,STCTY-21111 TRACT-  J 0005     IN LOUISVILLE KY ADJ AREA,1611,1611,0,1562,0,4074,34
G2101110J0006,STCTY-21111 TRACT-  J 0006     IN LOUISVILLE KY ADJ AREA,1380,1367,13,1350,13,8246,58.96
G2101110J0007,STCTY-21111 TRACT-  J 0007     IN LOUISVILLE KY ADJ AREA,3928,3927,1,3868,1,2763,18.92
G2101110J0008,STCTY-21111 TRACT-  J 0008     IN LOUISVILLE KY ADJ AREA,1549,1524,25,1492,25,8058,0
G2101110J0009,STCTY-21111 TRACT-  J 0009     IN LOUISVILLE KY ADJ AREA,2471,2456,15,2413,15,7391,64
G2101110J0010,STCTY-21111 TRACT-  J 0010     IN LOUISVILLE KY ADJ AREA,3313,3308,5,3256,5,6043,47.56
G2101110J0011,STCTY-21111 TRACT-  J 0011     IN LOUISVILLE KY ADJ AREA,2530,2513,17,2484,17,5425,45.14
G2101110J0012,STCTY-21111 TRACT-  J 0012     IN LOUISVILLE KY ADJ AREA,1178,1073,105,1061,105,3667,0
G22007100001,STCTY-22071 TRACT-    0001     IN NEW ORLEANS LA,5710,5604,106,5503,96,2512,22.96
G22007100002,STCTY-22071 TRACT-    0002     IN NEW ORLEANS LA,3926,2618,1308,2545,1308,1744,15.09
G22007100003,STCTY-22071 TRACT-    0003     IN NEW ORLEANS LA,3505,1355,2150,1314,2150,2030,13.01
G22007100004,STCTY-22071 TRACT-    0004     IN NEW ORLEANS LA,1838,1222,616,1208,616,1027,15.07
G22007100005,STCTY-22071 TRACT-    0005     IN NEW ORLEANS LA,1546,1187,359,1175,359,1717,13.15
G22007100006,STCTY-22071 TRACT-    0006     IN NEW ORLEANS LA,4195,2232,1963,2144,1963,854,9.46
G22007100007,STCTY-22071 TRACT-    0007     IN NEW ORLEANS LA,2597,2200,397,2094,389,2111,16.66
G22007100008,STCTY-22071 TRACT-    0008     IN NEW ORLEANS LA,2908,2383,525,2325,525,1663,18.63
G22007100009,STCTY-22071 TRACT-    0009     IN NEW ORLEANS LA,4379,1702,2677,1625,2672,1030,13.16
G22007100010,STCTY-22071 TRACT-    0010     IN NEW ORLEANS LA,1672,1637,35,1593,31,1900,20.79
G22007100011,STCTY-22071 TRACT-    0011     IN NEW ORLEANS LA,4620,4469,151,4358,142,2135,19.3
G22007100012,STCTY-22071 TRACT-    0012     IN NEW ORLEANS LA,5467,5367,100,5174,83,2061,18.4
G22007100013,STCTY-22071 TRACT-    0013     IN NEW ORLEANS LA,9221,8852,369,8618,361,2266,20.69
G22007100014,STCTY-22071 TRACT-    0014     IN NEW ORLEANS LA,5779,4187,1592,4099,1586,2044,18.95
G22007100015,STCTY-22071 TRACT-    0015     IN NEW ORLEANS LA,3879,3567,312,3508,311,1888,18.63
G22007100016,STCTY-22071 TRACT-    0016     IN NEW ORLEANS LA,948,179,769,169,769,441,12
G22007100017,STCTY-22071 TRACT-    0017     IN NEW ORLEANS LA,5092,3378,1714,3252,1707,1039,11.04
G22007100018,STCTY-22071 TRACT-    0018     IN NEW ORLEANS LA,4886,4724,162,4512,100,2264,17.77
G22007100019,STCTY-22071 TRACT-    0019     IN NEW ORLEANS LA,4535,4292,243,4163,216,2030,20.18
G22007100020,STCTY-22071 TRACT-    0020     IN NEW ORLEANS LA,3622,3427,195,3332,194,2292,21.39
G22007100021,STCTY-22071 TRACT-    0021     IN NEW ORLEANS LA,2693,2284,409,2243,406,1845,19.1
G22007100022,STCTY-22071 TRACT-    0022     IN NEW ORLEANS LA,2910,2855,55,2789,44,2428,23.21
G22007100023,STCTY-22071 TRACT-    0023     IN NEW ORLEANS LA,1486,1039,447,1023,447,1275,17.28
G22007100024,STCTY-22071 TRACT-    0024     IN NEW ORLEANS LA,6912,6907,5,6736,5,3993,30.64
G22007100025,STCTY-22071 TRACT-    0025     IN NEW ORLEANS LA,4967,4569,398,4424,398,4996,29.11
G22007100026,STCTY-22071 TRACT-    0026     IN NEW ORLEANS LA,4598,4020,578,3637,449,2526,16.05
G22007100027,STCTY-22071 TRACT-    0027     IN NEW ORLEANS LA,6042,2826,3216,2675,3181,1878,16.87
G22007100028,STCTY-22071 TRACT-    0028     IN NEW ORLEANS LA,4301,607,3694,583,3690,1651,17.53
G22007100029,STCTY-22071 TRACT-    0029     IN NEW ORLEANS LA,5154,2500,2654,2406,2653,1699,16.9
G22007100030,STCTY-22071 TRACT-    0030     IN NEW ORLEANS LA,4241,1191,3050,1145,3050,1737,17.77
G22007100031,STCTY-22071 TRACT-    0031     IN NEW ORLEANS LA,2554,842,1712,830,1711,1725,17.24
G22007100032,STCTY-22071 TRACT-    0032     IN NEW ORLEANS LA,1024,732,292,699,292,0,18.95
G22007100033,STCTY-22071 TRACT-    0033     IN NEW ORLEANS LA,3465,1886,1579,1781,1579,1439,14.42
G22007100034,STCTY-22071 TRACT-    0034     IN NEW ORLEANS LA,4791,2131,2660,1953,2654,2481,18.82
G22007100035,STCTY-22071 TRACT-    0035     IN NEW ORLEANS LA,3656,1758,1898,1636,1895,2326,21.21
G22007100036,STCTY-22071 TRACT-    0036     IN NEW ORLEANS LA,3830,3190,640,3013,639,2713,24.35
G22007100037,STCTY-22071 TRACT-    0037     IN NEW ORLEANS LA,8055,7872,183,7550,179,3421,26.21
G22007100038,STCTY-22071 TRACT-    0038     IN NEW ORLEANS LA,4747,3824,923,3346,838,2941,12.88
G22007100039,STCTY-22071 TRACT-    0039     IN NEW ORLEANS LA,4993,2876,2117,2685,2117,2779,15.89
G22007100040,STCTY-22071 TRACT-    0040     IN NEW ORLEANS LA,4224,3290,934,3112,922,2750,21.08
G22007100041,STCTY-22071 TRACT-    0041     IN NEW ORLEANS LA,3373,3318,55,3178,50,4921,27.75
G22007100042,STCTY-22071 TRACT-    0042     IN NEW ORLEANS LA,5426,4224,1202,3743,1147,3766,16.61
G22007100043,STCTY-22071 TRACT-    0043     IN NEW ORLEANS LA,6550,1421,5129,1268,5112,0,11.56
G22007100044,STCTY-22071 TRACT-    0044     IN NEW ORLEANS LA,5515,2443,3072,2285,3060,2237,17.78
G22007100045,STCTY-22071 TRACT-    0045     IN NEW ORLEANS LA,5963,5232,731,5031,719,2270,20.2
G22007100046,STCTY-22071 TRACT-    0046     IN NEW ORLEANS LA,5116,5097,19,4896,19,4901,35.83
G22007100047,STCTY-22071 TRACT-    0047     IN NEW ORLEANS LA,880,686,194,611,194,0,12.42
G22007100048,STCTY-22071 TRACT-    0048     IN NEW ORLEANS LA,1903,145,1758,124,1758,0,14.73
G22007100049,STCTY-22071 TRACT-    0049     IN NEW ORLEANS LA,5217,1635,3582,1528,3580,2473,17
G22007100050,STCTY-22071 TRACT-    0050     IN NEW ORLEANS LA,2748,2678,70,2602,69,2615,23.98
G22007100051,STCTY-22071 TRACT-    0051     IN NEW ORLEANS LA,1749,1748,1,1697,0,0,27.9
G22007100052,STCTY-22071 TRACT-    0052     IN NEW ORLEANS LA,940,896,44,881,44,0,24.39
G22007100053,STCTY-22071 TRACT-    0053     IN NEW ORLEANS LA,459,457,2,446,1,0,0
G22007100054,STCTY-22071 TRACT-    0054     IN NEW ORLEANS LA,1847,1837,10,1763,0,3432,30.65
G22007100055,STCTY-22071 TRACT-    0055     IN NEW ORLEANS LA,2835,2831,4,2743,2,4362,36.75
G22007100056,STCTY-22071 TRACT-    0056     IN NEW ORLEANS LA,4670,4651,19,4450,19,5133,34.17
G22007100057,STCTY-22071 TRACT-    0057     IN NEW ORLEANS LA,30,27,3,24,3,0,0
G22007100058,STCTY-22071 TRACT-    0058     IN NEW ORLEANS LA,2539,1689,850,1490,846,0,15.62
G22007100059,STCTY-22071 TRACT-    0059     IN NEW ORLEANS LA,5397,2320,3077,2137,3074,0,8.71
G22007100060,STCTY-22071 TRACT-    0060     IN NEW ORLEANS LA,5986,2384,3602,2290,3594,2479,15.36
G22007100061,STCTY-22071 TRACT-    0061     IN NEW ORLEANS LA,3218,3011,207,2898,203,2683,22.41
G22007100062,STCTY-22071 TRACT-    0062     IN NEW ORLEANS LA,2639,1661,978,1624,978,2190,19.21
G22007100063,STCTY-22071 TRACT-    0063     IN NEW ORLEANS LA,4275,4267,8,4127,7,3257,28.99
G22007100064,STCTY-22071 TRACT-    0064     IN NEW ORLEANS LA,5434,5347,87,5139,63,3169,30.22
G22007100065,STCTY-22071 TRACT-    0065     IN NEW ORLEANS LA,5533,5472,61,5274,61,3406,28.98
G22007100066,STCTY-22071 TRACT-    0066     IN NEW ORLEANS LA,1988,1456,532,1367,532,0,10.9
G22007100067,STCTY-22071 TRACT-    0067     IN NEW ORLEANS LA,5687,4573,1114,4293,1106,0,13.39
G22007100068,STCTY-22071 TRACT-    0068     IN NEW ORLEANS LA,5104,404,4700,360,4700,0,12.55
G22007100069,STCTY-22071 TRACT-    0069     IN NEW ORLEANS LA,2446,270,2176,255,2176,1471,14.67
G22007100070,STCTY-22071 TRACT-    0070     IN NEW ORLEANS LA,1956,430,1526,408,1526,1717,14.2
G22007100071,STCTY-22071 TRACT-    0071     IN NEW ORLEANS LA,5537,3569,1968,3439,1967,2307,18.21
G22007100072,STCTY-22071 TRACT-    0072     IN NEW ORLEANS LA,2389,126,2263,119,2263,0,17.37
G22007100073,STCTY-22071 TRACT-    0073     IN NEW ORLEANS LA,2213,294,1919,274,1919,0,14
G22007100074,STCTY-22071 TRACT-    0074     IN NEW ORLEANS LA,537,536,1,521,1,0,27.71
G22007100075,STCTY-22071 TRACT-    0075     IN NEW ORLEANS LA,5764,4087,1677,3965,1677,2142,19.28
G22007100076,STCTY-22071 TRACT-    0076     IN NEW ORLEANS LA,3247,2279,968,2209,968,4833,19.1
G22007100077,STCTY-22071 TRACT-    0077     IN NEW ORLEANS LA,2536,1820,716,1759,716,0,12.16
G22007100078,STCTY-22071 TRACT-    0078     IN NEW ORLEANS LA,4594,4463,131,4295,118,2769,15.17
G22007100079,STCTY-22071 TRACT-    0079     IN NEW ORLEANS LA,3756,3374,382,3165,377,0,14.55
G22007100080,STCTY-22071 TRACT-    0080     IN NEW ORLEANS LA,4915,662,4253,579,4250,0,13.12
G22007100081,STCTY-22071 TRACT-    0081     IN NEW ORLEANS LA,3417,2340,1077,2291,1075,0,13.18
G22007100082,STCTY-22071 TRACT-    0082     IN NEW ORLEANS LA,4119,4017,102,3826,97,3056,18.86
G22007100083,STCTY-22071 TRACT-    0083     IN NEW ORLEANS LA,3327,3239,88,3136,79,3861,19.45
G22007100084,STCTY-22071 TRACT-    0084     IN NEW ORLEANS LA,3207,2610,597,2406,597,0,17.2
G22007100085,STCTY-22071 TRACT-    0085     IN NEW ORLEANS LA,5689,661,5028,611,5028,0,16.12
G22007100086,STCTY-22071 TRACT-    0086     IN NEW ORLEANS LA,5116,290,4826,267,4825,0,14.62
G22007100087,STCTY-22071 TRACT-    0087     IN NEW ORLEANS LA,1915,1587,328,1564,328,0,16.05
G22007100088,STCTY-22071 TRACT-    0088     IN NEW ORLEANS LA,4395,4137,258,4051,258,2432,18.92
G22007100089,STCTY-22071 TRACT-    0089     IN NEW ORLEANS LA,3337,3012,325,2960,321,2185,17.72
G22007100090,STCTY-22071 TRACT-    0090     IN NEW ORLEANS LA,3630,3501,129,3354,129,4361,29.87
G22007100091,STCTY-22071 TRACT-    0091     IN NEW ORLEANS LA,4767,2111,2656,1955,2654,3542,17.79
G22007100092,STCTY-22071 TRACT-    0092     IN NEW ORLEANS LA,4941,366,4575,321,4574,0,16.03
G22007100093,STCTY-22071 TRACT-    0093     IN NEW ORLEANS LA,5180,587,4593,557,4592,0,16.94
G22007100094,STCTY-22071 TRACT-    0094     IN NEW ORLEANS LA,7025,756,6269,704,6268,1676,16.81
G22007100095,STCTY-22071 TRACT-    0095     IN NEW ORLEANS LA,284,195,89,194,89,0,0
G22007100096,STCTY-22071 TRACT-    0096     IN NEW ORLEANS LA,3728,3127,601,3021,601,2484,18.27
G22007100097,STCTY-22071 TRACT-    0097     IN NEW ORLEANS LA,3899,3020,879,2954,879,2110,16.85
G22007100098,STCTY-22071 TRACT-    0098     IN NEW ORLEANS LA,2804,2788,16,2650,15,3794,32.56
G22007100099,STCTY-22071 TRACT-    0099     IN NEW ORLEANS LA,3930,3575,355,3403,349,3591,27.77
G22007100100,STCTY-22071 TRACT-    0100     IN NEW ORLEANS LA,5198,1470,3728,1371,3728,2930,18.57
G22007100101,STCTY-22071 TRACT-    0101     IN NEW ORLEANS LA,3923,3632,291,3380,290,6220,40.22
G22007100102,STCTY-22071 TRACT-    0102     IN NEW ORLEANS LA,6491,2445,4046,2283,4045,4841,22.63
G22007100103,STCTY-22071 TRACT-    0103     IN NEW ORLEANS LA,4861,4494,367,4228,367,4734,34.09
G22007100104,STCTY-22071 TRACT-    0104     IN NEW ORLEANS LA,563,437,126,436,126,0,13.06
G22007100105,STCTY-22071 TRACT-    0105     IN NEW ORLEANS LA,3042,2675,367,2614,357,2657,19.66
G22007100106,STCTY-22071 TRACT-    0106     IN NEW ORLEANS LA,3189,2786,403,2722,403,2317,21.21
G22007100107,STCTY-22071 TRACT-    0107     IN NEW ORLEANS LA,4505,2722,1783,2596,1783,3617,21.96
G22007100108,STCTY-22071 TRACT-    0108     IN NEW ORLEANS LA,3114,2745,369,2626,366,4672,29.47
G22007100109,STCTY-22071 TRACT-    0109     IN NEW ORLEANS LA,3338,2529,809,2407,809,3932,28.63
G22007100110,STCTY-22071 TRACT-    0110     IN NEW ORLEANS LA,2593,2135,458,2009,458,6491,33.38
G22007100111,STCTY-22071 TRACT-    0111     IN NEW ORLEANS LA,4987,2310,2677,2158,2675,4125,22.47
G22007100112,STCTY-22071 TRACT-    0112     IN NEW ORLEANS LA,2675,2653,22,2531,22,6039,46.75
G22007100113,STCTY-22071 TRACT-    0113     IN NEW ORLEANS LA,508,488,20,469,17,0,0
G22007100114,STCTY-22071 TRACT-    0114     IN NEW ORLEANS LA,4186,4172,14,4083,0,2750,24.59
G22007100115,STCTY-22071 TRACT-    0115     IN NEW ORLEANS LA,3551,3509,42,3384,40,4167,29.59
G22007100116,STCTY-22071 TRACT-    0116     IN NEW ORLEANS LA,2894,2743,151,2637,149,4793,29.01
G22007100117,STCTY-22071 TRACT-    0117     IN NEW ORLEANS LA,2186,2129,57,2033,0,12440,65.15
G22007100118,STCTY-22071 TRACT-    0118     IN NEW ORLEANS LA,2517,2459,58,2330,0,10921,59.36
G22007100119,STCTY-22071 TRACT-    0119     IN NEW ORLEANS LA,3145,3108,37,2965,0,7344,49.03
G22007100120,STCTY-22071 TRACT-    0120     IN NEW ORLEANS LA,2489,2101,388,2017,0,7380,34.8
G22007100121,STCTY-22071 TRACT-    0121     IN NEW ORLEANS LA,4442,4301,141,4123,140,8582,51.13
G22007100122,STCTY-22071 TRACT-    0122     IN NEW ORLEANS LA,2368,2289,79,2212,73,7593,54.21
G22007100123,STCTY-22071 TRACT-    0123     IN NEW ORLEANS LA,2497,2492,5,2369,0,5200,41.98
G22007100124,STCTY-22071 TRACT-    0124     IN NEW ORLEANS LA,2517,1330,1187,1277,0,7325,21.77
G22007100125,STCTY-22071 TRACT-    0125     IN NEW ORLEANS LA,3062,1478,1584,1418,1584,3000,17.92
G22007100126,STCTY-22071 TRACT-    0126     IN NEW ORLEANS LA,3402,2680,722,2591,719,4640,31.66
G22007100127,STCTY-22071 TRACT-    0127     IN NEW ORLEANS LA,4216,3561,655,3445,0,4488,29.92
G22007100128,STCTY-22071 TRACT-    0128     IN NEW ORLEANS LA,3394,3200,194,3101,0,6254,41.86
G22007100129,STCTY-22071 TRACT-    0129     IN NEW ORLEANS LA,3666,3297,369,3216,368,2727,22.97
G22007100130,STCTY-22071 TRACT-    0130     IN NEW ORLEANS LA,3367,2822,545,2736,0,2587,23.38
G22007100131,STCTY-22071 TRACT-    0131     IN NEW ORLEANS LA,4512,1719,2793,1664,0,2071,15.51
G22007100132,STCTY-22071 TRACT-    0132     IN NEW ORLEANS LA,4295,4120,175,3968,167,4927,33.2
G22007100133,STCTY-22071 TRACT-    0133     IN NEW ORLEANS LA,255,224,31,222,0,0,0
G240510000011,STCTY-24510 TRACT-    0001-1   IN BALTIMORE MD,7800,7781,19,7051,0,2178,20.27
G240510000012,STCTY-24510 TRACT-    0001-2   IN BALTIMORE MD,7092,7091,1,6467,1,2941,25.54
G240510000013,STCTY-24510 TRACT-    0001-3   IN BALTIMORE MD,5798,5797,1,5066,0,2201,19.29
G240510000014,STCTY-24510 TRACT-    0001-4   IN BALTIMORE MD,4768,4742,26,4096,25,1742,16.43
G240510000015,STCTY-24510 TRACT-    0001-5   IN BALTIMORE MD,4822,4790,32,3945,32,2151,20.39
G240510000021,STCTY-24510 TRACT-    0002-1   IN BALTIMORE MD,5387,5386,1,4575,0,1504,18.65
G240510000022,STCTY-24510 TRACT-    0002-2   IN BALTIMORE MD,5367,5215,152,4275,146,1818,17.48
G240510000023,STCTY-24510 TRACT-    0002-3   IN BALTIMORE MD,6081,6069,12,4832,1,1673,13.88
G240510000031,STCTY-24510 TRACT-    0003-1   IN BALTIMORE MD,6029,3701,2328,2648,2312,1763,14.63
G240510000032,STCTY-24510 TRACT-    0003-2   IN BALTIMORE MD,5836,5630,206,3990,202,2221,14.6
G240510000041,STCTY-24510 TRACT-    0004-1   IN BALTIMORE MD,2767,2561,206,2245,149,0,30.86
G240510000042,STCTY-24510 TRACT-    0004-2   IN BALTIMORE MD,8136,4524,3612,3800,3600,2700,18.11
G240510000051,STCTY-24510 TRACT-    0005-1   IN BALTIMORE MD,7144,1526,5618,1044,5609,2120,19.43
G240510000052,STCTY-24510 TRACT-    0005-2   IN BALTIMORE MD,4139,1963,2176,1452,2174,2354,15.79
G240510000061,STCTY-24510 TRACT-    0006-1   IN BALTIMORE MD,5768,5767,1,5392,1,2380,28.1
G240510000062,STCTY-24510 TRACT-    0006-2   IN BALTIMORE MD,6668,6609,59,6015,51,2333,30.26
G240510000063,STCTY-24510 TRACT-    0006-3   IN BALTIMORE MD,4887,4676,211,3772,205,1931,23.95
G240510000064,STCTY-24510 TRACT-    0006-4   IN BALTIMORE MD,5954,4632,1322,3763,1321,1346,20.82
G240510000065,STCTY-24510 TRACT-    0006-5   IN BALTIMORE MD,5496,2521,2975,1895,2973,2265,20.28
G240510000071,STCTY-24510 TRACT-    0007-1   IN BALTIMORE MD,4773,4773,0,4455,0,2852,27.17
G240510000072,STCTY-24510 TRACT-    0007-2   IN BALTIMORE MD,7322,7320,2,6528,0,2454,26.85
G240510000073,STCTY-24510 TRACT-    0007-3   IN BALTIMORE MD,4686,4472,214,3896,201,2217,25.36
G240510000074,STCTY-24510 TRACT-    0007-4   IN BALTIMORE MD,7775,2436,5339,2099,5328,1592,25.36
G240510000075,STCTY-24510 TRACT-    0007-5   IN BALTIMORE MD,8288,3517,4771,3150,4766,1968,26.85
G240510000081,STCTY-24510 TRACT-    0008-1   IN BALTIMORE MD,6842,6841,1,6547,1,3202,33.48
G240510000082,STCTY-24510 TRACT-    0008-2   IN BALTIMORE MD,5658,5654,4,5301,2,2137,28.46
G240510000083,STCTY-24510 TRACT-    0008-3   IN BALTIMORE MD,7349,7326,23,6869,23,2422,29.97
G240510000084,STCTY-24510 TRACT-    0008-4   IN BALTIMORE MD,4375,4315,60,4099,59,2282,29.74
G240510000085,STCTY-24510 TRACT-    0008-5   IN BALTIMORE MD,6642,6641,1,6329,1,2366,28.73
G240510000086,STCTY-24510 TRACT-    0008-6   IN BALTIMORE MD,6702,6406,296,6137,295,1938,27.49
G240510000087,STCTY-24510 TRACT-    0008-7   IN BALTIMORE MD,8641,4733,3908,4360,3901,1838,24.78
G240510000091,STCTY-24510 TRACT-    0009-1   IN BALTIMORE MD,3503,3341,162,3219,162,3679,40.42
G240510000092,STCTY-24510 TRACT-    0009-2   IN BALTIMORE MD,1651,1647,4,1604,4,6305,0
G240510000093,STCTY-24510 TRACT-    0009-3   IN BALTIMORE MD,5186,5176,10,4985,4,3989,42.83
G240510000094,STCTY-24510 TRACT-    0009-4   IN BALTIMORE MD,3457,2701,756,2608,755,2139,27.74
G240510000095,STCTY-24510 TRACT-    0009-5   IN BALTIMORE MD,3141,3135,6,3017,5,3268,35.68
G240510000096,STCTY-24510 TRACT-    0009-6   IN BALTIMORE MD,4936,4934,2,4762,2,4078,42.23
G240510000097,STCTY-24510 TRACT-    0009-7   IN BALTIMORE MD,5723,5722,1,5431,0,2935,35.2
G240510000098,STCTY-24510 TRACT-    0009-8   IN BALTIMORE MD,8287,8068,219,7634,219,2824,30.91
G240510000099,STCTY-24510 TRACT-    0009-9   IN BALTIMORE MD,7859,6969,890,6614,888,1783,27.51
G240510000101,STCTY-24510 TRACT-    0010-1   IN BALTIMORE MD,9116,6842,2274,6193,2268,1921,23.23
G240510000102,STCTY-24510 TRACT-    0010-2   IN BALTIMORE MD,5234,976,4258,763,4255,2237,26.75
G240510000103,STCTY-24510 TRACT-    0010-3   IN BALTIMORE MD,2189,870,1319,822,1319,0,0
G240510000111,STCTY-24510 TRACT-    0011-1   IN BALTIMORE MD,2869,2797,72,2583,64,5860,34.47
G240510000112,STCTY-24510 TRACT-    0011-2   IN BALTIMORE MD,7224,6299,925,5976,915,5600,36.16
G240510000113,STCTY-24510 TRACT-    0011-3   IN BALTIMORE MD,2724,1618,1106,1509,1091,0,27.23
G240510000114,STCTY-24510 TRACT-    0011-4   IN BALTIMORE MD,6462,1740,4722,1620,4708,4885,25.8
G240510000121,STCTY-24510 TRACT-    0012-1   IN BALTIMORE MD,3510,3425,85,3285,83,13147,76.6
G240510000122,STCTY-24510 TRACT-    0012-2   IN BALTIMORE MD,7178,6786,392,6564,390,6463,56.86
G240510000123,STCTY-24510 TRACT-    0012-3   IN BALTIMORE MD,6098,5854,244,5548,244,3038,38.04
G240510000124,STCTY-24510 TRACT-    0012-4   IN BALTIMORE MD,5441,3996,1445,3825,1441,2092,28.29
G240510000125,STCTY-24510 TRACT-    0012-5   IN BALTIMORE MD,6439,5224,1215,4955,1197,2379,25.95
G240510000126,STCTY-24510 TRACT-    0012-6   IN BALTIMORE MD,4883,4663,220,4464,216,4416,36.9
G240510000127,STCTY-24510 TRACT-    0012-7   IN BALTIMORE MD,6308,4895,1413,4666,1408,1940,24.02
G240510000131,STCTY-24510 TRACT-    0013-1   IN BALTIMORE MD,4795,4337,458,3509,458,5740,53.95
G240510000132,STCTY-24510 TRACT-    0013-2   IN BALTIMORE MD,5070,5026,44,4095,35,4244,35.25
G240510000133,STCTY-24510 TRACT-    0013-3   IN BALTIMORE MD,6263,1992,4271,1800,4271,3672,32.84
G240510000134,STCTY-24510 TRACT-    0013-4   IN BALTIMORE MD,3934,3921,13,2992,13,2904,36.59
G240510000135,STCTY-24510 TRACT-    0013-5   IN BALTIMORE MD,2316,2315,1,2288,1,2092,29.63
G240510000136,STCTY-24510 TRACT-    0013-6   IN BALTIMORE MD,5274,5262,12,5164,0,2126,28.31
G240510000137,STCTY-24510 TRACT-    0013-7   IN BALTIMORE MD,6141,6024,117,5903,117,2822,37.72
G240510000138,STCTY-24510 TRACT-    0013-8   IN BALTIMORE MD,6000,5989,11,5899,8,2241,26.73
G240510000141,STCTY-24510 TRACT-    0014-1   IN BALTIMORE MD,6683,6135,548,5748,539,3700,30
G240510000142,STCTY-24510 TRACT-    0014-2   IN BALTIMORE MD,9329,959,8370,823,8355,2942,28.27
G240510000143,STCTY-24510 TRACT-    0014-3   IN BALTIMORE MD,9685,715,8970,577,8965,3155,31.38
G240510000151,STCTY-24510 TRACT-    0015-1   IN BALTIMORE MD,9353,864,8489,774,8488,3185,25.88
G2405100001510,STCTY-24510 TRACT-    0015-10  IN BALTIMORE MD,6062,6037,25,5342,24,5399,46.96
G2405100001511,STCTY-24510 TRACT-    0015-11  IN BALTIMORE MD,4496,4479,17,4105,17,6878,56.17
G2405100001512,STCTY-24510 TRACT-    0015-12  IN BALTIMORE MD,6439,6431,8,4669,8,3015,37.35
G2405100001513,STCTY-24510 TRACT-    0015-13  IN BALTIMORE MD,5925,5916,9,4442,5,2887,36.96
G240510000152,STCTY-24510 TRACT-    0015-2   IN BALTIMORE MD,7299,5112,2187,4077,2185,2142,28.68
G240510000153,STCTY-24510 TRACT-    0015-3   IN BALTIMORE MD,5489,5385,104,3997,104,2513,31.13
G240510000154,STCTY-24510 TRACT-    0015-4   IN BALTIMORE MD,6832,6821,11,5748,1,2213,29.63
G240510000155,STCTY-24510 TRACT-    0015-5   IN BALTIMORE MD,1933,1916,17,1597,17,5173,50.23
G240510000156,STCTY-24510 TRACT-    0015-6   IN BALTIMORE MD,6997,6984,13,6666,0,2445,33.69
G240510000157,STCTY-24510 TRACT-    0015-7   IN BALTIMORE MD,4386,4374,12,4096,12,3882,42.45
G240510000158,STCTY-24510 TRACT-    0015-8   IN BALTIMORE MD,6083,6027,56,5508,54,5541,49.98
G240510000159,STCTY-24510 TRACT-    0015-9   IN BALTIMORE MD,4495,4477,18,3834,18,4258,44.86
G240510000161,STCTY-24510 TRACT-    0016-1   IN BALTIMORE MD,7136,160,6976,129,6971,3585,29.37
G240510000162,STCTY-24510 TRACT-    0016-2   IN BALTIMORE MD,8443,142,8301,101,8291,3182,24.21
G240510000163,STCTY-24510 TRACT-    0016-3   IN BALTIMORE MD,5734,1009,4725,935,4725,2700,26.65
G240510000164,STCTY-24510 TRACT-    0016-4   IN BALTIMORE MD,6163,6151,12,5878,1,1592,28.8
G240510000165,STCTY-24510 TRACT-    0016-5   IN BALTIMORE MD,4232,4183,49,4047,49,3538,36.83
G240510000166,STCTY-24510 TRACT-    0016-6   IN BALTIMORE MD,5383,5381,2,5138,0,2291,35.59
G240510000167,STCTY-24510 TRACT-    0016-7   IN BALTIMORE MD,7027,6987,40,6746,38,2707,35.21
G240510000168,STCTY-24510 TRACT-    0016-8   IN BALTIMORE MD,5104,5083,21,4944,21,3528,37.16
G240510000171,STCTY-24510 TRACT-    0017-1   IN BALTIMORE MD,5260,977,4283,802,4276,0,24.37
G240510000172,STCTY-24510 TRACT-    0017-2   IN BALTIMORE MD,8136,158,7978,105,7972,2287,26.34
G240510000173,STCTY-24510 TRACT-    0017-3   IN BALTIMORE MD,5996,117,5879,79,5875,3487,25.07
G240510000181,STCTY-24510 TRACT-    0018-1   IN BALTIMORE MD,5651,1210,4441,1079,4438,0,24.01
G240510000182,STCTY-24510 TRACT-    0018-2   IN BALTIMORE MD,7367,802,6565,696,6562,2432,24.02
G240510000183,STCTY-24510 TRACT-    0018-3   IN BALTIMORE MD,5697,5058,639,4465,633,1598,21.04
G240510000191,STCTY-24510 TRACT-    0019-1   IN BALTIMORE MD,6444,407,6037,355,6036,2990,23.73
G240510000192,STCTY-24510 TRACT-    0019-2   IN BALTIMORE MD,5948,2783,3165,2553,3163,1781,21.46
G240510000193,STCTY-24510 TRACT-    0019-3   IN BALTIMORE MD,5000,4850,150,4466,143,1514,22.91
G240510000194,STCTY-24510 TRACT-    0019-4   IN BALTIMORE MD,6240,6004,236,5654,232,1896,22.41
G240510000201,STCTY-24510 TRACT-    0020-1   IN BALTIMORE MD,6463,5989,474,5582,468,2108,29.39
G240510000202,STCTY-24510 TRACT-    0020-2   IN BALTIMORE MD,8257,8139,118,7719,117,2325,32.98
G240510000203,STCTY-24510 TRACT-    0020-3   IN BALTIMORE MD,4741,4717,24,4322,24,1833,24.76
G240510000204,STCTY-24510 TRACT-    0020-4   IN BALTIMORE MD,4718,4718,0,4362,0,1986,27.37
G240510000205,STCTY-24510 TRACT-    0020-5   IN BALTIMORE MD,6760,6751,9,6290,0,1905,28.07
G240510000206,STCTY-24510 TRACT-    0020-6   IN BALTIMORE MD,4174,4016,158,3798,158,2753,31.34
G240510000207,STCTY-24510 TRACT-    0020-7   IN BALTIMORE MD,6675,6662,13,6335,13,3351,33.92
G240510000208,STCTY-24510 TRACT-    0020-8   IN BALTIMORE MD,3455,3453,2,3334,0,3395,34.68
G240510000211,STCTY-24510 TRACT-    0021-1   IN BALTIMORE MD,8046,6169,1877,5818,1875,1402,21.86
G240510000212,STCTY-24510 TRACT-    0021-2   IN BALTIMORE MD,9124,7951,1173,7470,1172,1808,24.86
G240510000221,STCTY-24510 TRACT-    0022-1   IN BALTIMORE MD,5152,3511,1641,3200,1618,2412,18.21
G240510000222,STCTY-24510 TRACT-    0022-2   IN BALTIMORE MD,6313,2201,4112,1771,4111,2093,19.69
G240510000231,STCTY-24510 TRACT-    0023-1   IN BALTIMORE MD,5893,2730,3163,2580,3160,2163,20.46
G240510000232,STCTY-24510 TRACT-    0023-2   IN BALTIMORE MD,4969,4912,57,4692,46,2211,25.49
G240510000233,STCTY-24510 TRACT-    0023-3   IN BALTIMORE MD,2688,2688,0,2625,0,1606,24.9
G240510000241,STCTY-24510 TRACT-    0024-1   IN BALTIMORE MD,4957,4954,3,4178,2,1606,23.54
G240510000242,STCTY-24510 TRACT-    0024-2   IN BALTIMORE MD,4112,4111,1,3957,1,1880,24.34
G240510000243,STCTY-24510 TRACT-    0024-3   IN BALTIMORE MD,5219,5219,0,5047,0,2215,24.17
G240510000244,STCTY-24510 TRACT-    0024-4   IN BALTIMORE MD,5343,5342,1,5145,1,2199,26.67
G240510000251,STCTY-24510 TRACT-    0025-1   IN BALTIMORE MD,3108,3073,35,2892,35,3525,42
G240510000252,STCTY-24510 TRACT-    0025-2   IN BALTIMORE MD,3972,3938,34,3622,34,2618,26.06
G240510000253,STCTY-24510 TRACT-    0025-3   IN BALTIMORE MD,5781,5002,779,4786,778,2274,27.97
G240510000254,STCTY-24510 TRACT-    0025-4   IN BALTIMORE MD,5452,5409,43,5220,43,3374,29.85
G240510000255,STCTY-24510 TRACT-    0025-5   IN BALTIMORE MD,4684,4613,71,3879,71,1987,24.16
G240510000256,STCTY-24510 TRACT-    0025-6   IN BALTIMORE MD,1637,861,776,764,776,0,17.03
G240510000261,STCTY-24510 TRACT-    0026-1   IN BALTIMORE MD,5010,5009,1,4695,1,3883,33.68
G2405100002610,STCTY-24510 TRACT-    0026-10  IN BALTIMORE MD,5884,5884,0,5447,0,2748,30.92
G2405100002611,STCTY-24510 TRACT-    0026-11  IN BALTIMORE MD,5110,5108,2,4666,2,2305,22.7
G2405100002612,STCTY-24510 TRACT-    0026-12  IN BALTIMORE MD,2607,1943,664,1631,662,0,0
G240510000262,STCTY-24510 TRACT-    0026-2   IN BALTIMORE MD,4731,4729,2,4427,2,3665,35.98
G240510000263,STCTY-24510 TRACT-    0026-3   IN BALTIMORE MD,4483,4482,1,4311,0,4089,36.77
G240510000264,STCTY-24510 TRACT-    0026-4   IN BALTIMORE MD,3733,3707,26,3511,26,2123,28.7
G240510000265,STCTY-24510 TRACT-    0026-5   IN BALTIMORE MD,3414,3413,1,3055,0,3539,29.32
G240510000266,STCTY-24510 TRACT-    0026-6   IN BALTIMORE MD,4323,4314,9,3997,9,2756,27.12
G240510000267,STCTY-24510 TRACT-    0026-7   IN BALTIMORE MD,4284,4283,1,3512,0,2224,25.18
G240510000268,STCTY-24510 TRACT-    0026-8   IN BALTIMORE MD,5136,5133,3,4404,1,2327,28.76
G240510000269,STCTY-24510 TRACT-    0026-9   IN BALTIMORE MD,6131,6041,90,5639,90,2805,22.39
G240510000271,STCTY-24510 TRACT-    0027-1   IN BALTIMORE MD,6925,6922,3,6519,3,4233,37.46
G2405100002710,STCTY-24510 TRACT-    0027-10  IN BALTIMORE MD,6796,6431,365,6171,364,3399,38.49
G2405100002711,STCTY-24510 TRACT-    0027-11  IN BALTIMORE MD,2736,2681,55,2521,55,8500,45.38
G2405100002712,STCTY-24510 TRACT-    0027-12  IN BALTIMORE MD,5157,4947,210,4789,210,11225,51.1
G2405100002713,STCTY-24510 TRACT-    0027-13  IN BALTIMORE MD,2972,2903,69,2785,67,12005,48.12
G2405100002714,STCTY-24510 TRACT-    0027-14  IN BALTIMORE MD,4824,4514,310,4356,309,9402,49.29
G2405100002715,STCTY-24510 TRACT-    0027-15  IN BALTIMORE MD,4557,4248,309,4066,307,6300,37.22
G2405100002716,STCTY-24510 TRACT-    0027-16  IN BALTIMORE MD,4367,4364,3,3856,2,2483,36.12
G2405100002717,STCTY-24510 TRACT-    0027-17  IN BALTIMORE MD,5778,5666,112,4759,111,3245,35.48
G2405100002718,STCTY-24510 TRACT-    0027-18  IN BALTIMORE MD,8814,8295,519,7468,511,2507,36.1
G2405100002719,STCTY-24510 TRACT-    0027-19  IN BALTIMORE MD,2696,2678,18,2456,17,4971,44.5
G240510000272,STCTY-24510 TRACT-    0027-2   IN BALTIMORE MD,3810,3809,1,3609,0,4136,41.3
G2405100002720,STCTY-24510 TRACT-    0027-20  IN BALTIMORE MD,3135,3067,68,2751,67,7058,61.08
G240510000273,STCTY-24510 TRACT-    0027-3   IN BALTIMORE MD,4292,4175,117,3967,117,4796,42.09
G240510000274,STCTY-24510 TRACT-    0027-4   IN BALTIMORE MD,5781,5778,3,5431,2,4376,38.14
G240510000275,STCTY-24510 TRACT-    0027-5   IN BALTIMORE MD,6852,6842,10,6454,10,4284,38.38
G240510000276,STCTY-24510 TRACT-    0027-6   IN BALTIMORE MD,5036,5030,6,4811,6,4023,39.03
G240510000277,STCTY-24510 TRACT-    0027-7   IN BALTIMORE MD,3593,3592,1,3353,1,5609,39.56
G240510000278,STCTY-24510 TRACT-    0027-8   IN BALTIMORE MD,3654,3642,12,3493,12,5004,48.44
G240510000279,STCTY-24510 TRACT-    0027-9   IN BALTIMORE MD,1536,1360,176,1326,176,5700,49.69
G240510000281,STCTY-24510 TRACT-    0028-1   IN BALTIMORE MD,6617,6600,17,6185,12,4915,44.97
G240510000282,STCTY-24510 TRACT-    0028-2   IN BALTIMORE MD,5421,5412,9,5147,9,5524,49.67
G240510000283,STCTY-24510 TRACT-    0028-3   IN BALTIMORE MD,1657,1634,23,1539,23,5059,41.17
G240510000284,STCTY-24510 TRACT-    0028-4   IN BALTIMORE MD,4905,4887,18,4676,18,5950,46.17
G25001700001,STCTY-25017 TRACT-    0001     IN CAMBRIDGE MA,3127,3122,5,2229,4,2121,25.59
G25001700002,STCTY-25017 TRACT-    0002     IN CAMBRIDGE MA,2400,2400,0,1682,0,4136,26.92
G25001700003,STCTY-25017 TRACT-    0003     IN CAMBRIDGE MA,3516,3516,0,2587,0,1652,22.42
G25001700004,STCTY-25017 TRACT-    0004     IN CAMBRIDGE MA,3676,3485,191,2768,181,0,26.93
G25001700005,STCTY-25017 TRACT-    0005     IN CAMBRIDGE MA,4352,3970,382,2935,382,2944,32.46
G25001700006,STCTY-25017 TRACT-    0006     IN CAMBRIDGE MA,3648,3645,3,2538,3,2382,31.49
G25001700007,STCTY-25017 TRACT-    0007     IN CAMBRIDGE MA,3396,3387,9,2321,7,0,26.22
G25001700008,STCTY-25017 TRACT-    0008     IN CAMBRIDGE MA,3444,3348,96,2429,96,0,28.56
G25001700009,STCTY-25017 TRACT-    0009     IN CAMBRIDGE MA,4004,3940,64,3053,63,3786,42.44
G25001700010,STCTY-25017 TRACT-    0010     IN CAMBRIDGE MA,4211,4114,97,2977,79,5306,41.25
G25001700011,STCTY-25017 TRACT-    0011     IN CAMBRIDGE MA,3717,3270,447,2349,395,0,34.15
G25001700012,STCTY-25017 TRACT-    0012     IN CAMBRIDGE MA,4265,3966,299,3024,289,3321,34.07
G25001700013,STCTY-25017 TRACT-    0013     IN CAMBRIDGE MA,5707,5519,188,4006,188,2911,37.88
G25001700014,STCTY-25017 TRACT-    0014     IN CAMBRIDGE MA,2886,2436,450,1840,448,2500,33.32
G25001700015,STCTY-25017 TRACT-    0015     IN CAMBRIDGE MA,3657,2424,1233,1855,1232,3250,30.99
G25001700016,STCTY-25017 TRACT-    0016     IN CAMBRIDGE MA,4093,4047,46,3270,43,7738,50.45
G25001700017,STCTY-25017 TRACT-    0017     IN CAMBRIDGE MA,4995,4896,99,3826,98,4114,42.65
G25001700018,STCTY-25017 TRACT-    0018     IN CAMBRIDGE MA,5207,5132,75,3970,64,7170,46.88
G25001700019,STCTY-25017 TRACT-    0019     IN CAMBRIDGE MA,2416,2326,90,1805,70,0,31.8
G25001700020,STCTY-25017 TRACT-    0020     IN CAMBRIDGE MA,3364,3351,13,2884,10,8359,57.52
G25001700021,STCTY-25017 TRACT-    0021     IN CAMBRIDGE MA,3476,3429,47,2799,39,10000,56.92
G25001700022,STCTY-25017 TRACT-    0022     IN CAMBRIDGE MA,4528,4507,21,3713,21,13081,65.02
G25001700023,STCTY-25017 TRACT-    0023     IN CAMBRIDGE MA,3521,3507,14,2694,13,4345,43.48
G25001700024,STCTY-25017 TRACT-    0024     IN CAMBRIDGE MA,2839,2579,260,2024,254,0,45.42
G25001700025,STCTY-25017 TRACT-    0025     IN CAMBRIDGE MA,2987,2975,12,2476,9,9779,53.19
G25001700026,STCTY-25017 TRACT-    0026     IN CAMBRIDGE MA,3800,3428,372,2644,372,3316,43.76
G25001700027,STCTY-25017 TRACT-    0027     IN CAMBRIDGE MA,3327,3091,236,2463,236,3909,42.25
G25001700028,STCTY-25017 TRACT-    0028     IN CAMBRIDGE MA,2963,2806,157,2310,155,2950,41.58
G25001700029,STCTY-25017 TRACT-    0029     IN CAMBRIDGE MA,4006,3984,22,3155,17,2482,34.91
G25001700030,STCTY-25017 TRACT-    0030     IN CAMBRIDGE MA,3351,3255,96,2671,90,3896,41.09
G2500250A0001,STCTY-25025 TRACT-  A 0001     IN BOSTON MA,6174,6174,0,4814,0,3995,42.05
G2500250A0002,STCTY-25025 TRACT-  A 0002     IN BOSTON MA,4809,4807,2,3871,0,2309,35.59
G2500250A0003,STCTY-25025 TRACT-  A 0003     IN BOSTON MA,6960,6960,0,5190,0,2103,31.68
G2500250A0004,STCTY-25025 TRACT-  A 0004     IN BOSTON MA,5331,5330,1,4014,0,3152,29.53
G2500250A0005,STCTY-25025 TRACT-  A 0005     IN BOSTON MA,6670,6650,20,4879,20,2114,29.03
G2500250A0006,STCTY-25025 TRACT-  A 0006     IN BOSTON MA,4285,4280,5,3091,0,2467,29.71
G2500250B0001,STCTY-25025 TRACT-  B 0001     IN BOSTON MA,3329,3328,1,2301,0,1782,31.01
G2500250B0002,STCTY-25025 TRACT-  B 0002     IN BOSTON MA,3696,3687,9,2514,0,1886,27.09
G2500250B0003,STCTY-25025 TRACT-  B 0003     IN BOSTON MA,2951,2927,24,2048,24,1597,25.88
G2500250B0004,STCTY-25025 TRACT-  B 0004     IN BOSTON MA,3862,3854,8,2722,7,1571,26.5
G2500250B0005A,STCTY-25025 TRACT-  B 0005-A   IN BOSTON MA,3480,3480,0,2381,0,0,28.23
G2500250B0005B,STCTY-25025 TRACT-  B 0005-B   IN BOSTON MA,5381,5379,2,4035,1,1675,27.25
G2500250B0006,STCTY-25025 TRACT-  B 0006     IN BOSTON MA,2735,2593,142,1812,141,0,0
G2500250C0001,STCTY-25025 TRACT-  C 0001     IN BOSTON MA,1020,965,55,925,24,0,0
G2500250C0002,STCTY-25025 TRACT-  C 0002     IN BOSTON MA,2912,2902,10,2404,0,0,26.94
G2500250C0003,STCTY-25025 TRACT-  C 0003     IN BOSTON MA,3961,3953,8,3322,2,2602,31.18
G2500250D0001,STCTY-25025 TRACT-  D 0001     IN BOSTON MA,1376,1369,7,1148,7,0,22.48
G2500250D0002,STCTY-25025 TRACT-  D 0002     IN BOSTON MA,1304,1303,1,1044,0,0,26
G2500250D0003,STCTY-25025 TRACT-  D 0003     IN BOSTON MA,2912,2910,2,2458,1,2397,25.41
G2500250D0004,STCTY-25025 TRACT-  D 0004     IN BOSTON MA,3532,3514,18,2943,18,2041,23.07
G2500250E0001,STCTY-25025 TRACT-  E 0001     IN BOSTON MA,5120,5006,114,4058,79,2260,26.09
G2500250E0002,STCTY-25025 TRACT-  E 0002     IN BOSTON MA,3450,3430,20,2748,1,4250,23.1
G2500250F0001,STCTY-25025 TRACT-  F 0001     IN BOSTON MA,3221,3219,2,1929,1,0,25.67
G2500250F0002,STCTY-25025 TRACT-  F 0002     IN BOSTON MA,5437,5436,1,3568,0,0,28.78
G2500250F0003,STCTY-25025 TRACT-  F 0003     IN BOSTON MA,973,961,12,703,11,0,30.8
G2500250F0004,STCTY-25025 TRACT-  F 0004     IN BOSTON MA,5573,5572,1,3493,0,0,26.73
G2500250F0005,STCTY-25025 TRACT-  F 0005     IN BOSTON MA,3367,3362,5,2264,4,0,28.63
G2500250F0006,STCTY-25025 TRACT-  F 0006     IN BOSTON MA,1127,1115,12,867,3,0,44.5
G2500250G0001,STCTY-25025 TRACT-  G 0001     IN BOSTON MA,1128,737,391,467,1,0,20.75
G2500250G0002,STCTY-25025 TRACT-  G 0002     IN BOSTON MA,3159,2555,604,1604,54,0,23.91
G2500250G0003,STCTY-25025 TRACT-  G 0003     IN BOSTON MA,783,779,4,652,1,0,0
G2500250G0004,STCTY-25025 TRACT-  G 0004     IN BOSTON MA,584,529,55,390,54,0,29.5
G2500250H0001,STCTY-25025 TRACT-  H 0001     IN BOSTON MA,7864,7794,70,5089,68,2487,29.91
G2500250H0002,STCTY-25025 TRACT-  H 0002     IN BOSTON MA,2720,2713,7,1725,7,0,23.38
G2500250H0003,STCTY-25025 TRACT-  H 0003     IN BOSTON MA,2295,2251,44,1685,43,0,29.14
G2500250H0004,STCTY-25025 TRACT-  H 0004     IN BOSTON MA,4708,4672,36,3136,31,0,28.05
G2500250I0001,STCTY-25025 TRACT-  I 0001     IN BOSTON MA,2680,2392,288,1552,282,0,26.34
G2500250I0002,STCTY-25025 TRACT-  I 0002     IN BOSTON MA,4231,3697,534,2390,494,0,18.99
G2500250I0003,STCTY-25025 TRACT-  I 0003     IN BOSTON MA,6322,6200,122,3816,97,5406,25.35
G2500250I0004,STCTY-25025 TRACT-  I 0004     IN BOSTON MA,2991,2980,11,2136,8,0,23.21
G2500250J0001,STCTY-25025 TRACT-  J 0001     IN BOSTON MA,5468,5424,44,3505,26,5288,31.13
G2500250J0002,STCTY-25025 TRACT-  J 0002     IN BOSTON MA,2379,1397,982,911,959,0,27.54
G2500250J0003,STCTY-25025 TRACT-  J 0003     IN BOSTON MA,3312,3272,40,2439,36,0,43.41
G2500250J0004,STCTY-25025 TRACT-  J 0004     IN BOSTON MA,4047,3763,284,2834,277,0,39.33
G2500250J0005,STCTY-25025 TRACT-  J 0005     IN BOSTON MA,7988,7726,262,5974,232,0,38.14
G2500250K0001,STCTY-25025 TRACT-  K 0001     IN BOSTON MA,5078,4992,86,3871,77,0,36.01
G2500250K0002,STCTY-25025 TRACT-  K 0002     IN BOSTON MA,4613,4602,11,3531,6,17687,58.64
G2500250K0003,STCTY-25025 TRACT-  K 0003     IN BOSTON MA,4266,4245,21,3200,15,17465,68.73
G2500250K0004A,STCTY-25025 TRACT-  K 0004-A   IN BOSTON MA,3646,3620,26,2930,23,14792,67.96
G2500250K0004B,STCTY-25025 TRACT-  K 0004-B   IN BOSTON MA,8281,8234,47,6825,12,0,42.14
G2500250K0005,STCTY-25025 TRACT-  K 0005     IN BOSTON MA,4662,4634,28,3590,26,16500,68.55
G2500250L0001,STCTY-25025 TRACT-  L 0001     IN BOSTON MA,4530,4470,60,2862,48,5345,12.23
G2500250L0002,STCTY-25025 TRACT-  L 0002     IN BOSTON MA,5177,2231,2946,1578,2924,6597,28.72
G2500250L0003,STCTY-25025 TRACT-  L 0003     IN BOSTON MA,4481,3349,1132,2340,1113,0,27.22
G2500250L0004,STCTY-25025 TRACT-  L 0004     IN BOSTON MA,2456,2368,88,1647,86,0,28.63
G2500250L0005,STCTY-25025 TRACT-  L 0005     IN BOSTON MA,2743,2721,22,2037,22,0,23.21
G2500250L0006,STCTY-25025 TRACT-  L 0006     IN BOSTON MA,3330,3300,30,2498,19,0,26.58
G2500250M0001,STCTY-25025 TRACT-  M 0001     IN BOSTON MA,2529,2529,0,1927,0,0,21.74
G2500250M0002,STCTY-25025 TRACT-  M 0002     IN BOSTON MA,3586,3586,0,2859,0,1464,19.26
G2500250M0003,STCTY-25025 TRACT-  M 0003     IN BOSTON MA,2656,2655,1,1856,0,0,19.26
G2500250M0004,STCTY-25025 TRACT-  M 0004     IN BOSTON MA,1940,1940,0,1393,0,0,18.51
G2500250N0001,STCTY-25025 TRACT-  N 0001     IN BOSTON MA,7226,7223,3,5654,3,1446,25.5
G2500250N0002,STCTY-25025 TRACT-  N 0002     IN BOSTON MA,4846,4842,4,3900,0,2731,35.17
G2500250N0003,STCTY-25025 TRACT-  N 0003     IN BOSTON MA,3619,3617,2,2822,0,3589,36.03
G2500250N0004,STCTY-25025 TRACT-  N 0004     IN BOSTON MA,5695,5694,1,4600,0,2955,34.21
G2500250O0001,STCTY-25025 TRACT-  O 0001     IN BOSTON MA,7891,7888,3,6082,0,2815,29.63
G2500250O0002,STCTY-25025 TRACT-  O 0002     IN BOSTON MA,2183,2183,0,1680,0,2471,30.33
G2500250O0003,STCTY-25025 TRACT-  O 0003     IN BOSTON MA,4713,4712,1,3680,1,1750,27.07
G2500250O0004,STCTY-25025 TRACT-  O 0004     IN BOSTON MA,1375,1375,0,1051,0,0,21.48
G2500250P0001A,STCTY-25025 TRACT-  P 0001-A   IN BOSTON MA,2138,2138,0,1648,0,0,25.43
G2500250P0001B,STCTY-25025 TRACT-  P 0001-B   IN BOSTON MA,3967,3967,0,3591,0,0,25.59
G2500250P0001C,STCTY-25025 TRACT-  P 0001-C   IN BOSTON MA,2255,2255,0,1780,0,2078,30.67
G2500250P0002,STCTY-25025 TRACT-  P 0002     IN BOSTON MA,5978,5978,0,4721,0,2394,36.23
G2500250P0003,STCTY-25025 TRACT-  P 0003     IN BOSTON MA,4313,4307,6,3336,0,4364,38.72
G2500250P0004,STCTY-25025 TRACT-  P 0004     IN BOSTON MA,3783,3776,7,3055,7,3583,38.72
G2500250P0005,STCTY-25025 TRACT-  P 0005     IN BOSTON MA,4773,4757,16,3428,16,2700,33.33
G2500250P0006,STCTY-25025 TRACT-  P 0006     IN BOSTON MA,3707,3697,10,2827,9,4100,38.39
G2500250Q0001,STCTY-25025 TRACT-  Q 0001     IN BOSTON MA,1767,1737,30,1385,30,0,25.18
G2500250Q0002,STCTY-25025 TRACT-  Q 0002     IN BOSTON MA,4747,3953,794,3127,792,1781,24.79
G2500250Q0003,STCTY-25025 TRACT-  Q 0003     IN BOSTON MA,4611,4449,162,3395,157,3293,29.72
G2500250Q0004,STCTY-25025 TRACT-  Q 0004     IN BOSTON MA,3775,3764,11,2820,11,2808,29.74
G2500250Q0005,STCTY-25025 TRACT-  Q 0005     IN BOSTON MA,6538,6526,12,5191,5,2199,31.87
G2500250R0001,STCTY-25025 TRACT-  R 0001     IN BOSTON MA,6257,782,5475,618,5465,0,25.3
G2500250R0002,STCTY-25025 TRACT-  R 0002     IN BOSTON MA,4057,2622,1435,2003,1422,1870,26.46
G2500250R0003,STCTY-25025 TRACT-  R 0003     IN BOSTON MA,3635,2007,1628,1610,1623,0,26.3
G2500250S0001,STCTY-25025 TRACT-  S 0001     IN BOSTON MA,3300,3273,27,2608,24,0,40.35
G2500250S0002,STCTY-25025 TRACT-  S 0002     IN BOSTON MA,1191,1155,36,917,36,0,26.89
G2500250S0003,STCTY-25025 TRACT-  S 0003     IN BOSTON MA,5448,5228,220,4007,219,2848,27.11
G2500250S0004,STCTY-25025 TRACT-  S 0004     IN BOSTON MA,4490,4367,123,3429,118,0,37.99
G2500250S0005,STCTY-25025 TRACT-  S 0005     IN BOSTON MA,7414,7387,27,5685,17,3181,41.22
G2500250S0006,STCTY-25025 TRACT-  S 0006     IN BOSTON MA,4939,4931,8,3565,5,3382,32.22
G2500250T0001,STCTY-25025 TRACT-  T 0001     IN BOSTON MA,4750,4748,2,3821,0,3388,33.4
G2500250T0002,STCTY-25025 TRACT-  T 0002     IN BOSTON MA,7338,7325,13,5855,11,3458,38.93
G2500250T0003A,STCTY-25025 TRACT-  T 0003-A   IN BOSTON MA,3935,3929,6,3094,4,4160,43
G2500250T0003B,STCTY-25025 TRACT-  T 0003-B   IN BOSTON MA,5547,5541,6,4279,3,3088,42.67
G2500250T0004A,STCTY-25025 TRACT-  T 0004-A   IN BOSTON MA,4915,4915,0,3869,0,2568,38.78
G2500250T0004B,STCTY-25025 TRACT-  T 0004-B   IN BOSTON MA,4437,4437,0,3393,0,2703,40.65
G2500250T0005A,STCTY-25025 TRACT-  T 0005-A   IN BOSTON MA,5846,5843,3,4535,1,2500,38.78
G2500250T0005B,STCTY-25025 TRACT-  T 0005-B   IN BOSTON MA,5498,5489,9,4228,9,3728,43.08
G2500250T0006,STCTY-25025 TRACT-  T 0006     IN BOSTON MA,6282,6255,27,3933,19,3714,36.09
G2500250T0007A,STCTY-25025 TRACT-  T 0007-A   IN BOSTON MA,3342,3333,9,2255,5,0,45.66
G2500250T0007B,STCTY-25025 TRACT-  T 0007-B   IN BOSTON MA,8186,8146,40,5057,36,6083,43.26
G2500250T0008A,STCTY-25025 TRACT-  T 0008-A   IN BOSTON MA,8008,7988,20,5049,19,4028,47.65
G2500250T0008B,STCTY-25025 TRACT-  T 0008-B   IN BOSTON MA,4559,4536,23,3329,20,3849,38.49
G2500250T0009,STCTY-25025 TRACT-  T 0009     IN BOSTON MA,6933,6912,21,5585,2,3760,43.15
G2500250T0010,STCTY-25025 TRACT-  T 0010     IN BOSTON MA,4469,4459,10,3652,9,5241,45.87
G2500250U0001,STCTY-25025 TRACT-  U 0001     IN BOSTON MA,6357,6022,335,4488,332,3675,34.59
G2500250U0002,STCTY-25025 TRACT-  U 0002     IN BOSTON MA,5939,5008,931,3860,924,2880,30.91
G2500250U0003,STCTY-25025 TRACT-  U 0003     IN BOSTON MA,4705,4592,113,3615,94,3266,32.91
G2500250U0004,STCTY-25025 TRACT-  U 0004     IN BOSTON MA,6580,6271,309,4783,301,2436,32.79
G2500250U0005,STCTY-25025 TRACT-  U 0005     IN BOSTON MA,8860,5326,3534,3292,3523,3849,42.07
G2500250U0006A,STCTY-25025 TRACT-  U 0006-A   IN BOSTON MA,5249,4863,386,3054,382,4633,44.45
G2500250U0006B,STCTY-25025 TRACT-  U 0006-B   IN BOSTON MA,7248,7219,29,4879,29,5914,53.6
G2500250V0001,STCTY-25025 TRACT-  V 0001     IN BOSTON MA,4569,4477,92,3372,92,3308,34.89
G2500250V0002,STCTY-25025 TRACT-  V 0002     IN BOSTON MA,5164,5149,15,3975,12,3933,30.1
G2500250V0003,STCTY-25025 TRACT-  V 0003     IN BOSTON MA,3899,3898,1,2978,0,2483,33.39
G2500250V0004A,STCTY-25025 TRACT-  V 0004-A   IN BOSTON MA,2275,2275,0,1766,0,0,46.31
G2500250V0004B,STCTY-25025 TRACT-  V 0004-B   IN BOSTON MA,3726,3722,4,2845,3,4117,42.63
G2500250V0005,STCTY-25025 TRACT-  V 0005     IN BOSTON MA,8233,8224,9,6377,6,4862,39.36
G2500250V0006,STCTY-25025 TRACT-  V 0006     IN BOSTON MA,7468,7427,41,5655,40,3440,36.21
G2500250W0001A,STCTY-25025 TRACT-  W 0001-A   IN BOSTON MA,6814,6802,12,5552,10,7401,47.67
G2500250W0001B,STCTY-25025 TRACT-  W 0001-B   IN BOSTON MA,8235,8233,2,6943,2,5671,51.82
G2500250W0002,STCTY-25025 TRACT-  W 0002     IN BOSTON MA,4879,4879,0,3782,0,2938,38.67
G2500250W0003A,STCTY-25025 TRACT-  W 0003-A   IN BOSTON MA,9219,9142,77,6983,72,4750,41.53
G2500250W0003B,STCTY-25025 TRACT-  W 0003-B   IN BOSTON MA,1501,1500,1,1200,0,3459,37.27
G2500250W0004A,STCTY-25025 TRACT-  W 0004-A   IN BOSTON MA,2011,2011,0,1654,0,4109,42.02
G2500250W0004B,STCTY-25025 TRACT-  W 0004-B   IN BOSTON MA,7950,7949,1,6419,1,4057,44.53
G2500250W0005,STCTY-25025 TRACT-  W 0005     IN BOSTON MA,9362,9359,3,7580,0,4735,47.13
G2500250W0006A,STCTY-25025 TRACT-  W 0006-A   IN BOSTON MA,4272,4272,0,3768,0,5303,51.61
G2500250W0006B,STCTY-25025 TRACT-  W 0006-B   IN BOSTON MA,5328,5314,14,4601,6,6722,56.53
G2500250W0006C,STCTY-25025 TRACT-  W 0006-C   IN BOSTON MA,5269,5266,3,4586,3,7046,50.41
G2500250W0006D,STCTY-25025 TRACT-  W 0006-D   IN BOSTON MA,4607,4603,4,3631,0,4205,43.96
G2500250X0001,STCTY-25025 TRACT-  X 0001     IN BOSTON MA,8931,8915,16,7222,10,4730,40.04
G2500250X0002,STCTY-25025 TRACT-  X 0002     IN BOSTON MA,10223,10217,6,8106,3,3453,39.53
G2500250X0003A,STCTY-25025 TRACT-  X 0003-A   IN BOSTON MA,6020,6020,0,5054,0,4750,47.72
G2500250X0003B,STCTY-25025 TRACT-  X 0003-B   IN BOSTON MA,6351,6350,1,5254,1,5012,46.06
G2500250X0004A,STCTY-25025 TRACT-  X 0004-A   IN BOSTON MA,8482,8462,20,6662,13,3951,42.5
G2500250X0004B,STCTY-25025 TRACT-  X 0004-B   IN BOSTON MA,5594,5591,3,4578,1,4306,46.48
G2500250X0005A,STCTY-25025 TRACT-  X 0005-A   IN BOSTON MA,7914,7892,22,4703,21,3181,44.87
G2500250X0005B,STCTY-25025 TRACT-  X 0005-B   IN BOSTON MA,5028,5025,3,3131,2,3256,45.28
G2500250X0005C,STCTY-25025 TRACT-  X 0005-C   IN BOSTON MA,5083,5072,11,3845,4,3734,42.32
G2500250X0006A,STCTY-25025 TRACT-  X 0006-A   IN BOSTON MA,11902,11889,13,7407,5,3694,47.92
G2500250X0006B,STCTY-25025 TRACT-  X 0006-B   IN BOSTON MA,6879,6838,41,5242,36,4138,47.03
G2500250X0006C,STCTY-25025 TRACT-  X 0006-C   IN BOSTON MA,3874,3872,2,3216,0,4449,36.84
G2500250Y0001,STCTY-25025 TRACT-  Y 0001     IN BOSTON MA,5892,5891,1,4508,0,3355,34.12
G2500250Y0002,STCTY-25025 TRACT-  Y 0002     IN BOSTON MA,7294,7135,159,5584,155,3468,41.56
G2500250Y0003A,STCTY-25025 TRACT-  Y 0003-A   IN BOSTON MA,11123,11091,32,8562,23,0,43.96
G2500250Y0003B,STCTY-25025 TRACT-  Y 0003-B   IN BOSTON MA,7357,7337,20,5729,14,4534,40.75
G2500250Y0004,STCTY-25025 TRACT-  Y 0004     IN BOSTON MA,8852,8846,6,7024,4,4461,45.08
G2500250Y0005A,STCTY-25025 TRACT-  Y 0005-A   IN BOSTON MA,5428,5418,10,4391,6,5855,48.17
G2500250Y0005B,STCTY-25025 TRACT-  Y 0005-B   IN BOSTON MA,8778,8763,15,6996,14,6062,50.51
G2500250Y0005C,STCTY-25025 TRACT-  Y 0005-C   IN BOSTON MA,8643,8628,15,6842,15,0,50.09
G2500250Z0001A,STCTY-25025 TRACT-  Z 0001-A   IN BOSTON MA,5087,5080,7,4015,5,4318,43.59
G2500250Z0001B,STCTY-25025 TRACT-  Z 0001-B   IN BOSTON MA,6446,6438,8,5109,3,4057,37.24
G2500250Z0001C,STCTY-25025 TRACT-  Z 0001-C   IN BOSTON MA,5741,5723,18,4624,14,3895,33.66
G2500250Z0002,STCTY-25025 TRACT-  Z 0002     IN BOSTON MA,7918,7901,17,6216,15,3744,39.1
G26004900001,STCTY-26049 TRACT-    0001     IN FLINT MI,4682,4679,3,4447,0,1830,25.8
G26004900002,STCTY-26049 TRACT-    0002     IN FLINT MI,4635,4635,0,4257,0,1838,25.64
G26004900003,STCTY-26049 TRACT-    0003     IN FLINT MI,4615,3962,653,3377,642,2219,25.66
G26004900004,STCTY-26049 TRACT-    0004     IN FLINT MI,5443,3963,1480,3032,1480,2530,26.81
G26004900005,STCTY-26049 TRACT-    0005     IN FLINT MI,5467,3327,2140,2302,2140,1914,25.51
G26004900006,STCTY-26049 TRACT-    0006     IN FLINT MI,4901,4660,241,4091,238,2602,23.68
G26004900007,STCTY-26049 TRACT-    0007     IN FLINT MI,4158,4146,12,3671,0,3038,28.39
G26004900008,STCTY-26049 TRACT-    0008     IN FLINT MI,3227,3211,16,2923,13,3321,34.1
G26004900009,STCTY-26049 TRACT-    0009     IN FLINT MI,3984,2057,1927,1906,1927,2478,29.27
G26004900010,STCTY-26049 TRACT-    0010     IN FLINT MI,4535,4526,9,4129,1,2752,32.87
G26004900011,STCTY-26049 TRACT-    0011     IN FLINT MI,4311,4306,5,3988,5,1936,29.5
G26004900012,STCTY-26049 TRACT-    0012     IN FLINT MI,5189,5185,4,4416,0,2642,29.92
G26004900013,STCTY-26049 TRACT-    0013     IN FLINT MI,3672,3672,0,3160,0,3193,32.99
G26004900014,STCTY-26049 TRACT-    0014     IN FLINT MI,3008,3008,0,2752,0,3069,31.29
G26004900015,STCTY-26049 TRACT-    0015     IN FLINT MI,3958,3900,58,3481,55,4434,37.7
G26004900016,STCTY-26049 TRACT-    0016     IN FLINT MI,2001,1993,8,1787,8,8125,0
G26004900017,STCTY-26049 TRACT-    0017     IN FLINT MI,3602,3602,0,3307,0,2490,28.42
G26004900018,STCTY-26049 TRACT-    0018     IN FLINT MI,3665,3663,2,3289,2,2946,32.36
G26004900019,STCTY-26049 TRACT-    0019     IN FLINT MI,3739,3739,0,3337,0,3380,33.51
G26004900020,STCTY-26049 TRACT-    0020     IN FLINT MI,4277,4277,0,3622,0,3066,30.91
G26004900021,STCTY-26049 TRACT-    0021     IN FLINT MI,3547,3541,6,3072,0,4306,39.27
G26004900022,STCTY-26049 TRACT-    0022     IN FLINT MI,2763,2763,0,2471,0,5037,50.47
G26004900023,STCTY-26049 TRACT-    0023     IN FLINT MI,2715,2715,0,2398,0,3953,36.35
G26004900024,STCTY-26049 TRACT-    0024     IN FLINT MI,3001,2996,5,2679,5,4453,36.72
G26004900025,STCTY-26049 TRACT-    0025     IN FLINT MI,2657,2655,2,2396,1,3917,36.25
G26004900026,STCTY-26049 TRACT-    0026     IN FLINT MI,3505,3500,5,3207,2,3354,35.29
G26004900027,STCTY-26049 TRACT-    0027     IN FLINT MI,3827,3824,3,3429,1,3429,34.96
G26004900028,STCTY-26049 TRACT-    0028     IN FLINT MI,2139,2136,3,1877,1,3803,31.47
G26004900029,STCTY-26049 TRACT-    0029     IN FLINT MI,3827,3785,42,3400,40,3786,34.85
G26004900030,STCTY-26049 TRACT-    0030     IN FLINT MI,2779,2779,0,2458,0,3360,31.78
G26004900031,STCTY-26049 TRACT-    0031     IN FLINT MI,4116,4099,17,3708,7,3490,32.27
G26004900032,STCTY-26049 TRACT-    0032     IN FLINT MI,3393,3393,0,3126,0,2870,31.92
G26004900033,STCTY-26049 TRACT-    0033     IN FLINT MI,4918,4901,17,4483,17,2758,32.02
G26004900034,STCTY-26049 TRACT-    0034     IN FLINT MI,3338,3332,6,3150,0,2384,30.69
G26004900035,STCTY-26049 TRACT-    0035     IN FLINT MI,3234,3224,10,3013,10,2968,29.36
G26004900036,STCTY-26049 TRACT-    0036     IN FLINT MI,3878,3875,3,3383,3,4172,40.95
G26004900037,STCTY-26049 TRACT-    0037     IN FLINT MI,3869,3867,2,3411,1,4532,43.95
G26004900038,STCTY-26049 TRACT-    0038     IN FLINT MI,3356,3356,0,3035,0,4592,47.93
G26004900039,STCTY-26049 TRACT-    0039     IN FLINT MI,1977,1977,0,1748,0,3509,37.11
G26004900040,STCTY-26049 TRACT-    0040     IN FLINT MI,2614,2608,6,2444,0,2605,30.49
G26004900041,STCTY-26049 TRACT-    0041     IN FLINT MI,3021,3021,0,2851,0,2750,29.45
G2600490G0001,STCTY-26049 TRACT-  G 0001     IN FLINT MI ADJ AREA,3803,3803,0,3585,0,2805,22.43
G2600490G0002,STCTY-26049 TRACT-  G 0002     IN FLINT MI ADJ AREA,960,960,0,886,0,0,0
G2600490G0003,STCTY-26049 TRACT-  G 0003     IN FLINT MI ADJ AREA,4074,4074,0,3867,0,1580,20.86
G2600490G0004,STCTY-26049 TRACT-  G 0004     IN FLINT MI ADJ AREA,893,893,0,837,0,0,0
G2600490G0005,STCTY-26049 TRACT-  G 0005     IN FLINT MI ADJ AREA,1278,1278,0,1182,0,1515,0
G2600490G0006,STCTY-26049 TRACT-  G 0006     IN FLINT MI ADJ AREA,2923,2917,6,2755,6,2582,28.43
G2600490G0007,STCTY-26049 TRACT-  G 0007     IN FLINT MI ADJ AREA,782,782,0,695,0,0,0
G2600490G0008,STCTY-26049 TRACT-  G 0008     IN FLINT MI ADJ AREA,3451,3440,11,3218,10,1991,18.32
G2600490G0009,STCTY-26049 TRACT-  G 0009     IN FLINT MI ADJ AREA,3896,3895,1,3724,0,1908,24.63
G2600490G0010,STCTY-26049 TRACT-  G 0010     IN FLINT MI ADJ AREA,1836,1836,0,1767,0,1568,0
G2600490G0011,STCTY-26049 TRACT-  G 0011     IN FLINT MI ADJ AREA,679,679,0,641,0,0,0
G2600490G0012,STCTY-26049 TRACT-  G 0012     IN FLINT MI ADJ AREA,3558,3555,3,3350,0,2635,26.4
G2600490G0013,STCTY-26049 TRACT-  G 0013     IN FLINT MI ADJ AREA,5285,5284,1,4930,0,1961,25.31
G2600490G0014,STCTY-26049 TRACT-  G 0014     IN FLINT MI ADJ AREA,1798,1797,1,1679,0,2086,0
G2600490G0015,STCTY-26049 TRACT-  G 0015     IN FLINT MI ADJ AREA,3826,3822,4,3604,0,2168,22.97
G2600490G0016,STCTY-26049 TRACT-  G 0016     IN FLINT MI ADJ AREA,778,778,0,737,0,0,0
G2600490G0017,STCTY-26049 TRACT-  G 0017     IN FLINT MI ADJ AREA,2991,2983,8,2802,8,2927,23.77
G2600490G0018,STCTY-26049 TRACT-  G 0018     IN FLINT MI ADJ AREA,1513,1513,0,1438,0,2214,0
G2600490G0019,STCTY-26049 TRACT-  G 0019     IN FLINT MI ADJ AREA,848,839,9,783,9,0,0
G2600490G0020,STCTY-26049 TRACT-  G 0020     IN FLINT MI ADJ AREA,2954,2954,0,2766,0,1886,0
G2600490G0021,STCTY-26049 TRACT-  G 0021     IN FLINT MI ADJ AREA,1005,952,53,885,53,0,0
G2600490G0022,STCTY-26049 TRACT-  G 0022     IN FLINT MI ADJ AREA,4478,4477,1,4214,0,1788,20.65
G2600490G0023,STCTY-26049 TRACT-  G 0023     IN FLINT MI ADJ AREA,2237,2237,0,2136,0,1865,30.39
G26009900877,STCTY-26099 TRACT-    0877     IN DETROIT MI ADJ AREA,24,24,0,15,0,0,0
G26009900880,STCTY-26099 TRACT-    0880     IN DETROIT MI ADJ AREA,4083,4083,0,3490,0,2886,30.7
G26009900881,STCTY-26099 TRACT-    0881     IN DETROIT MI ADJ AREA,3423,3418,5,2914,5,3539,36.92
G26009900882,STCTY-26099 TRACT-    0882     IN DETROIT MI ADJ AREA,2031,2031,0,1703,0,3286,0
G26009900883,STCTY-26099 TRACT-    0883     IN DETROIT MI ADJ AREA,4032,4032,0,3392,0,3815,34.19
G26009900884,STCTY-26099 TRACT-    0884     IN DETROIT MI ADJ AREA,2521,2521,0,2163,0,2409,33.03
G26009900885,STCTY-26099 TRACT-    0885     IN DETROIT MI ADJ AREA,3810,3447,363,2989,363,1702,28.09
G26009900886,STCTY-26099 TRACT-    0886     IN DETROIT MI ADJ AREA,1740,1740,0,1523,0,1755,0
G26009900887,STCTY-26099 TRACT-    0887     IN DETROIT MI ADJ AREA,3473,3473,0,2941,0,2138,28.15
G26009900888,STCTY-26099 TRACT-    0888     IN DETROIT MI ADJ AREA,1969,1969,0,1750,0,1689,35.43
G26009900889,STCTY-26099 TRACT-    0889     IN DETROIT MI ADJ AREA,2899,2773,126,2370,126,2539,32.34
G26012500848,STCTY-26125 TRACT-    0848     IN DETROIT MI ADJ AREA,4469,4296,173,3716,173,2185,25.83
G26012500849,STCTY-26125 TRACT-    0849     IN DETROIT MI ADJ AREA,6788,6785,3,5615,1,3558,42.2
G26012500850,STCTY-26125 TRACT-    0850     IN DETROIT MI ADJ AREA,11266,11250,16,9492,5,4301,43.96
G26012500851,STCTY-26125 TRACT-    0851     IN DETROIT MI ADJ AREA,1724,0,1724,0,1724,638,24.5
G26012500852,STCTY-26125 TRACT-    0852     IN DETROIT MI ADJ AREA,1169,1169,0,987,0,3076,0
G26012500853,STCTY-26125 TRACT-    0853     IN DETROIT MI ADJ AREA,3391,3360,31,2982,26,7125,63.54
G26012500854,STCTY-26125 TRACT-    0854     IN DETROIT MI ADJ AREA,1705,1685,20,1476,19,9720,0
G26012500855,STCTY-26125 TRACT-    0855     IN DETROIT MI ADJ AREA,6406,6404,2,5541,2,3540,33.71
G26012500856,STCTY-26125 TRACT-    0856     IN DETROIT MI ADJ AREA,9485,9470,15,8150,11,4536,41.1
G26012500857,STCTY-26125 TRACT-    0857     IN DETROIT MI ADJ AREA,5088,5073,15,4432,15,4733,43.16
G26012500858,STCTY-26125 TRACT-    0858     IN DETROIT MI ADJ AREA,2008,2001,7,1723,6,5316,47.9
G26012500859,STCTY-26125 TRACT-    0859     IN DETROIT MI ADJ AREA,935,930,5,777,5,4194,0
G26012500860,STCTY-26125 TRACT-    0860     IN DETROIT MI ADJ AREA,1002,1002,0,872,0,2310,0
G26012500861,STCTY-26125 TRACT-    0861     IN DETROIT MI ADJ AREA,2140,2140,0,1840,0,3706,34.03
G26012500862,STCTY-26125 TRACT-    0862     IN DETROIT MI ADJ AREA,4429,4429,0,3779,0,4105,38.41
G26012500863,STCTY-26125 TRACT-    0863     IN DETROIT MI ADJ AREA,20316,20307,9,17283,7,2420,28.28
G26012500864,STCTY-26125 TRACT-    0864     IN DETROIT MI ADJ AREA,4006,4004,2,3504,1,2803,30.25
G26012500865,STCTY-26125 TRACT-    0865     IN DETROIT MI ADJ AREA,1495,1494,1,1303,1,2579,37.21
G26012500866,STCTY-26125 TRACT-    0866     IN DETROIT MI ADJ AREA,4127,4121,6,3640,6,4164,47.95
G26012500867,STCTY-26125 TRACT-    0867     IN DETROIT MI ADJ AREA,3389,3285,104,3073,99,12618,84.92
G26012500868,STCTY-26125 TRACT-    0868     IN DETROIT MI ADJ AREA,2185,2164,21,2011,18,8231,68.67
G26016300001,STCTY-26163 TRACT-    0001     IN DETROIT MI,4321,4077,244,2886,184,0,5.83
G26016300002,STCTY-26163 TRACT-    0002     IN DETROIT MI,3481,3270,211,2284,179,0,23.19
G26016300003,STCTY-26163 TRACT-    0003     IN DETROIT MI,4808,4792,16,3716,6,2961,29.23
G26016300004,STCTY-26163 TRACT-    0004     IN DETROIT MI,1635,1435,200,1119,197,0,28.22
G26016300005,STCTY-26163 TRACT-    0005     IN DETROIT MI,4099,3969,130,3330,98,2324,28.22
G26016300006,STCTY-26163 TRACT-    0006     IN DETROIT MI,1325,1308,17,1045,17,0,35.6
G26016300007,STCTY-26163 TRACT-    0007     IN DETROIT MI,4976,4873,103,3997,91,2759,33.49
G26016300008,STCTY-26163 TRACT-    0008     IN DETROIT MI,3185,2969,216,2286,216,2414,32.55
G26016300009,STCTY-26163 TRACT-    0009     IN DETROIT MI,4015,3917,98,3024,89,2381,32.66
G26016300010,STCTY-26163 TRACT-    0010     IN DETROIT MI,4235,4183,52,3355,51,1868,29.68
G26016300011,STCTY-26163 TRACT-    0011     IN DETROIT MI,3479,2677,802,2223,800,2755,35.63
G26016300012,STCTY-26163 TRACT-    0012     IN DETROIT MI,3962,3531,431,2838,424,2288,31.46
G26016300013,STCTY-26163 TRACT-    0013     IN DETROIT MI,3864,1900,1964,1537,1957,2885,34.6
G26016300014,STCTY-26163 TRACT-    0014     IN DETROIT MI,3813,1554,2259,1204,2259,3106,37.79
G26016300015,STCTY-26163 TRACT-    0015     IN DETROIT MI,2879,568,2311,450,2311,3134,34.62
G26016300016,STCTY-26163 TRACT-    0016     IN DETROIT MI,3869,2977,892,2358,891,3310,39.54
G26016300017,STCTY-26163 TRACT-    0017     IN DETROIT MI,904,904,0,711,0,0,41.13
G26016300018,STCTY-26163 TRACT-    0018     IN DETROIT MI,2820,2811,9,2258,3,3825,43.32
G26016300019,STCTY-26163 TRACT-    0019     IN DETROIT MI,6706,6693,13,5492,11,3280,37.25
G26016300020,STCTY-26163 TRACT-    0020     IN DETROIT MI,2275,2263,12,1891,0,3292,32.17
G26016300021,STCTY-26163 TRACT-    0021     IN DETROIT MI,4367,4362,5,3483,5,3319,35.93
G26016300022,STCTY-26163 TRACT-    0022     IN DETROIT MI,2545,2516,29,2025,22,0,37.74
G26016300023,STCTY-26163 TRACT-    0023     IN DETROIT MI,170,170,0,149,0,0,0
G26016300024,STCTY-26163 TRACT-    0024     IN DETROIT MI,2976,2958,18,2430,12,0,31.04
G26016300025,STCTY-26163 TRACT-    0025     IN DETROIT MI,7467,7420,47,6105,32,3794,35.28
G26016300026,STCTY-26163 TRACT-    0026     IN DETROIT MI,5014,5003,11,4246,1,3158,30.09
G26016300027,STCTY-26163 TRACT-    0027     IN DETROIT MI,3985,3974,11,3367,10,3100,26
G26016300028,STCTY-26163 TRACT-    0028     IN DETROIT MI,6693,6320,373,5231,323,3410,29.77
G26016300029,STCTY-26163 TRACT-    0029     IN DETROIT MI,4372,4334,38,3613,31,0,31.59
G26016300030,STCTY-26163 TRACT-    0030     IN DETROIT MI,7557,7479,78,6387,19,0,30.43
G26016300031,STCTY-26163 TRACT-    0031     IN DETROIT MI,7646,7600,46,6332,26,0,32.34
G26016300032,STCTY-26163 TRACT-    0032     IN DETROIT MI,7425,7323,102,6000,25,0,32.55
G26016300033,STCTY-26163 TRACT-    0033     IN DETROIT MI,4809,4723,86,3422,30,0,27.05
G26016300034,STCTY-26163 TRACT-    0034     IN DETROIT MI,2704,2671,33,2176,3,0,23.69
G26016300035,STCTY-26163 TRACT-    0035     IN DETROIT MI,5407,5333,74,4272,36,2250,26.72
G26016300036,STCTY-26163 TRACT-    0036     IN DETROIT MI,3574,3449,125,2808,118,2632,28.66
G26016300037,STCTY-26163 TRACT-    0037     IN DETROIT MI,2732,2661,71,2098,46,2423,31.9
G26016300038,STCTY-26163 TRACT-    0038     IN DETROIT MI,4580,4567,13,3777,7,2197,32.29
G26016300039,STCTY-26163 TRACT-    0039     IN DETROIT MI,6534,6493,41,5522,12,2332,31.87
G26016300040,STCTY-26163 TRACT-    0040     IN DETROIT MI,4095,4064,31,3344,31,4438,30.19
G26016300041,STCTY-26163 TRACT-    0041     IN DETROIT MI,4235,4210,25,3496,20,2399,30.67
G26016300042,STCTY-26163 TRACT-    0042     IN DETROIT MI,3147,2974,173,2486,170,2386,31.91
G26016300043,STCTY-26163 TRACT-    0043     IN DETROIT MI,6075,5966,109,4933,106,2759,31.87
G26016300051,STCTY-26163 TRACT-    0051     IN DETROIT MI,3304,3069,235,2569,234,2068,31.45
G26016300052,STCTY-26163 TRACT-    0052     IN DETROIT MI,3519,3510,9,2538,9,2621,32.86
G26016300053,STCTY-26163 TRACT-    0053     IN DETROIT MI,4719,4400,319,2874,319,2369,29.67
G26016300054,STCTY-26163 TRACT-    0054     IN DETROIT MI,5919,5699,220,3390,213,2245,27.69
G26016300055,STCTY-26163 TRACT-    0055     IN DETROIT MI,6034,5580,454,3810,454,2175,27.52
G26016300056,STCTY-26163 TRACT-    0056     IN DETROIT MI,2290,2272,18,1698,16,2285,30.62
G26016300057,STCTY-26163 TRACT-    0057     IN DETROIT MI,4986,4982,4,3411,3,3158,34.83
G26016300058,STCTY-26163 TRACT-    0058     IN DETROIT MI,10,10,0,6,0,0,0
G26016300059,STCTY-26163 TRACT-    0059     IN DETROIT MI,5993,5984,9,4641,8,3110,35.44
G26016300060,STCTY-26163 TRACT-    0060     IN DETROIT MI,9173,9168,5,7276,0,3493,39.09
G26016300061,STCTY-26163 TRACT-    0061     IN DETROIT MI,7004,6996,8,5687,5,3346,39.5
G26016300062,STCTY-26163 TRACT-    0062     IN DETROIT MI,2962,2962,0,2348,0,3723,40.33
G26016300063,STCTY-26163 TRACT-    0063     IN DETROIT MI,2215,2208,7,1826,0,3350,42.41
G26016300064,STCTY-26163 TRACT-    0064     IN DETROIT MI,1407,1325,82,1016,82,2114,26.56
G26016300065,STCTY-26163 TRACT-    0065     IN DETROIT MI,3410,3394,16,2516,3,1995,31.05
G26016300066,STCTY-26163 TRACT-    0066     IN DETROIT MI,5881,5735,146,4576,139,2710,35.64
G26016300067,STCTY-26163 TRACT-    0067     IN DETROIT MI,6809,6796,13,5663,9,3816,40.02
G26016300068,STCTY-26163 TRACT-    0068     IN DETROIT MI,6230,6217,13,5167,12,3030,34.9
G26016300069,STCTY-26163 TRACT-    0069     IN DETROIT MI,4527,4526,1,3736,0,2806,35.7
G26016300070,STCTY-26163 TRACT-    0070     IN DETROIT MI,5531,5527,4,4560,0,3194,38.27
G26016300071,STCTY-26163 TRACT-    0071     IN DETROIT MI,4459,4459,0,3503,0,3631,41.43
G26016300072,STCTY-26163 TRACT-    0072     IN DETROIT MI,2044,2043,1,1673,1,2933,36.71
G26016300073,STCTY-26163 TRACT-    0073     IN DETROIT MI,3439,3439,0,2633,0,3285,36.84
G26016300074,STCTY-26163 TRACT-    0074     IN DETROIT MI,1821,1819,2,1307,2,2597,33.85
G26016300075,STCTY-26163 TRACT-    0075     IN DETROIT MI,3548,3548,0,2760,0,3734,38.22
G26016300076,STCTY-26163 TRACT-    0076     IN DETROIT MI,2536,2536,0,1890,0,3730,37.09
G26016300101,STCTY-26163 TRACT-    0101     IN DETROIT MI,4753,4737,16,3512,16,2303,25.54
G26016300102,STCTY-26163 TRACT-    0102     IN DETROIT MI,1324,1324,0,993,0,2167,23.62
G26016300103,STCTY-26163 TRACT-    0103     IN DETROIT MI,6389,6350,39,4613,39,2441,30.49
G26016300104,STCTY-26163 TRACT-    0104     IN DETROIT MI,4720,4715,5,3278,0,2522,28.9
G26016300105,STCTY-26163 TRACT-    0105     IN DETROIT MI,5787,5378,409,4027,408,2899,33.29
G26016300106,STCTY-26163 TRACT-    0106     IN DETROIT MI,5176,5176,0,3824,0,3095,35.52
G26016300107,STCTY-26163 TRACT-    0107     IN DETROIT MI,5247,5214,33,3782,33,2889,37.88
G26016300108,STCTY-26163 TRACT-    0108     IN DETROIT MI,5161,5157,4,3487,4,2559,33.53
G26016300109,STCTY-26163 TRACT-    0109     IN DETROIT MI,4986,4981,5,3564,5,2909,35.21
G26016300110,STCTY-26163 TRACT-    0110     IN DETROIT MI,1986,1974,12,1404,8,3218,37.04
G26016300111,STCTY-26163 TRACT-    0111     IN DETROIT MI,4047,2976,1071,2155,1071,3516,38.73
G26016300112,STCTY-26163 TRACT-    0112     IN DETROIT MI,3327,3327,0,2558,0,3311,40.67
G26016300113,STCTY-26163 TRACT-    0113     IN DETROIT MI,2335,2334,1,1771,0,3362,38.55
G26016300114,STCTY-26163 TRACT-    0114     IN DETROIT MI,7381,7368,13,5689,13,2427,33.55
G26016300115,STCTY-26163 TRACT-    0115     IN DETROIT MI,5402,5365,37,3853,28,1952,27.81
G26016300116,STCTY-26163 TRACT-    0116     IN DETROIT MI,5605,5574,31,4154,24,2277,30.96
G26016300117,STCTY-26163 TRACT-    0117     IN DETROIT MI,3219,3201,18,2468,10,2219,29.47
G26016300118,STCTY-26163 TRACT-    0118     IN DETROIT MI,1903,915,988,698,987,2927,39.05
G26016300119,STCTY-26163 TRACT-    0119     IN DETROIT MI,3872,449,3423,317,3423,2924,39.8
G26016300120,STCTY-26163 TRACT-    0120     IN DETROIT MI,4792,478,4314,389,4313,3238,41.14
G26016300121,STCTY-26163 TRACT-    0121     IN DETROIT MI,5268,814,4454,655,4454,2906,39.44
G26016300122,STCTY-26163 TRACT-    0122     IN DETROIT MI,4592,4121,471,3300,469,2484,35.47
G26016300123,STCTY-26163 TRACT-    0123     IN DETROIT MI,3891,3824,67,3017,67,2348,30.97
G26016300151,STCTY-26163 TRACT-    0151     IN DETROIT MI,6495,6471,24,5407,21,6691,45.98
G26016300152,STCTY-26163 TRACT-    0152     IN DETROIT MI,3975,3958,17,3228,6,0,44.71
G26016300153,STCTY-26163 TRACT-    0153     IN DETROIT MI,9169,9151,18,7071,12,4163,41.41
G26016300154,STCTY-26163 TRACT-    0154     IN DETROIT MI,7227,7205,22,5490,17,5573,42.98
G26016300155,STCTY-26163 TRACT-    0155     IN DETROIT MI,5927,5921,6,4786,6,4435,45.58
G26016300156,STCTY-26163 TRACT-    0156     IN DETROIT MI,1960,1957,3,1626,3,4821,50.51
G26016300157,STCTY-26163 TRACT-    0157     IN DETROIT MI,4673,4387,286,3561,285,4672,46.9
G26016300158,STCTY-26163 TRACT-    0158     IN DETROIT MI,2695,2576,119,2110,115,3162,43.73
G26016300159,STCTY-26163 TRACT-    0159     IN DETROIT MI,3945,3941,4,3234,3,4608,43.43
G26016300160,STCTY-26163 TRACT-    0160     IN DETROIT MI,2783,2773,10,2255,1,4408,43.82
G26016300161,STCTY-26163 TRACT-    0161     IN DETROIT MI,5382,5381,1,4335,1,4724,45.79
G26016300162,STCTY-26163 TRACT-    0162     IN DETROIT MI,3844,3844,0,3163,0,4663,51.72
G26016300163,STCTY-26163 TRACT-    0163     IN DETROIT MI,4912,4912,0,3904,0,5055,47.52
G26016300164,STCTY-26163 TRACT-    0164     IN DETROIT MI,6751,6749,2,4778,1,3181,43.31
G26016300165,STCTY-26163 TRACT-    0165     IN DETROIT MI,3580,3578,2,2696,2,3824,44.24
G26016300166,STCTY-26163 TRACT-    0166     IN DETROIT MI,4868,4863,5,3593,3,3551,43.5
G26016300167,STCTY-26163 TRACT-    0167     IN DETROIT MI,4464,4450,14,2769,6,3388,42.79
G26016300168,STCTY-26163 TRACT-    0168     IN DETROIT MI,5960,5924,36,4224,36,7303,48.05
G26016300169,STCTY-26163 TRACT-    0169     IN DETROIT MI,4724,4710,14,3571,14,5613,50.2
G26016300170,STCTY-26163 TRACT-    0170     IN DETROIT MI,7597,7587,10,5663,4,3780,43.57
G26016300171,STCTY-26163 TRACT-    0171     IN DETROIT MI,6265,6240,25,4869,15,4483,46.02
G26016300172,STCTY-26163 TRACT-    0172     IN DETROIT MI,5738,5677,61,4234,61,3964,44.53
G26016300173,STCTY-26163 TRACT-    0173     IN DETROIT MI,4154,3564,590,2531,590,3183,40.41
G26016300174,STCTY-26163 TRACT-    0174     IN DETROIT MI,4433,3391,1042,2451,1041,3168,38.8
G26016300175,STCTY-26163 TRACT-    0175     IN DETROIT MI,4754,4729,25,3599,15,3554,38.43
G26016300176,STCTY-26163 TRACT-    0176     IN DETROIT MI,27392,27289,103,18191,94,4475,47.86
G26016300177,STCTY-26163 TRACT-    0177     IN DETROIT MI,4460,4444,16,2831,14,6192,59.23
G26016300178,STCTY-26163 TRACT-    0178     IN DETROIT MI,5719,5707,12,4262,12,5562,50.43
G26016300179,STCTY-26163 TRACT-    0179     IN DETROIT MI,4362,4357,5,3341,5,5264,44.74
G26016300180,STCTY-26163 TRACT-    0180     IN DETROIT MI,7504,7488,16,4649,15,4669,45.08
G26016300181,STCTY-26163 TRACT-    0181     IN DETROIT MI,4059,4001,58,3184,51,9877,47.96
G26016300182,STCTY-26163 TRACT-    0182     IN DETROIT MI,3625,3608,17,2424,14,5464,48.26
G26016300183,STCTY-26163 TRACT-    0183     IN DETROIT MI,4220,4207,13,3164,13,4954,43.53
G26016300184,STCTY-26163 TRACT-    0184     IN DETROIT MI,5216,5204,12,4139,10,4556,45.67
G26016300185,STCTY-26163 TRACT-    0185     IN DETROIT MI,4869,4838,31,3030,27,8043,47.69
G26016300186,STCTY-26163 TRACT-    0186     IN DETROIT MI,3304,3262,42,2673,37,9601,45.87
G26016300187,STCTY-26163 TRACT-    0187     IN DETROIT MI,6570,6555,15,3850,14,3358,37.76
G26016300188,STCTY-26163 TRACT-    0188     IN DETROIT MI,5269,5127,142,3814,133,4155,38.77
G26016300189,STCTY-26163 TRACT-    0189     IN DETROIT MI,7120,7106,14,5907,9,5461,46.77
G26016300190,STCTY-26163 TRACT-    0190     IN DETROIT MI,1959,1907,52,1575,45,8351,44.65
G26016300191,STCTY-26163 TRACT-    0191     IN DETROIT MI,3084,3063,21,2550,18,6600,56.86
G26016300201,STCTY-26163 TRACT-    0201     IN DETROIT MI,5612,5612,0,4479,0,3502,40.52
G26016300202,STCTY-26163 TRACT-    0202     IN DETROIT MI,3253,3253,0,2568,0,3743,42.71
G26016300203,STCTY-26163 TRACT-    0203     IN DETROIT MI,5591,5588,3,4626,3,5446,49.15
G26016300204,STCTY-26163 TRACT-    0204     IN DETROIT MI,2957,2957,0,2539,0,5550,53.95
G26016300205,STCTY-26163 TRACT-    0205     IN DETROIT MI,1978,1978,0,1680,0,4698,41.29
G26016300206,STCTY-26163 TRACT-    0206     IN DETROIT MI,2636,2635,1,2182,1,5757,0
G26016300207,STCTY-26163 TRACT-    0207     IN DETROIT MI,5125,5116,9,4099,2,4471,42.29
G26016300208,STCTY-26163 TRACT-    0208     IN DETROIT MI,4015,4005,10,3303,3,4219,46.48
G26016300209,STCTY-26163 TRACT-    0209     IN DETROIT MI,5261,5261,0,4313,0,5097,48.04
G26016300210,STCTY-26163 TRACT-    0210     IN DETROIT MI,4471,4467,4,3782,2,4382,47.71
G26016300211,STCTY-26163 TRACT-    0211     IN DETROIT MI,1886,1886,0,1510,0,4260,44.88
G26016300212,STCTY-26163 TRACT-    0212     IN DETROIT MI,3106,3102,4,2515,4,3456,44.32
G26016300213,STCTY-26163 TRACT-    0213     IN DETROIT MI,2748,2747,1,2305,1,4609,46.61
G26016300251,STCTY-26163 TRACT-    0251     IN DETROIT MI,3899,3895,4,3234,4,4878,51.55
G26016300252,STCTY-26163 TRACT-    0252     IN DETROIT MI,6364,6360,4,5422,4,4857,52.29
G26016300253,STCTY-26163 TRACT-    0253     IN DETROIT MI,5899,5898,1,4895,1,4960,53.02
G26016300254,STCTY-26163 TRACT-    0254     IN DETROIT MI,4631,4631,0,3796,0,4168,42.85
G26016300255,STCTY-26163 TRACT-    0255     IN DETROIT MI,979,979,0,804,0,5314,48.83
G26016300256,STCTY-26163 TRACT-    0256     IN DETROIT MI,5540,5537,3,4658,3,5246,52.14
G26016300257,STCTY-26163 TRACT-    0257     IN DETROIT MI,7874,7870,4,6630,0,5152,49.33
G26016300258,STCTY-26163 TRACT-    0258     IN DETROIT MI,5111,5110,1,4239,1,5628,48.13
G26016300259,STCTY-26163 TRACT-    0259     IN DETROIT MI,9512,9503,9,7941,4,5451,51.47
G26016300260,STCTY-26163 TRACT-    0260     IN DETROIT MI,4021,4018,3,3394,0,4938,51.52
G26016300261,STCTY-26163 TRACT-    0261     IN DETROIT MI,11559,11541,18,9332,1,3904,43.96
G26016300262,STCTY-26163 TRACT-    0262     IN DETROIT MI,4728,4722,6,3924,6,6162,53.95
G26016300263,STCTY-26163 TRACT-    0263     IN DETROIT MI,9080,9072,8,7065,2,4171,45.24
G26016300264,STCTY-26163 TRACT-    0264     IN DETROIT MI,6813,6778,35,5638,12,4819,51.93
G26016300301,STCTY-26163 TRACT-    0301     IN DETROIT MI,7265,7089,176,6204,173,15721,64.54
G26016300302,STCTY-26163 TRACT-    0302     IN DETROIT MI,12336,12260,76,10417,76,8111,75.65
G26016300303,STCTY-26163 TRACT-    0303     IN DETROIT MI,3007,3000,7,2557,6,7007,0
G26016300304,STCTY-26163 TRACT-    0304     IN DETROIT MI,653,652,1,566,1,6767,0
G26016300305,STCTY-26163 TRACT-    0305     IN DETROIT MI,3468,1583,1885,1294,1885,2646,32.31
G26016300306,STCTY-26163 TRACT-    0306     IN DETROIT MI,2203,2197,6,1844,5,7169,37.04
G26016300307,STCTY-26163 TRACT-    0307     IN DETROIT MI,3725,3596,129,3165,125,14661,97.71
G26016300351,STCTY-26163 TRACT-    0351     IN DETROIT MI,3751,3751,0,2964,0,3908,37.41
G26016300352,STCTY-26163 TRACT-    0352     IN DETROIT MI,4949,4939,10,3846,2,2880,35.99
G26016300353,STCTY-26163 TRACT-    0353     IN DETROIT MI,510,510,0,404,0,0,0
G26016300354,STCTY-26163 TRACT-    0354     IN DETROIT MI,189,189,0,156,0,0,0
G26016300355,STCTY-26163 TRACT-    0355     IN DETROIT MI,145,145,0,131,0,0,0
G26016300356,STCTY-26163 TRACT-    0356     IN DETROIT MI,764,764,0,608,0,2875,0
G26016300357,STCTY-26163 TRACT-    0357     IN DETROIT MI,624,621,3,501,0,4257,0
G26016300358,STCTY-26163 TRACT-    0358     IN DETROIT MI,6887,6886,1,5738,1,4272,38.78
G26016300359,STCTY-26163 TRACT-    0359     IN DETROIT MI,916,916,0,771,0,2161,0
G26016300401,STCTY-26163 TRACT-    0401     IN DETROIT MI,4524,4518,6,4019,3,6787,58.82
G26016300402,STCTY-26163 TRACT-    0402     IN DETROIT MI,2556,2554,2,2181,2,4703,0
G26016300403,STCTY-26163 TRACT-    0403     IN DETROIT MI,3812,3812,0,3274,0,2315,31.69
G26016300404,STCTY-26163 TRACT-    0404     IN DETROIT MI,2382,2382,0,2005,0,2681,36.04
G26016300405,STCTY-26163 TRACT-    0405     IN DETROIT MI,4477,4477,0,3833,0,2546,31.68
G26016300406,STCTY-26163 TRACT-    0406     IN DETROIT MI,3794,3790,4,3354,4,7898,0
G26016300407,STCTY-26163 TRACT-    0407     IN DETROIT MI,2601,2595,6,2277,6,8066,63.7
G26016300408,STCTY-26163 TRACT-    0408     IN DETROIT MI,2603,2603,0,2275,0,6099,56.31
G26016300409,STCTY-26163 TRACT-    0409     IN DETROIT MI,6308,6306,2,5403,2,6249,56.29
G26016300410,STCTY-26163 TRACT-    0410     IN DETROIT MI,4058,4019,39,3604,35,9872,89.36
G26016300411,STCTY-26163 TRACT-    0411     IN DETROIT MI,1357,1354,3,1181,3,7279,0
G26016300412,STCTY-26163 TRACT-    0412     IN DETROIT MI,2363,2363,0,2054,0,5262,43.99
G26016300413,STCTY-26163 TRACT-    0413     IN DETROIT MI,844,843,1,728,1,7414,0
G26016300414,STCTY-26163 TRACT-    0414     IN DETROIT MI,2110,2110,0,1771,0,4170,45
G26016300415,STCTY-26163 TRACT-    0415     IN DETROIT MI,4230,4224,6,3591,0,2930,32.63
G26016300451,STCTY-26163 TRACT-    0451     IN DETROIT MI,2844,2844,0,2330,0,3770,36.42
G26016300452,STCTY-26163 TRACT-    0452     IN DETROIT MI,457,455,2,396,2,5820,0
G26016300453,STCTY-26163 TRACT-    0453     IN DETROIT MI,5084,5083,1,4336,1,4232,45.31
G26016300454,STCTY-26163 TRACT-    0454     IN DETROIT MI,1737,1735,2,1486,2,4682,46.02
G26016300455,STCTY-26163 TRACT-    0455     IN DETROIT MI,1708,1707,1,1411,1,4914,48.14
G26016300456,STCTY-26163 TRACT-    0456     IN DETROIT MI,1345,1341,4,1140,1,3060,0
G26016300457,STCTY-26163 TRACT-    0457     IN DETROIT MI,483,483,0,409,0,0,0
G26016300458,STCTY-26163 TRACT-    0458     IN DETROIT MI,500,500,0,417,0,0,0
G26016300459,STCTY-26163 TRACT-    0459     IN DETROIT MI,666,666,0,582,0,3906,0
G26016300501,STCTY-26163 TRACT-    0501     IN DETROIT MI,2834,2824,10,2271,7,2795,30.25
G26016300502,STCTY-26163 TRACT-    0502     IN DETROIT MI,2269,2160,109,1561,107,0,25.78
G26016300503,STCTY-26163 TRACT-    0503     IN DETROIT MI,3361,2339,1022,1623,1012,1890,26.63
G26016300504,STCTY-26163 TRACT-    0504     IN DETROIT MI,3917,2072,1845,1554,1837,0,28
G26016300505,STCTY-26163 TRACT-    0505     IN DETROIT MI,2743,1172,1571,882,1563,0,23.24
G26016300506,STCTY-26163 TRACT-    0506     IN DETROIT MI,3760,2779,981,1767,957,0,25.32
G26016300507,STCTY-26163 TRACT-    0507     IN DETROIT MI,1614,1509,105,939,104,0,0
G26016300508,STCTY-26163 TRACT-    0508     IN DETROIT MI,3362,917,2445,573,2444,0,26.68
G26016300509,STCTY-26163 TRACT-    0509     IN DETROIT MI,3452,283,3169,185,3168,0,29.22
G26016300510,STCTY-26163 TRACT-    0510     IN DETROIT MI,3218,749,2469,547,2469,2118,31.34
G26016300511,STCTY-26163 TRACT-    0511     IN DETROIT MI,3590,305,3285,194,3285,2102,31.98
G26016300512,STCTY-26163 TRACT-    0512     IN DETROIT MI,5089,1005,4084,697,4083,2417,29.84
G26016300513,STCTY-26163 TRACT-    0513     IN DETROIT MI,2840,1370,1470,954,1464,1695,32.13
G26016300514,STCTY-26163 TRACT-    0514     IN DETROIT MI,4112,3741,371,2562,369,2221,33.05
G26016300515,STCTY-26163 TRACT-    0515     IN DETROIT MI,4767,3113,1654,2198,1654,2362,31.89
G26016300516,STCTY-26163 TRACT-    0516     IN DETROIT MI,3983,2165,1818,1428,1818,2285,31.41
G26016300517,STCTY-26163 TRACT-    0517     IN DETROIT MI,3141,3017,124,2287,122,2000,32.25
G26016300518,STCTY-26163 TRACT-    0518     IN DETROIT MI,3194,3185,9,2428,8,3559,40.83
G26016300519,STCTY-26163 TRACT-    0519     IN DETROIT MI,4628,4499,129,3412,129,3140,36.58
G26016300520,STCTY-26163 TRACT-    0520     IN DETROIT MI,4743,4549,194,3545,194,3029,39.19
G26016300521,STCTY-26163 TRACT-    0521     IN DETROIT MI,5554,5500,54,4482,51,2561,35.28
G26016300522,STCTY-26163 TRACT-    0522     IN DETROIT MI,5298,5298,0,4150,0,2400,33.1
G26016300523,STCTY-26163 TRACT-    0523     IN DETROIT MI,6415,6291,124,4863,124,2278,32.64
G26016300524,STCTY-26163 TRACT-    0524     IN DETROIT MI,4155,4096,59,2734,59,2259,33.27
G26016300525,STCTY-26163 TRACT-    0525     IN DETROIT MI,6833,6563,270,4611,270,1967,30.3
G26016300526,STCTY-26163 TRACT-    0526     IN DETROIT MI,4088,2397,1691,1555,1686,2254,27.32
G26016300527,STCTY-26163 TRACT-    0527     IN DETROIT MI,1344,508,836,346,836,0,27.13
G26016300528,STCTY-26163 TRACT-    0528     IN DETROIT MI,4568,165,4403,101,4395,0,33.57
G26016300529,STCTY-26163 TRACT-    0529     IN DETROIT MI,4797,61,4736,31,4732,0,29.92
G26016300530,STCTY-26163 TRACT-    0530     IN DETROIT MI,1142,831,311,595,309,0,0
G26016300531,STCTY-26163 TRACT-    0531     IN DETROIT MI,7612,4853,2759,3569,2707,0,25.88
G26016300532,STCTY-26163 TRACT-    0532     IN DETROIT MI,4687,3123,1564,2432,1545,0,27.98
G26016300533,STCTY-26163 TRACT-    0533     IN DETROIT MI,5167,2356,2811,1898,2805,0,35.87
G26016300534,STCTY-26163 TRACT-    0534     IN DETROIT MI,3671,225,3446,176,3439,0,31.62
G26016300535,STCTY-26163 TRACT-    0535     IN DETROIT MI,3253,10,3243,8,3243,0,20.03
G26016300536,STCTY-26163 TRACT-    0536     IN DETROIT MI,3619,145,3474,96,3473,0,32.27
G26016300537,STCTY-26163 TRACT-    0537     IN DETROIT MI,5369,1406,3963,1085,3962,1735,28.29
G26016300538,STCTY-26163 TRACT-    0538     IN DETROIT MI,4391,2378,2013,1830,2013,1808,26.17
G26016300539,STCTY-26163 TRACT-    0539     IN DETROIT MI,5421,4196,1225,3245,1225,1633,24.59
G26016300540,STCTY-26163 TRACT-    0540     IN DETROIT MI,2873,2872,1,2145,0,2059,29.84
G26016300541,STCTY-26163 TRACT-    0541     IN DETROIT MI,3651,3451,200,2628,200,1362,24.1
G26016300542,STCTY-26163 TRACT-    0542     IN DETROIT MI,2776,2009,767,1098,767,2300,28.78
G26016300543,STCTY-26163 TRACT-    0543     IN DETROIT MI,7512,1687,5825,852,5803,2330,34.59
G26016300544,STCTY-26163 TRACT-    0544     IN DETROIT MI,7652,220,7432,141,7428,0,37.61
G26016300545,STCTY-26163 TRACT-    0545     IN DETROIT MI,7757,2625,5132,2156,5132,0,40.96
G26016300546,STCTY-26163 TRACT-    0546     IN DETROIT MI,4680,2187,2493,1762,2476,0,34.05
G26016300547,STCTY-26163 TRACT-    0547     IN DETROIT MI,1515,441,1074,322,1074,0,33.64
G26016300548,STCTY-26163 TRACT-    0548     IN DETROIT MI,5587,5506,81,4053,79,2187,27.43
G26016300549,STCTY-26163 TRACT-    0549     IN DETROIT MI,3608,3477,131,2494,129,1990,24.1
G26016300550,STCTY-26163 TRACT-    0550     IN DETROIT MI,6569,6569,0,4775,0,2417,31.16
G26016300551,STCTY-26163 TRACT-    0551     IN DETROIT MI,4325,4174,151,3584,141,4000,33.32
G26016300552,STCTY-26163 TRACT-    0552     IN DETROIT MI,3867,3023,844,2524,834,4647,40.28
G26016300553,STCTY-26163 TRACT-    0553     IN DETROIT MI,11419,9812,1607,7413,1578,4246,40.58
G26016300554,STCTY-26163 TRACT-    0554     IN DETROIT MI,1829,1025,804,635,804,2438,33.74
G26016300555,STCTY-26163 TRACT-    0555     IN DETROIT MI,3150,1479,1671,836,1639,1826,33.81
G26016300556,STCTY-26163 TRACT-    0556     IN DETROIT MI,5138,2105,3033,1143,2990,2314,35.59
G26016300557,STCTY-26163 TRACT-    0557     IN DETROIT MI,5364,2369,2995,1917,2987,3488,41.37
G26016300558,STCTY-26163 TRACT-    0558     IN DETROIT MI,6943,1652,5291,1320,5289,2645,34.35
G26016300559,STCTY-26163 TRACT-    0559     IN DETROIT MI,4038,1892,2146,1404,2141,2218,30.58
G26016300560,STCTY-26163 TRACT-    0560     IN DETROIT MI,3206,2777,429,2095,429,2469,31.25
G26016300561,STCTY-26163 TRACT-    0561     IN DETROIT MI,4444,4444,0,3275,0,2427,33.57
G26016300562,STCTY-26163 TRACT-    0562     IN DETROIT MI,6438,6130,308,4333,308,2939,34.62
G26016300563,STCTY-26163 TRACT-    0563     IN DETROIT MI,3718,3717,1,2547,1,3302,37.7
G26016300564,STCTY-26163 TRACT-    0564     IN DETROIT MI,3730,3730,0,2673,0,3572,37.63
G26016300565,STCTY-26163 TRACT-    0565     IN DETROIT MI,3690,3690,0,2929,0,3260,36.68
G26016300566,STCTY-26163 TRACT-    0566     IN DETROIT MI,5269,5265,4,4187,4,2754,33.27
G26016300567,STCTY-26163 TRACT-    0567     IN DETROIT MI,3647,3647,0,2844,0,3752,38.2
G26016300568,STCTY-26163 TRACT-    0568     IN DETROIT MI,3458,3458,0,2748,0,3161,35.66
G26016300569,STCTY-26163 TRACT-    0569     IN DETROIT MI,3413,3407,6,2854,6,2743,32.96
G26016300570,STCTY-26163 TRACT-    0570     IN DETROIT MI,7696,7656,40,5773,33,2352,30.72
G26016300571,STCTY-26163 TRACT-    0571     IN DETROIT MI,13046,10782,2264,6889,2263,2631,33.39
G26016300572,STCTY-26163 TRACT-    0572     IN DETROIT MI,11372,8020,3352,5082,3350,2382,29.93
G26016300601,STCTY-26163 TRACT-    0601     IN DETROIT MI,3504,3503,1,2759,1,3541,35.9
G26016300602,STCTY-26163 TRACT-    0602     IN DETROIT MI,4333,4140,193,2920,193,2898,37.22
G26016300603,STCTY-26163 TRACT-    0603     IN DETROIT MI,5039,3710,1329,2893,1329,3593,36.62
G26016300604,STCTY-26163 TRACT-    0604     IN DETROIT MI,4379,3768,611,2682,610,2820,34.96
G26016300605,STCTY-26163 TRACT-    0605     IN DETROIT MI,3532,3321,211,2482,210,3152,38.36
G26016300606,STCTY-26163 TRACT-    0606     IN DETROIT MI,7181,7181,0,5441,0,3370,36.39
G26016300607,STCTY-26163 TRACT-    0607     IN DETROIT MI,6149,6144,5,4489,2,2899,35.63
G26016300608,STCTY-26163 TRACT-    0608     IN DETROIT MI,3501,3501,0,2652,0,5750,45.87
G26016300609,STCTY-26163 TRACT-    0609     IN DETROIT MI,3760,3759,1,2930,1,3985,47.61
G26016300610,STCTY-26163 TRACT-    0610     IN DETROIT MI,4594,4594,0,3595,0,3398,38.78
G26016300611,STCTY-26163 TRACT-    0611     IN DETROIT MI,2077,2077,0,1693,0,3228,40.9
G26016300612,STCTY-26163 TRACT-    0612     IN DETROIT MI,7075,7075,0,5793,0,3678,42.16
G26016300613,STCTY-26163 TRACT-    0613     IN DETROIT MI,5693,5692,1,4708,1,3803,42.65
G26016300614,STCTY-26163 TRACT-    0614     IN DETROIT MI,2259,2259,0,1778,0,3693,40.33
G26016300615,STCTY-26163 TRACT-    0615     IN DETROIT MI,2060,2060,0,1716,0,3505,38.41
G26016300616,STCTY-26163 TRACT-    0616     IN DETROIT MI,2427,2427,0,1920,0,4750,41.01
G26016300651,STCTY-26163 TRACT-    0651     IN DETROIT MI,2300,2300,0,1858,0,4347,47.21
G26016300652,STCTY-26163 TRACT-    0652     IN DETROIT MI,3946,3946,0,3213,0,5186,46.21
G26016300653,STCTY-26163 TRACT-    0653     IN DETROIT MI,3685,3684,1,2925,0,5060,45.46
G26016300654,STCTY-26163 TRACT-    0654     IN DETROIT MI,5081,5066,15,4035,12,4503,42.45
G26016300655,STCTY-26163 TRACT-    0655     IN DETROIT MI,1644,1644,0,1206,0,2423,36.19
G26016300656,STCTY-26163 TRACT-    0656     IN DETROIT MI,4336,4336,0,3612,0,5669,47.9
G26016300657,STCTY-26163 TRACT-    0657     IN DETROIT MI,1210,1210,0,980,0,5094,47.07
G26016300658,STCTY-26163 TRACT-    0658     IN DETROIT MI,2219,2219,0,1705,0,3621,41.56
G26016300659,STCTY-26163 TRACT-    0659     IN DETROIT MI,3724,3720,4,2956,0,4049,42.74
G26016300660,STCTY-26163 TRACT-    0660     IN DETROIT MI,5594,5589,5,4505,0,5168,44.26
G26016300661,STCTY-26163 TRACT-    0661     IN DETROIT MI,7209,7205,4,5822,4,3660,38.41
G26016300662,STCTY-26163 TRACT-    0662     IN DETROIT MI,4691,4553,138,3504,137,2810,35.88
G26016300663,STCTY-26163 TRACT-    0663     IN DETROIT MI,5826,5809,17,4310,17,2914,36.74
G26016300664,STCTY-26163 TRACT-    0664     IN DETROIT MI,2315,2313,2,1819,2,3074,38.05
G26016300665,STCTY-26163 TRACT-    0665     IN DETROIT MI,3179,3179,0,2432,0,2838,39.06
G26016300666,STCTY-26163 TRACT-    0666     IN DETROIT MI,2714,2714,0,2220,0,4260,41.48
G26016300667,STCTY-26163 TRACT-    0667     IN DETROIT MI,1220,1220,0,1022,0,5873,0
G26016300668,STCTY-26163 TRACT-    0668     IN DETROIT MI,1421,1420,1,1169,0,5014,44.89
G26016300669,STCTY-26163 TRACT-    0669     IN DETROIT MI,2348,2348,0,1841,0,3841,35.55
G26016300670,STCTY-26163 TRACT-    0670     IN DETROIT MI,4770,4765,5,3992,1,4778,44.95
G26016300671,STCTY-26163 TRACT-    0671     IN DETROIT MI,3317,3317,0,2668,0,4213,40.73
G26016300701,STCTY-26163 TRACT-    0701     IN DETROIT MI,5454,5454,0,4045,0,3816,45.55
G26016300702,STCTY-26163 TRACT-    0702     IN DETROIT MI,6819,6819,0,5332,0,5305,53.07
G26016300703,STCTY-26163 TRACT-    0703     IN DETROIT MI,9253,9251,2,7610,0,5963,49.45
G26016300704,STCTY-26163 TRACT-    0704     IN DETROIT MI,2647,2647,0,2225,0,4836,43.76
G26016300705,STCTY-26163 TRACT-    0705     IN DETROIT MI,6900,6881,19,5752,0,4527,44.15
G26016300706,STCTY-26163 TRACT-    0706     IN DETROIT MI,5503,5500,3,4626,2,4232,43.13
G26016300707,STCTY-26163 TRACT-    0707     IN DETROIT MI,3364,3364,0,2732,0,4599,42.37
G26016300708,STCTY-26163 TRACT-    0708     IN DETROIT MI,2193,2193,0,1865,0,5852,51.8
G26016300709,STCTY-26163 TRACT-    0709     IN DETROIT MI,4300,4299,1,3717,1,7658,65.78
G26016300710,STCTY-26163 TRACT-    0710     IN DETROIT MI,2557,2557,0,1979,0,4067,38.71
G26016300711,STCTY-26163 TRACT-    0711     IN DETROIT MI,2380,2380,0,1795,0,2866,36.75
G26016300712,STCTY-26163 TRACT-    0712     IN DETROIT MI,4487,4483,4,3959,4,7881,68.01
G26016300713,STCTY-26163 TRACT-    0713     IN DETROIT MI,3544,3540,4,3019,4,6483,59.17
G26016300751,STCTY-26163 TRACT-    0751     IN DETROIT MI,3821,3809,12,3304,12,4055,51.97
G26016300752,STCTY-26163 TRACT-    0752     IN DETROIT MI,3887,3869,18,3218,14,5541,44.2
G26016300753,STCTY-26163 TRACT-    0753     IN DETROIT MI,5580,5576,4,4606,4,4841,44.81
G26016300754,STCTY-26163 TRACT-    0754     IN DETROIT MI,11999,11401,598,9244,493,3530,40.01
G26016300755,STCTY-26163 TRACT-    0755     IN DETROIT MI,3889,3801,88,3253,86,2719,30.9
G26016300756,STCTY-26163 TRACT-    0756     IN DETROIT MI,5264,5250,14,4302,5,2920,38.06
G26016300757,STCTY-26163 TRACT-    0757     IN DETROIT MI,7387,7345,42,5969,34,2648,42.74
G26016300758,STCTY-26163 TRACT-    0758     IN DETROIT MI,3393,3335,58,2870,50,9375,72.64
G26016300759,STCTY-26163 TRACT-    0759     IN DETROIT MI,6272,6241,31,5115,14,3215,41.36
G26016300760,STCTY-26163 TRACT-    0760     IN DETROIT MI,4402,4386,16,3464,16,3669,40.14
G26016300761,STCTY-26163 TRACT-    0761     IN DETROIT MI,2983,2877,106,2381,105,4860,39.44
G26016300762,STCTY-26163 TRACT-    0762     IN DETROIT MI,6058,5994,64,4715,64,3673,36.36
G26016300763,STCTY-26163 TRACT-    0763     IN DETROIT MI,7318,7292,26,5904,20,3169,39.23
G26016300764,STCTY-26163 TRACT-    0764     IN DETROIT MI,5331,5291,40,4398,40,3851,39.32
G26016300765,STCTY-26163 TRACT-    0765     IN DETROIT MI,6056,5867,189,4465,189,3169,36.86
G26016300766,STCTY-26163 TRACT-    0766     IN DETROIT MI,4482,4456,26,3462,25,2594,34.99
G26016300767,STCTY-26163 TRACT-    0767     IN DETROIT MI,3148,3142,6,2591,6,2871,35.14
G26016300768,STCTY-26163 TRACT-    0768     IN DETROIT MI,3926,3771,155,2969,155,3323,37.65
G26016300769,STCTY-26163 TRACT-    0769     IN DETROIT MI,4741,4677,64,3555,64,2942,36.84
G26016300770,STCTY-26163 TRACT-    0770     IN DETROIT MI,4761,4521,240,3402,238,3286,37.4
G26016300771,STCTY-26163 TRACT-    0771     IN DETROIT MI,5628,5621,7,4419,7,3344,39.05
G26016300772,STCTY-26163 TRACT-    0772     IN DETROIT MI,5419,5403,16,4358,15,3777,40.82
G26016300773,STCTY-26163 TRACT-    0773     IN DETROIT MI,4279,4278,1,3509,0,4043,43.91
G26016300774,STCTY-26163 TRACT-    0774     IN DETROIT MI,5811,5772,39,4733,11,3330,35.9
G26016300775,STCTY-26163 TRACT-    0775     IN DETROIT MI,4437,4414,23,3573,20,2557,34.19
G26016300776,STCTY-26163 TRACT-    0776     IN DETROIT MI,3259,3255,4,2546,4,3375,34.59
G26016300777,STCTY-26163 TRACT-    0777     IN DETROIT MI,2061,2040,21,1534,19,3431,38.76
G26016300778,STCTY-26163 TRACT-    0778     IN DETROIT MI,749,749,0,586,0,0,35.85
G26016300779,STCTY-26163 TRACT-    0779     IN DETROIT MI,4684,4678,6,3940,0,4341,40.02
G26016300780,STCTY-26163 TRACT-    0780     IN DETROIT MI,6189,6172,17,5022,14,3934,40.88
G26016300781,STCTY-26163 TRACT-    0781     IN DETROIT MI,4815,4813,2,3626,0,3315,41.64
G26016300782,STCTY-26163 TRACT-    0782     IN DETROIT MI,3868,3858,10,3049,2,3559,43.66
G26016300783,STCTY-26163 TRACT-    0783     IN DETROIT MI,6400,6388,12,5271,0,3592,40.51
G26016300784,STCTY-26163 TRACT-    0784     IN DETROIT MI,3766,3756,10,3075,0,4226,41.88
G26016300785,STCTY-26163 TRACT-    0785     IN DETROIT MI,4702,4681,21,3722,11,3735,41.65
G26016300786,STCTY-26163 TRACT-    0786     IN DETROIT MI,7584,7582,2,5647,2,3630,42.97
G26016300787,STCTY-26163 TRACT-    0787     IN DETROIT MI,5214,5212,2,4175,1,5263,47.66
G26016300788,STCTY-26163 TRACT-    0788     IN DETROIT MI,4076,4075,1,3444,0,3427,32.76
G26016300789,STCTY-26163 TRACT-    0789     IN DETROIT MI,2417,2417,0,1796,0,3413,41.91
G26016300790,STCTY-26163 TRACT-    0790     IN DETROIT MI,7802,7792,10,5760,10,3460,39.58
G26016300791,STCTY-26163 TRACT-    0791     IN DETROIT MI,5716,5697,19,4246,16,2824,36.19
G26016300792,STCTY-26163 TRACT-    0792     IN DETROIT MI,4931,4829,102,3769,102,3017,38.24
G26016300793,STCTY-26163 TRACT-    0793     IN DETROIT MI,3976,3960,16,3129,16,3699,44.34
G26016300794,STCTY-26163 TRACT-    0794     IN DETROIT MI,3724,3718,6,3054,6,2817,38.58
G26016300795,STCTY-26163 TRACT-    0795     IN DETROIT MI,3937,3936,1,3216,0,2811,35.81
G26016300796,STCTY-26163 TRACT-    0796     IN DETROIT MI,5920,5714,206,4572,204,2973,36.21
G26016300797,STCTY-26163 TRACT-    0797     IN DETROIT MI,2712,2680,32,2178,32,3261,39.4
G26016300801,STCTY-26163 TRACT-    0801     IN DETROIT MI ADJ AREA,0,0,0,0,0,0,0
G26016300802,STCTY-26163 TRACT-    0802     IN DETROIT MI ADJ AREA,115,115,0,105,0,0,0
G26016300803,STCTY-26163 TRACT-    0803     IN DETROIT MI ADJ AREA,13239,13230,9,11075,3,3067,33.98
G26016300804,STCTY-26163 TRACT-    0804     IN DETROIT MI ADJ AREA,3654,1121,2533,837,2533,1855,27.72
G26016300805,STCTY-26163 TRACT-    0805     IN DETROIT MI ADJ AREA,3756,3756,0,3070,0,3275,35.64
G26016300806,STCTY-26163 TRACT-    0806     IN DETROIT MI ADJ AREA,3962,3962,0,3513,0,3528,35.5
G26016300807,STCTY-26163 TRACT-    0807     IN DETROIT MI ADJ AREA,5491,3646,1845,2959,1817,2168,31.05
G26016300808,STCTY-26163 TRACT-    0808     IN DETROIT MI ADJ AREA,5053,5052,1,4161,1,3793,36.18
G26016300809,STCTY-26163 TRACT-    0809     IN DETROIT MI ADJ AREA,4923,4923,0,4135,0,3139,36.85
G26016300810,STCTY-26163 TRACT-    0810     IN DETROIT MI ADJ AREA,8242,8242,0,6709,0,3301,29.99
G26016300811,STCTY-26163 TRACT-    0811     IN DETROIT MI ADJ AREA,6674,6673,1,5819,1,3991,38.45
G26016300812,STCTY-26163 TRACT-    0812     IN DETROIT MI ADJ AREA,5726,5724,2,4851,2,2873,29.56
G26016300813,STCTY-26163 TRACT-    0813     IN DETROIT MI ADJ AREA,804,795,9,712,9,3346,0
G26016300814,STCTY-26163 TRACT-    0814     IN DETROIT MI ADJ AREA,2206,2181,25,1914,25,5938,43.45
G26016300815,STCTY-26163 TRACT-    0815     IN DETROIT MI ADJ AREA,5284,5277,7,4657,7,3781,35.58
G26016300816,STCTY-26163 TRACT-    0816     IN DETROIT MI ADJ AREA,53,53,0,43,0,0,0
G26016300817,STCTY-26163 TRACT-    0817     IN DETROIT MI ADJ AREA,1782,1776,6,1641,6,2830,0
G26016300818,STCTY-26163 TRACT-    0818     IN DETROIT MI ADJ AREA,6025,6024,1,5228,0,3534,36.09
G26016300819,STCTY-26163 TRACT-    0819     IN DETROIT MI ADJ AREA,1771,1771,0,1499,0,2412,33.57
G26016300820,STCTY-26163 TRACT-    0820     IN DETROIT MI ADJ AREA,7440,7436,4,6312,0,2900,35.53
G26016300821,STCTY-26163 TRACT-    0821     IN DETROIT MI ADJ AREA,3487,3487,0,3068,0,5063,45.13
G26016300822,STCTY-26163 TRACT-    0822     IN DETROIT MI ADJ AREA,4764,4757,7,3915,0,2328,33.8
G26016300823,STCTY-26163 TRACT-    0823     IN DETROIT MI ADJ AREA,93,92,1,85,1,0,0
G26016300824,STCTY-26163 TRACT-    0824     IN DETROIT MI ADJ AREA,3968,3968,0,3478,0,2174,32.3
G26016300825,STCTY-26163 TRACT-    0825     IN DETROIT MI ADJ AREA,1896,1895,1,1656,1,2849,45.07
G26016300826,STCTY-26163 TRACT-    0826     IN DETROIT MI ADJ AREA,4540,4539,1,4008,1,5019,41.82
G26016300827,STCTY-26163 TRACT-    0827     IN DETROIT MI ADJ AREA,2281,2281,0,2000,0,3641,35.51
G26016300828,STCTY-26163 TRACT-    0828     IN DETROIT MI ADJ AREA,3559,3549,10,3140,8,6660,0
G26016300829,STCTY-26163 TRACT-    0829     IN DETROIT MI ADJ AREA,3076,3060,16,2688,13,7184,44.78
G26016300830,STCTY-26163 TRACT-    0830     IN DETROIT MI ADJ AREA,1612,1606,6,1334,6,4169,37.92
G26016300831,STCTY-26163 TRACT-    0831     IN DETROIT MI ADJ AREA,2943,2932,11,2222,2,4070,37.34
G26016300832,STCTY-26163 TRACT-    0832     IN DETROIT MI ADJ AREA,9929,9928,1,7620,0,4376,42.41
G26016300833,STCTY-26163 TRACT-    0833     IN DETROIT MI ADJ AREA,5931,5931,0,4697,0,4375,43.15
G26016300834,STCTY-26163 TRACT-    0834     IN DETROIT MI ADJ AREA,7044,7044,0,5634,0,4041,41.89
G26016300835,STCTY-26163 TRACT-    0835     IN DETROIT MI ADJ AREA,6391,6388,3,5133,3,5698,49.54
G26016300836,STCTY-26163 TRACT-    0836     IN DETROIT MI ADJ AREA,2960,2959,1,2392,1,6437,51.17
G26016300837,STCTY-26163 TRACT-    0837     IN DETROIT MI ADJ AREA,2374,2371,3,1869,0,3654,37.89
G26016300838,STCTY-26163 TRACT-    0838     IN DETROIT MI ADJ AREA,1083,1083,0,787,0,2104,30.25
G26016300839,STCTY-26163 TRACT-    0839     IN DETROIT MI ADJ AREA,7812,7776,36,4616,0,2684,35.03
G26016300840,STCTY-26163 TRACT-    0840     IN DETROIT MI ADJ AREA,153,153,0,142,0,0,0
G26016300841,STCTY-26163 TRACT-    0841     IN DETROIT MI ADJ AREA,2373,2372,1,2044,0,2250,26.85
G26016300842,STCTY-26163 TRACT-    0842     IN DETROIT MI ADJ AREA,2771,92,2679,77,2679,1979,22
G26016300843,STCTY-26163 TRACT-    0843     IN DETROIT MI ADJ AREA,1238,1194,44,1082,44,2250,33.89
G26016300844,STCTY-26163 TRACT-    0844     IN DETROIT MI ADJ AREA,662,662,0,556,0,2265,0
G26016300845,STCTY-26163 TRACT-    0845     IN DETROIT MI ADJ AREA,4096,4089,7,3566,1,1760,29.41
G26016300846,STCTY-26163 TRACT-    0846     IN DETROIT MI ADJ AREA,4084,4083,1,3611,1,1514,17.09
G26016300847,STCTY-26163 TRACT-    0847     IN DETROIT MI ADJ AREA,6867,6865,2,5920,2,2826,30.51
G26016300869,STCTY-26163 TRACT-    0869     IN DETROIT MI ADJ AREA,3496,3414,82,2852,79,16133,52.83
G26016300870,STCTY-26163 TRACT-    0870     IN DETROIT MI ADJ AREA,6002,5981,21,4928,16,6099,49.97
G26016300871,STCTY-26163 TRACT-    0871     IN DETROIT MI ADJ AREA,3148,3055,93,2717,88,11534,0
G26016300872,STCTY-26163 TRACT-    0872     IN DETROIT MI ADJ AREA,2065,2045,20,1679,20,5976,58.82
G26016300873,STCTY-26163 TRACT-    0873     IN DETROIT MI ADJ AREA,4114,3993,121,3486,120,12098,97.45
G26016300874,STCTY-26163 TRACT-    0874     IN DETROIT MI ADJ AREA,2155,2073,82,1635,79,19922,47.66
G26016300875,STCTY-26163 TRACT-    0875     IN DETROIT MI ADJ AREA,4450,4398,52,3804,52,10409,68.25
G26016300876,STCTY-26163 TRACT-    0876     IN DETROIT MI ADJ AREA,612,575,37,429,34,0,0
G26016300877,STCTY-26163 TRACT-    0877     IN DETROIT MI ADJ AREA,777,739,38,575,37,0,0
G26016300878,STCTY-26163 TRACT-    0878     IN DETROIT MI ADJ AREA,2805,2801,4,2362,4,6461,0
G26016300879,STCTY-26163 TRACT-    0879     IN DETROIT MI ADJ AREA,858,858,0,696,0,2320,0
G26016300901,STCTY-26163 TRACT-    0901     IN DETROIT MI ADJ AREA,2782,2523,259,1783,251,4448,37.67
G26016300902,STCTY-26163 TRACT-    0902     IN DETROIT MI ADJ AREA,2320,2301,19,1961,18,7843,66.67
G26016300903,STCTY-26163 TRACT-    0903     IN DETROIT MI ADJ AREA,2001,1996,5,1658,4,6830,48.62
G26016300904,STCTY-26163 TRACT-    0904     IN DETROIT MI ADJ AREA,4983,4977,6,4104,6,4888,44.73
G26016300905,STCTY-26163 TRACT-    0905     IN DETROIT MI ADJ AREA,3984,3983,1,3168,1,3641,41.99
G26016300906,STCTY-26163 TRACT-    0906     IN DETROIT MI ADJ AREA,4858,3865,993,2710,985,2649,35.61
G26016300907,STCTY-26163 TRACT-    0907     IN DETROIT MI ADJ AREA,5343,5332,11,3901,6,3224,43.35
G26016300908,STCTY-26163 TRACT-    0908     IN DETROIT MI ADJ AREA,5290,5281,9,4192,8,5825,46.36
G26016300909,STCTY-26163 TRACT-    0909     IN DETROIT MI ADJ AREA,5372,5359,13,4159,2,4207,36
G26016300910,STCTY-26163 TRACT-    0910     IN DETROIT MI ADJ AREA,3139,3135,4,2532,3,4697,42.13
G26016300911,STCTY-26163 TRACT-    0911     IN DETROIT MI ADJ AREA,2870,2867,3,2367,3,5078,36.47
G26016300912,STCTY-26163 TRACT-    0912     IN DETROIT MI ADJ AREA,4216,4211,5,3200,5,3681,29.4
G26016300913,STCTY-26163 TRACT-    0913     IN DETROIT MI ADJ AREA,3652,3645,7,2971,0,3169,38.84
G26016300951,STCTY-26163 TRACT-    0951     IN DETROIT MI ADJ AREA,2011,1462,549,1021,543,2031,22.18
G26016300952,STCTY-26163 TRACT-    0952     IN DETROIT MI ADJ AREA,7515,7198,317,4868,316,2057,27.59
G26016300953,STCTY-26163 TRACT-    0953     IN DETROIT MI ADJ AREA,5610,5589,21,3849,21,2640,30.26
G26016300954,STCTY-26163 TRACT-    0954     IN DETROIT MI ADJ AREA,2911,2828,83,1996,83,2164,31.91
G26016300955,STCTY-26163 TRACT-    0955     IN DETROIT MI ADJ AREA,3154,2190,964,1507,964,2407,25.9
G26016300956,STCTY-26163 TRACT-    0956     IN DETROIT MI ADJ AREA,6612,6552,60,4351,57,2529,33.31
G26016300957,STCTY-26163 TRACT-    0957     IN DETROIT MI ADJ AREA,5208,5075,133,3401,133,2654,33.77
G26016300958,STCTY-26163 TRACT-    0958     IN DETROIT MI ADJ AREA,7010,6674,336,4309,336,2079,33.04
G26016300959,STCTY-26163 TRACT-    0959     IN DETROIT MI ADJ AREA,4249,4155,94,2726,94,1989,30.91
G26016300960,STCTY-26163 TRACT-    0960     IN DETROIT MI ADJ AREA,3915,3167,748,2210,747,2890,31.44
G26016300961,STCTY-26163 TRACT-    0961     IN DETROIT MI ADJ AREA,1644,1575,69,1157,69,1720,27.78
G2700030C0001,STCTY-27003 TRACT-  C 0001     IN MINNEAPOLIS MN ADJ AREA,6035,6033,2,5269,1,2666,28.96
G2700370C0001,STCTY-27037 TRACT-  C 0001     IN ST.PAUL MN ADJ AREA,5733,5732,1,5167,0,4007,36.02
G2700370C0002,STCTY-27037 TRACT-  C 0002     IN ST.PAUL MN ADJ AREA,2880,2878,2,2534,1,3766,26.66
G2700370C0003,STCTY-27037 TRACT-  C 0003     IN ST.PAUL MN ADJ AREA,6329,6328,1,5373,1,3790,32.09
G2700370C0004,STCTY-27037 TRACT-  C 0004     IN ST.PAUL MN ADJ AREA,2635,2635,0,2263,0,3343,26.67
G27005300001,STCTY-27053 TRACT-    0001     IN MINNEAPOLIS MN,4083,3934,149,3433,149,2506,31.83
G27005300002,STCTY-27053 TRACT-    0002     IN MINNEAPOLIS MN,3256,3254,2,2886,2,3520,35.54
G27005300003,STCTY-27053 TRACT-    0003     IN MINNEAPOLIS MN,4117,4117,0,3711,0,4746,44.44
G27005300004,STCTY-27053 TRACT-    0004     IN MINNEAPOLIS MN,4704,4704,0,4078,0,3324,35.81
G27005300005,STCTY-27053 TRACT-    0005     IN MINNEAPOLIS MN,2400,2400,0,1892,0,2500,28.07
G27005300006,STCTY-27053 TRACT-    0006     IN MINNEAPOLIS MN,4685,4685,0,4082,0,3657,37.39
G27005300007,STCTY-27053 TRACT-    0007     IN MINNEAPOLIS MN,3068,3063,5,2771,5,4013,41.87
G27005300008,STCTY-27053 TRACT-    0008     IN MINNEAPOLIS MN,3487,3487,0,3097,0,4008,44.87
G27005300009,STCTY-27053 TRACT-    0009     IN MINNEAPOLIS MN,4091,4091,0,3561,0,3590,38.69
G27005300010,STCTY-27053 TRACT-    0010     IN MINNEAPOLIS MN,2860,2860,0,2427,0,2382,27.26
G27005300011,STCTY-27053 TRACT-    0011     IN MINNEAPOLIS MN,3535,3529,6,3060,2,3349,34.41
G27005300012,STCTY-27053 TRACT-    0012     IN MINNEAPOLIS MN,4859,4859,0,4141,0,4604,42.16
G27005300013,STCTY-27053 TRACT-    0013     IN MINNEAPOLIS MN,3189,3183,6,2860,1,3616,37.17
G27005300014,STCTY-27053 TRACT-    0014     IN MINNEAPOLIS MN,3142,3142,0,2822,0,3661,35.55
G27005300015,STCTY-27053 TRACT-    0015     IN MINNEAPOLIS MN,3223,3223,0,2790,0,3479,35.68
G27005300016,STCTY-27053 TRACT-    0016     IN MINNEAPOLIS MN,4387,4387,0,3738,0,3057,33.87
G27005300017,STCTY-27053 TRACT-    0017     IN MINNEAPOLIS MN,3377,3377,0,2649,0,2262,28.71
G27005300018,STCTY-27053 TRACT-    0018     IN MINNEAPOLIS MN,5284,5281,3,4386,2,2485,30.63
G27005300019,STCTY-27053 TRACT-    0019     IN MINNEAPOLIS MN,3731,3731,0,3078,0,2917,32.77
G27005300020,STCTY-27053 TRACT-    0020     IN MINNEAPOLIS MN,2474,2474,0,2196,0,4020,42.63
G27005300021,STCTY-27053 TRACT-    0021     IN MINNEAPOLIS MN,4715,4709,6,4272,4,3220,31.47
G27005300022,STCTY-27053 TRACT-    0022     IN MINNEAPOLIS MN,4009,3996,13,3559,2,2705,31.96
G27005300023,STCTY-27053 TRACT-    0023     IN MINNEAPOLIS MN,4369,4358,11,3767,9,1450,26.59
G27005300024,STCTY-27053 TRACT-    0024     IN MINNEAPOLIS MN,3877,3877,0,3166,0,1829,28.18
G27005300025,STCTY-27053 TRACT-    0025     IN MINNEAPOLIS MN,4177,4177,0,3402,0,2310,31.24
G27005300026,STCTY-27053 TRACT-    0026     IN MINNEAPOLIS MN,4372,4365,7,3674,3,2093,27.78
G27005300027,STCTY-27053 TRACT-    0027     IN MINNEAPOLIS MN,3542,3542,0,2601,0,4528,47.63
G27005300028,STCTY-27053 TRACT-    0028     IN MINNEAPOLIS MN,3675,3673,2,2927,0,3880,37.83
G27005300029,STCTY-27053 TRACT-    0029     IN MINNEAPOLIS MN,4586,4586,0,4145,0,2768,31.09
G27005300030,STCTY-27053 TRACT-    0030     IN MINNEAPOLIS MN,2593,2593,0,2167,0,2628,29.47
G27005300031,STCTY-27053 TRACT-    0031     IN MINNEAPOLIS MN,4799,4799,0,4067,0,1757,26.29
G27005300032,STCTY-27053 TRACT-    0032     IN MINNEAPOLIS MN,1948,1945,3,1405,1,5742,39.92
G27005300033,STCTY-27053 TRACT-    0033     IN MINNEAPOLIS MN,4649,4648,1,2867,1,3239,42.59
G27005300034,STCTY-27053 TRACT-    0034     IN MINNEAPOLIS MN,5411,4701,710,3685,681,1558,25.51
G27005300035,STCTY-27053 TRACT-    0035     IN MINNEAPOLIS MN,2968,2628,340,2248,340,0,21.33
G27005300036,STCTY-27053 TRACT-    0036     IN MINNEAPOLIS MN,3675,3665,10,2869,0,1732,19.19
G27005300037,STCTY-27053 TRACT-    0037     IN MINNEAPOLIS MN,3633,3623,10,3178,1,3068,27.55
G27005300038,STCTY-27053 TRACT-    0038     IN MINNEAPOLIS MN,3466,3457,9,3181,2,5073,35.51
G27005300039,STCTY-27053 TRACT-    0039     IN MINNEAPOLIS MN,2551,2532,19,2327,0,3115,27.77
G27005300040,STCTY-27053 TRACT-    0040     IN MINNEAPOLIS MN,4744,4727,17,4287,5,3469,37.03
G27005300041,STCTY-27053 TRACT-    0041     IN MINNEAPOLIS MN,4474,4443,31,3629,27,2412,29.87
G27005300042,STCTY-27053 TRACT-    0042     IN MINNEAPOLIS MN,4540,3535,1005,2865,992,1953,21.84
G27005300043,STCTY-27053 TRACT-    0043     IN MINNEAPOLIS MN,3239,3204,35,2879,3,0,20.55
G27005300044,STCTY-27053 TRACT-    0044     IN MINNEAPOLIS MN,3810,3713,97,3279,1,0,19.3
G27005300045,STCTY-27053 TRACT-    0045     IN MINNEAPOLIS MN,3291,3196,95,1953,73,0,0
G27005300046,STCTY-27053 TRACT-    0046     IN MINNEAPOLIS MN,3094,3014,80,2171,57,0,14.87
G27005300047,STCTY-27053 TRACT-    0047     IN MINNEAPOLIS MN,3433,3136,297,2383,292,1297,16.34
G27005300048,STCTY-27053 TRACT-    0048     IN MINNEAPOLIS MN,5107,5097,10,3967,9,1644,22.14
G27005300049,STCTY-27053 TRACT-    0049     IN MINNEAPOLIS MN,3622,3617,5,3240,0,3418,41.11
G27005300050,STCTY-27053 TRACT-    0050     IN MINNEAPOLIS MN,3478,3478,0,3155,0,5149,43.43
G27005300051,STCTY-27053 TRACT-    0051     IN MINNEAPOLIS MN,2889,2878,11,2651,2,4934,41.31
G27005300052,STCTY-27053 TRACT-    0052     IN MINNEAPOLIS MN,4647,4644,3,4254,0,0,28.12
G27005300053,STCTY-27053 TRACT-    0053     IN MINNEAPOLIS MN,4186,4137,49,3657,1,0,24.33
G27005300054,STCTY-27053 TRACT-    0054     IN MINNEAPOLIS MN,3984,3957,27,3439,6,0,22.53
G27005300055,STCTY-27053 TRACT-    0055     IN MINNEAPOLIS MN,3642,3621,21,3358,10,10376,46.9
G27005300056,STCTY-27053 TRACT-    0056     IN MINNEAPOLIS MN,5793,5787,6,5261,4,7172,35.75
G27005300057,STCTY-27053 TRACT-    0057     IN MINNEAPOLIS MN,6629,6606,23,6046,0,0,29.78
G27005300058,STCTY-27053 TRACT-    0058     IN MINNEAPOLIS MN,5260,5235,25,4686,11,0,23.09
G27005300059,STCTY-27053 TRACT-    0059     IN MINNEAPOLIS MN,6234,6226,8,5373,0,2162,22.82
G27005300060,STCTY-27053 TRACT-    0060     IN MINNEAPOLIS MN,5332,5318,14,4203,9,1982,26.67
G27005300061,STCTY-27053 TRACT-    0061     IN MINNEAPOLIS MN,4213,4014,199,3403,187,1636,24.62
G27005300062,STCTY-27053 TRACT-    0062     IN MINNEAPOLIS MN,3026,2974,52,2467,46,1755,26.91
G27005300063,STCTY-27053 TRACT-    0063     IN MINNEAPOLIS MN,3075,3075,0,2456,0,1966,29.16
G27005300064,STCTY-27053 TRACT-    0064     IN MINNEAPOLIS MN,2621,2619,2,2054,2,3261,33.65
G27005300065,STCTY-27053 TRACT-    0065     IN MINNEAPOLIS MN,3963,3954,9,3667,7,9070,60.47
G27005300066,STCTY-27053 TRACT-    0066     IN MINNEAPOLIS MN,4445,4438,7,4097,6,6589,48.98
G27005300067,STCTY-27053 TRACT-    0067     IN MINNEAPOLIS MN,5940,5932,8,5391,0,4157,37.39
G27005300068,STCTY-27053 TRACT-    0068     IN MINNEAPOLIS MN,4494,4489,5,4072,3,5053,40.58
G27005300069,STCTY-27053 TRACT-    0069     IN MINNEAPOLIS MN,4057,3919,138,3444,126,3162,24.57
G27005300070,STCTY-27053 TRACT-    0070     IN MINNEAPOLIS MN,4423,4416,7,4007,1,3425,36.04
G27005300071,STCTY-27053 TRACT-    0071     IN MINNEAPOLIS MN,6236,6060,176,5359,170,2740,32.21
G27005300072,STCTY-27053 TRACT-    0072     IN MINNEAPOLIS MN,5575,5575,0,4810,0,2151,30.97
G27005300073,STCTY-27053 TRACT-    0073     IN MINNEAPOLIS MN,2337,2328,9,2042,9,2819,28.69
G27005300074,STCTY-27053 TRACT-    0074     IN MINNEAPOLIS MN,3873,3846,27,3344,18,2038,25.6
G27005300075,STCTY-27053 TRACT-    0075     IN MINNEAPOLIS MN,4098,4038,60,3330,60,2863,30.71
G27005300076,STCTY-27053 TRACT-    0076     IN MINNEAPOLIS MN,2613,2613,0,2253,0,3881,42.71
G27005300077,STCTY-27053 TRACT-    0077     IN MINNEAPOLIS MN,3093,3049,44,2741,44,3184,34.32
G27005300078,STCTY-27053 TRACT-    0078     IN MINNEAPOLIS MN,4804,4717,87,4160,83,2611,34.19
G27005300079,STCTY-27053 TRACT-    0079     IN MINNEAPOLIS MN,3845,3744,101,3233,94,2583,31.86
G27005300080,STCTY-27053 TRACT-    0080     IN MINNEAPOLIS MN,4229,4223,6,3865,1,5076,46.8
G27005300081,STCTY-27053 TRACT-    0081     IN MINNEAPOLIS MN,5339,5319,20,4746,8,4074,46.08
G27005300082,STCTY-27053 TRACT-    0082     IN MINNEAPOLIS MN,5021,4989,32,4452,29,3151,36.56
G27005300083,STCTY-27053 TRACT-    0083     IN MINNEAPOLIS MN,4205,4177,28,3749,21,3090,32.75
G27005300084,STCTY-27053 TRACT-    0084     IN MINNEAPOLIS MN,3519,3504,15,3088,13,4013,37.14
G27005300085,STCTY-27053 TRACT-    0085     IN MINNEAPOLIS MN,5608,5583,25,4683,21,3509,39.73
G27005300086,STCTY-27053 TRACT-    0086     IN MINNEAPOLIS MN,3667,3631,36,3025,35,3248,34.91
G27005300087,STCTY-27053 TRACT-    0087     IN MINNEAPOLIS MN,4007,3986,21,3294,21,3225,40.21
G27005300088,STCTY-27053 TRACT-    0088     IN MINNEAPOLIS MN,4692,4604,88,3907,87,3444,37.01
G27005300089,STCTY-27053 TRACT-    0089     IN MINNEAPOLIS MN,4415,4415,0,3748,0,3840,40.52
G27005300090,STCTY-27053 TRACT-    0090     IN MINNEAPOLIS MN,5446,5438,8,4725,6,4428,42.09
G27005300091,STCTY-27053 TRACT-    0091     IN MINNEAPOLIS MN,2848,2846,2,2652,0,5400,53.22
G27005300092,STCTY-27053 TRACT-    0092     IN MINNEAPOLIS MN,4248,4240,8,3803,6,4455,48.33
G27005300093,STCTY-27053 TRACT-    0093     IN MINNEAPOLIS MN,4420,4417,3,4024,3,4185,48.04
G27005300094,STCTY-27053 TRACT-    0094     IN MINNEAPOLIS MN,4134,3849,285,3432,281,3807,42.32
G27005300095,STCTY-27053 TRACT-    0095     IN MINNEAPOLIS MN,3743,3718,25,3232,25,4453,46.34
G27005300096,STCTY-27053 TRACT-    0096     IN MINNEAPOLIS MN,4652,4604,48,4036,48,4116,44.48
G27005300097,STCTY-27053 TRACT-    0097     IN MINNEAPOLIS MN,3280,3270,10,2721,10,3679,40.74
G27005300098,STCTY-27053 TRACT-    0098     IN MINNEAPOLIS MN,3597,3591,6,3330,2,5200,59.5
G27005300099,STCTY-27053 TRACT-    0099     IN MINNEAPOLIS MN,5749,5745,4,5310,0,4867,52.24
G27005300100,STCTY-27053 TRACT-    0100     IN MINNEAPOLIS MN,2551,2145,406,1894,406,3514,43.56
G27005300101,STCTY-27053 TRACT-    0101     IN MINNEAPOLIS MN,3206,3206,0,2688,0,3971,45.18
G27005300102,STCTY-27053 TRACT-    0102     IN MINNEAPOLIS MN,3862,3861,1,3268,0,3795,44.37
G27005300103,STCTY-27053 TRACT-    0103     IN MINNEAPOLIS MN,3410,3391,19,2975,15,3459,38.74
G27005300104,STCTY-27053 TRACT-    0104     IN MINNEAPOLIS MN,3258,3248,10,2766,9,3380,41.52
G27005300105,STCTY-27053 TRACT-    0105     IN MINNEAPOLIS MN,4543,4540,3,3928,0,3885,41.18
G27005300106,STCTY-27053 TRACT-    0106     IN MINNEAPOLIS MN,3617,3616,1,3408,1,6272,59.5
G27005300107,STCTY-27053 TRACT-    0107     IN MINNEAPOLIS MN,3182,3175,7,2956,6,6812,61.69
G27005300108,STCTY-27053 TRACT-    0108     IN MINNEAPOLIS MN,5152,5149,3,4717,3,4655,52.49
G27005300109,STCTY-27053 TRACT-    0109     IN MINNEAPOLIS MN,5419,5411,8,4869,6,4796,48.15
G27005300110,STCTY-27053 TRACT-    0110     IN MINNEAPOLIS MN,4168,4168,0,3719,0,4628,47.77
G27005300111,STCTY-27053 TRACT-    0111     IN MINNEAPOLIS MN,4340,4336,4,3820,4,3865,44.18
G27005300112,STCTY-27053 TRACT-    0112     IN MINNEAPOLIS MN,4186,4186,0,3926,0,5182,56.37
G27005300113,STCTY-27053 TRACT-    0113     IN MINNEAPOLIS MN,3749,3749,0,3493,0,6429,64.04
G27005300114,STCTY-27053 TRACT-    0114     IN MINNEAPOLIS MN,4091,4078,13,3806,2,7392,77.99
G27005300115,STCTY-27053 TRACT-    0115     IN MINNEAPOLIS MN,4338,4328,10,4044,5,7476,59.77
G27005300116,STCTY-27053 TRACT-    0116     IN MINNEAPOLIS MN,5787,5782,5,5329,1,6263,59.31
G27005300117,STCTY-27053 TRACT-    0117     IN MINNEAPOLIS MN,6171,6169,2,5593,2,5889,60.31
G27005300118,STCTY-27053 TRACT-    0118     IN MINNEAPOLIS MN,4305,4304,1,3837,0,4386,47.06
G27005300119,STCTY-27053 TRACT-    0119     IN MINNEAPOLIS MN,5506,5500,6,4808,6,4016,41.29
G27005300120,STCTY-27053 TRACT-    0120     IN MINNEAPOLIS MN,2012,2012,0,1851,0,4991,38
G27005300121,STCTY-27053 TRACT-    0121     IN MINNEAPOLIS MN,3572,3572,0,3202,0,2457,31.78
G2700530C0002,STCTY-27053 TRACT-  C 0002     IN MINNEAPOLIS MN ADJ AREA,1870,1863,7,1666,7,2667,0
G2700530C0003,STCTY-27053 TRACT-  C 0003     IN MINNEAPOLIS MN ADJ AREA,2767,2764,3,2495,3,2565,25.75
G2700530C0004,STCTY-27053 TRACT-  C 0004     IN MINNEAPOLIS MN ADJ AREA,6018,6018,0,5626,0,3702,34.94
G2700530C0005,STCTY-27053 TRACT-  C 0005     IN MINNEAPOLIS MN ADJ AREA,2048,2048,0,1843,0,3736,28.67
G2700530C0006,STCTY-27053 TRACT-  C 0006     IN MINNEAPOLIS MN ADJ AREA,7737,7731,6,7091,5,4987,34.01
G2700530C0007,STCTY-27053 TRACT-  C 0007     IN MINNEAPOLIS MN ADJ AREA,4333,4332,1,3790,1,3448,27.17
G2700530C0008,STCTY-27053 TRACT-  C 0008     IN MINNEAPOLIS MN ADJ AREA,1282,1282,0,1220,0,6016,0
G2700530C0009,STCTY-27053 TRACT-  C 0009     IN MINNEAPOLIS MN ADJ AREA,5855,5839,16,5443,10,8694,37.89
G2700530C0010,STCTY-27053 TRACT-  C 0010     IN MINNEAPOLIS MN ADJ AREA,3778,3778,0,3467,0,3694,25.62
G2700530C0011,STCTY-27053 TRACT-  C 0011     IN MINNEAPOLIS MN ADJ AREA,2972,2953,19,2840,6,0,0
G27012300001,STCTY-27123 TRACT-    0001     IN ST.PAUL MN,4293,4283,10,3887,1,5815,46.08
G27012300002,STCTY-27123 TRACT-    0002     IN ST.PAUL MN,5139,5125,14,4585,14,4851,44.87
G27012300003,STCTY-27123 TRACT-    0003     IN ST.PAUL MN,2474,2474,0,2268,0,4774,41.88
G27012300004,STCTY-27123 TRACT-    0004     IN ST.PAUL MN,977,946,31,819,31,2920,0
G27012300005,STCTY-27123 TRACT-    0005     IN ST.PAUL MN,1834,1824,10,1581,10,2565,28.63
G27012300006,STCTY-27123 TRACT-    0006     IN ST.PAUL MN,3336,3334,2,2857,2,4681,37.83
G27012300007,STCTY-27123 TRACT-    0007     IN ST.PAUL MN,2894,2893,1,2614,0,3500,30.82
G27012300008,STCTY-27123 TRACT-    0008     IN ST.PAUL MN,4658,4631,27,3859,27,2773,26.88
G27012300009,STCTY-27123 TRACT-    0009     IN ST.PAUL MN,3600,3599,1,2958,1,3252,33.13
G27012300010,STCTY-27123 TRACT-    0010     IN ST.PAUL MN,5031,5025,6,4041,1,2928,31.07
G27012300011,STCTY-27123 TRACT-    0011     IN ST.PAUL MN,3735,3725,10,3165,10,4200,35.83
G27012300012,STCTY-27123 TRACT-    0012     IN ST.PAUL MN,2887,2879,8,2463,8,3334,30.7
G27012300013,STCTY-27123 TRACT-    0013     IN ST.PAUL MN,3424,3385,39,2866,38,2250,25.31
G27012300014,STCTY-27123 TRACT-    0014     IN ST.PAUL MN,4157,4146,11,3630,10,2099,26.26
G27012300015,STCTY-27123 TRACT-    0015     IN ST.PAUL MN,4514,4500,14,3782,4,2171,26.87
G27012300016,STCTY-27123 TRACT-    0016     IN ST.PAUL MN,3873,3873,0,3249,0,2949,29.5
G27012300017,STCTY-27123 TRACT-    0017     IN ST.PAUL MN,4289,4288,1,3840,0,2883,30.87
G27012300018,STCTY-27123 TRACT-    0018     IN ST.PAUL MN,4095,4095,0,3697,0,3453,34.21
G27012300019,STCTY-27123 TRACT-    0019     IN ST.PAUL MN,2061,2056,5,1842,0,2956,27.89
G27012300020,STCTY-27123 TRACT-    0020     IN ST.PAUL MN,3328,3323,5,2948,5,3635,35.12
G27012300021,STCTY-27123 TRACT-    0021     IN ST.PAUL MN,3526,3526,0,3168,0,3934,37.05
G27012300022,STCTY-27123 TRACT-    0022     IN ST.PAUL MN,3681,3650,31,3286,30,3978,38.57
G27012300023,STCTY-27123 TRACT-    0023     IN ST.PAUL MN,4399,4380,19,3968,19,4178,42.91
G27012300024,STCTY-27123 TRACT-    0024     IN ST.PAUL MN,2870,2860,10,2466,3,2854,30.12
G27012300025,STCTY-27123 TRACT-    0025     IN ST.PAUL MN,4961,4909,52,4277,52,3211,30.48
G27012300026,STCTY-27123 TRACT-    0026     IN ST.PAUL MN,4947,4886,61,4163,59,2262,29.69
G27012300027,STCTY-27123 TRACT-    0027     IN ST.PAUL MN,3733,3723,10,3300,10,2323,28.88
G27012300028,STCTY-27123 TRACT-    0028     IN ST.PAUL MN,5345,5327,18,4744,18,2987,22.83
G27012300029,STCTY-27123 TRACT-    0029     IN ST.PAUL MN,3834,3747,87,3012,87,1883,21.9
G27012300030,STCTY-27123 TRACT-    0030     IN ST.PAUL MN,2697,2674,23,2167,23,1908,24.46
G27012300031,STCTY-27123 TRACT-    0031     IN ST.PAUL MN,3689,3684,5,3271,5,2468,28.19
G27012300032,STCTY-27123 TRACT-    0032     IN ST.PAUL MN,3702,3701,1,3319,0,3479,31.13
G27012300033,STCTY-27123 TRACT-    0033     IN ST.PAUL MN,4643,4639,4,4256,4,4164,40.7
G27012300034,STCTY-27123 TRACT-    0034     IN ST.PAUL MN,3908,3901,7,3561,0,3735,40.28
G27012300035,STCTY-27123 TRACT-    0035     IN ST.PAUL MN,4752,3479,1273,3043,1268,3240,36.29
G27012300036,STCTY-27123 TRACT-    0036     IN ST.PAUL MN,4428,3046,1382,2707,1379,2169,26.87
G27012300037,STCTY-27123 TRACT-    0037     IN ST.PAUL MN,5582,5230,352,4658,343,2034,29.14
G27012300038,STCTY-27123 TRACT-    0038     IN ST.PAUL MN,2980,2872,108,2446,108,3610,40.34
G27012300039,STCTY-27123 TRACT-    0039     IN ST.PAUL MN,3709,3516,193,3013,187,3305,29.29
G27012300040,STCTY-27123 TRACT-    0040     IN ST.PAUL MN,4424,4373,51,3945,46,2607,30.81
G27012300041,STCTY-27123 TRACT-    0041     IN ST.PAUL MN,5052,5015,37,4453,11,0,24.43
G27012300042,STCTY-27123 TRACT-    0042     IN ST.PAUL MN,2202,2153,49,1828,16,0,20.85
G27012300043,STCTY-27123 TRACT-    0043     IN ST.PAUL MN,2467,2394,73,1721,63,0,14.01
G27012300044,STCTY-27123 TRACT-    0044     IN ST.PAUL MN,3623,3620,3,3255,3,3309,29.14
G27012300045,STCTY-27123 TRACT-    0045     IN ST.PAUL MN,5065,5065,0,4574,0,3195,32.61
G27012300046,STCTY-27123 TRACT-    0046     IN ST.PAUL MN,3651,3651,0,3317,0,3409,35.56
G27012300047,STCTY-27123 TRACT-    0047     IN ST.PAUL MN,1774,1770,4,1602,0,3194,0
G27012300048,STCTY-27123 TRACT-    0048     IN ST.PAUL MN,2196,2190,6,2056,5,9858,56.47
G27012300049,STCTY-27123 TRACT-    0049     IN ST.PAUL MN,4184,4184,0,3883,0,5800,48.43
G27012300050,STCTY-27123 TRACT-    0050     IN ST.PAUL MN,3952,3950,2,3687,2,5040,48.05
G27012300051,STCTY-27123 TRACT-    0051     IN ST.PAUL MN,3406,3406,0,3138,0,5657,50.16
G27012300052,STCTY-27123 TRACT-    0052     IN ST.PAUL MN,4918,4915,3,4337,2,5532,49.05
G27012300053,STCTY-27123 TRACT-    0053     IN ST.PAUL MN,5425,5425,0,4887,0,4644,47.95
G27012300054,STCTY-27123 TRACT-    0054     IN ST.PAUL MN,4387,4385,2,3745,2,4167,36.67
G27012300055,STCTY-27123 TRACT-    0055     IN ST.PAUL MN,4712,4710,2,4197,0,3766,28.41
G27012300056,STCTY-27123 TRACT-    0056     IN ST.PAUL MN,2713,2710,3,2417,2,5408,47.06
G27012300057,STCTY-27123 TRACT-    0057     IN ST.PAUL MN,3845,3838,7,3522,6,7226,54.02
G27012300058,STCTY-27123 TRACT-    0058     IN ST.PAUL MN,4040,4030,10,3690,5,8611,44.96
G27012300059,STCTY-27123 TRACT-    0059     IN ST.PAUL MN,3777,3769,8,3312,7,2603,23.47
G27012300060,STCTY-27123 TRACT-    0060     IN ST.PAUL MN,3710,3690,20,3151,14,2341,21.74
G27012300061,STCTY-27123 TRACT-    0061     IN ST.PAUL MN,4677,4517,160,3407,144,1402,22.1
G27012300062,STCTY-27123 TRACT-    0062     IN ST.PAUL MN,3914,3911,3,3584,0,6528,51.51
G27012300063,STCTY-27123 TRACT-    0063     IN ST.PAUL MN,3873,3871,2,3605,1,6056,50.36
G27012300064,STCTY-27123 TRACT-    0064     IN ST.PAUL MN,4942,4939,3,4506,2,5641,51.41
G27012300065,STCTY-27123 TRACT-    0065     IN ST.PAUL MN,4005,3996,9,3639,5,4650,49.27
G27012300066,STCTY-27123 TRACT-    0066     IN ST.PAUL MN,4028,4025,3,3695,2,4778,47.79
G27012300067,STCTY-27123 TRACT-    0067     IN ST.PAUL MN,4641,4641,0,4063,0,3184,37.38
G27012300068,STCTY-27123 TRACT-    0068     IN ST.PAUL MN,3803,3803,0,3325,0,2854,31.54
G27012300069,STCTY-27123 TRACT-    0069     IN ST.PAUL MN,4940,4938,2,4361,1,2500,28.27
G27012300070,STCTY-27123 TRACT-    0070     IN ST.PAUL MN,3913,3913,0,3559,0,4255,39.67
G27012300071,STCTY-27123 TRACT-    0071     IN ST.PAUL MN,5198,5198,0,4673,0,3553,34.07
G27012300072,STCTY-27123 TRACT-    0072     IN ST.PAUL MN,5701,5701,0,5076,0,2986,29.04
G27012300073,STCTY-27123 TRACT-    0073     IN ST.PAUL MN,3461,3427,34,2903,34,1945,26.4
G27012300074,STCTY-27123 TRACT-    0074     IN ST.PAUL MN,767,767,0,702,0,2788,0
G27012300075,STCTY-27123 TRACT-    0075     IN ST.PAUL MN,924,921,3,880,2,9512,0
G27012300076,STCTY-27123 TRACT-    0076     IN ST.PAUL MN,1441,1434,7,1316,7,2736,49.84
G27013700001,STCTY-27137 TRACT-    0001     IN DULUTH MN,2578,2577,1,2197,0,3616,36.41
G27013700002,STCTY-27137 TRACT-    0002     IN DULUTH MN,2826,2821,5,2439,5,4035,35.52
G27013700003,STCTY-27137 TRACT-    0003     IN DULUTH MN,2919,2915,4,2065,4,2235,22.71
G27013700004,STCTY-27137 TRACT-    0004     IN DULUTH MN,818,814,4,645,4,2423,0
G27013700005,STCTY-27137 TRACT-    0005     IN DULUTH MN,2690,2689,1,2376,1,5762,44.36
G27013700006,STCTY-27137 TRACT-    0006     IN DULUTH MN,3639,3639,0,3121,0,4657,44.27
G27013700007,STCTY-27137 TRACT-    0007     IN DULUTH MN,1785,1785,0,1656,0,9142,0
G27013700008,STCTY-27137 TRACT-    0008     IN DULUTH MN,1576,1576,0,1353,0,5881,0
G27013700009,STCTY-27137 TRACT-    0009     IN DULUTH MN,5273,5214,59,4206,50,3654,31.19
G27013700010,STCTY-27137 TRACT-    0010     IN DULUTH MN,2501,2497,4,2151,2,6429,50.01
G27013700011,STCTY-27137 TRACT-    0011     IN DULUTH MN,1529,1523,6,1330,6,6167,60.68
G27013700012,STCTY-27137 TRACT-    0012     IN DULUTH MN,3076,3049,27,2480,27,3019,33.65
G27013700013,STCTY-27137 TRACT-    0013     IN DULUTH MN,2566,2566,0,2131,0,3729,42.22
G27013700014,STCTY-27137 TRACT-    0014     IN DULUTH MN,3001,2999,2,2612,2,4192,42.56
G27013700015,STCTY-27137 TRACT-    0015     IN DULUTH MN,727,727,0,580,0,2804,0
G27013700016,STCTY-27137 TRACT-    0016     IN DULUTH MN,4811,4746,65,3769,56,2601,27.11
G27013700017,STCTY-27137 TRACT-    0017     IN DULUTH MN,4003,3997,6,3361,4,2880,32.62
G27013700018,STCTY-27137 TRACT-    0018     IN DULUTH MN,3399,3379,20,2709,3,2490,21.72
G27013700019,STCTY-27137 TRACT-    0019     IN DULUTH MN,3915,3883,32,2751,19,0,14.07
G27013700020,STCTY-27137 TRACT-    0020     IN DULUTH MN,1099,1098,1,877,0,3083,28.76
G27013700021,STCTY-27137 TRACT-    0021     IN DULUTH MN,3653,3609,44,2049,40,2138,19.32
G27013700022,STCTY-27137 TRACT-    0022     IN DULUTH MN,1501,1486,15,1326,5,2799,29.86
G27013700023,STCTY-27137 TRACT-    0023     IN DULUTH MN,1145,1145,0,967,0,2521,0
G27013700024,STCTY-27137 TRACT-    0024     IN DULUTH MN,2150,2150,0,1647,0,3440,28.21
G27013700025,STCTY-27137 TRACT-    0025     IN DULUTH MN,3814,3794,20,2913,7,1889,24.3
G27013700026,STCTY-27137 TRACT-    0026     IN DULUTH MN,3609,3609,0,2880,0,3194,29.31
G27013700027,STCTY-27137 TRACT-    0027     IN DULUTH MN,2670,2670,0,2097,0,3420,29.03
G27013700028,STCTY-27137 TRACT-    0028     IN DULUTH MN,3328,3328,0,2766,0,2250,25.89
G27013700029,STCTY-27137 TRACT-    0029     IN DULUTH MN,830,830,0,682,0,2739,0
G27013700030,STCTY-27137 TRACT-    0030     IN DULUTH MN,1925,1925,0,1607,0,3660,33.99
G27013700031,STCTY-27137 TRACT-    0031     IN DULUTH MN,4667,4667,0,3760,0,4216,34.61
G27013700032,STCTY-27137 TRACT-    0032     IN DULUTH MN,1554,1554,0,1221,0,2787,26.07
G27013700033,STCTY-27137 TRACT-    0033     IN DULUTH MN,4125,4120,5,3377,5,2391,26.68
G27013700034,STCTY-27137 TRACT-    0034     IN DULUTH MN,2681,2678,3,2140,3,2042,23.41
G27013700035,STCTY-27137 TRACT-    0035     IN DULUTH MN,1732,1722,10,1443,2,2030,25.53
G27013700036,STCTY-27137 TRACT-    0036     IN DULUTH MN,1824,1818,6,1552,6,2703,31.85
G27013700037,STCTY-27137 TRACT-    0037     IN DULUTH MN,2000,2000,0,1818,0,0,26.77
G27013700038,STCTY-27137 TRACT-    0038     IN DULUTH MN,3126,3060,66,2273,63,1981,23.56
G29009500001,STCTY-29095 TRACT-    0001     IN KANSAS CITY MO,240,130,110,113,110,0,0
G29009500002,STCTY-29095 TRACT-    0002     IN KANSAS CITY MO,2019,1944,75,1668,72,0,5.82
G29009500003,STCTY-29095 TRACT-    0003     IN KANSAS CITY MO,4241,3501,740,2463,738,665,12.88
G29009500004,STCTY-29095 TRACT-    0004     IN KANSAS CITY MO,2291,2247,44,2000,43,891,12.94
G29009500005,STCTY-29095 TRACT-    0005     IN KANSAS CITY MO,2498,2431,67,2312,67,1348,18.61
G29009500006,STCTY-29095 TRACT-    0006     IN KANSAS CITY MO,6156,6154,2,5976,2,2065,25.45
G29009500007,STCTY-29095 TRACT-    0007     IN KANSAS CITY MO,5309,5298,11,5104,11,3197,31.39
G29009500008,STCTY-29095 TRACT-    0008     IN KANSAS CITY MO,5601,5588,13,5357,12,2742,29.9
G29009500009,STCTY-29095 TRACT-    0009     IN KANSAS CITY MO,5340,5303,37,5010,37,2221,27.76
G29009500010,STCTY-29095 TRACT-    0010     IN KANSAS CITY MO,4931,4619,312,3928,311,1399,24.67
G29009500011,STCTY-29095 TRACT-    0011     IN KANSAS CITY MO,6661,6544,117,6342,108,0,16.71
G29009500012,STCTY-29095 TRACT-    0012     IN KANSAS CITY MO,2341,2278,63,2089,54,0,13.05
G29009500013,STCTY-29095 TRACT-    0013     IN KANSAS CITY MO,5002,4039,963,3825,957,0,15.51
G29009500014,STCTY-29095 TRACT-    0014     IN KANSAS CITY MO,4645,4155,490,3994,422,0,15.23
G29009500015,STCTY-29095 TRACT-    0015     IN KANSAS CITY MO,4497,4237,260,3902,258,0,19.89
G29009500016,STCTY-29095 TRACT-    0016     IN KANSAS CITY MO,6473,1860,4613,1804,4611,0,21.13
G29009500017,STCTY-29095 TRACT-    0017     IN KANSAS CITY MO,5584,3265,2319,2979,2317,1302,18.04
G29009500018,STCTY-29095 TRACT-    0018     IN KANSAS CITY MO,7460,7422,38,7100,37,2269,24.26
G29009500019,STCTY-29095 TRACT-    0019     IN KANSAS CITY MO,5993,5984,9,5822,8,1801,22.69
G29009500020,STCTY-29095 TRACT-    0020     IN KANSAS CITY MO,3883,3784,99,3627,99,1792,22.07
G29009500021,STCTY-29095 TRACT-    0021     IN KANSAS CITY MO,5366,5366,0,5154,0,1890,23.5
G29009500022,STCTY-29095 TRACT-    0022     IN KANSAS CITY MO,4480,4472,8,4349,8,2195,26.43
G29009500023,STCTY-29095 TRACT-    0023     IN KANSAS CITY MO,5321,4784,537,4679,537,1888,22.93
G29009500024,STCTY-29095 TRACT-    0024     IN KANSAS CITY MO,4219,3871,348,3708,344,1400,19.39
G29009500025,STCTY-29095 TRACT-    0025     IN KANSAS CITY MO,6098,1605,4493,1505,4493,1711,17.8
G29009500026,STCTY-29095 TRACT-    0026     IN KANSAS CITY MO,3630,155,3475,143,3475,0,15.3
G29009500027,STCTY-29095 TRACT-    0027     IN KANSAS CITY MO,2890,1392,1498,1335,1491,0,13.73
G29009500028,STCTY-29095 TRACT-    0028     IN KANSAS CITY MO,2439,2383,56,2286,40,0,12.98
G29009500029,STCTY-29095 TRACT-    0029     IN KANSAS CITY MO,6269,5990,279,5756,273,945,18.17
G29009500030,STCTY-29095 TRACT-    0030     IN KANSAS CITY MO,3857,3398,459,2707,458,558,13.03
G29009500031,STCTY-29095 TRACT-    0031     IN KANSAS CITY MO,1399,544,855,493,855,0,15.2
G29009500032,STCTY-29095 TRACT-    0032     IN KANSAS CITY MO,5059,119,4940,99,4940,1927,18.47
G29009500033,STCTY-29095 TRACT-    0033     IN KANSAS CITY MO,4344,3509,835,3395,835,1483,22.32
G29009500034,STCTY-29095 TRACT-    0034     IN KANSAS CITY MO,5888,5885,3,5734,3,2427,29.29
G29009500035,STCTY-29095 TRACT-    0035     IN KANSAS CITY MO,3919,3919,0,3758,0,2108,26.3
G29009500036,STCTY-29095 TRACT-    0036     IN KANSAS CITY MO,6638,6254,384,6051,384,2202,26.64
G29009500037,STCTY-29095 TRACT-    0037     IN KANSAS CITY MO,4688,4273,415,4051,415,1740,23.95
G29009500038,STCTY-29095 TRACT-    0038     IN KANSAS CITY MO,3869,3860,9,3643,9,3286,32.46
G29009500039,STCTY-29095 TRACT-    0039     IN KANSAS CITY MO,4445,1089,3356,1016,3356,2000,22
G29009500040,STCTY-29095 TRACT-    0040     IN KANSAS CITY MO,4536,4426,110,4027,108,2057,27.31
G29009500041,STCTY-29095 TRACT-    0041     IN KANSAS CITY MO,4995,1414,3581,1345,3581,1733,17.91
G29009500042,STCTY-29095 TRACT-    0042     IN KANSAS CITY MO,5020,4685,335,4373,334,2570,27.55
G29009500043,STCTY-29095 TRACT-    0043     IN KANSAS CITY MO,9742,9034,708,8645,705,2678,26.13
G29009500044,STCTY-29095 TRACT-    0044     IN KANSAS CITY MO,2371,2322,49,2209,48,0,22.72
G29009500045,STCTY-29095 TRACT-    0045     IN KANSAS CITY MO,3400,2596,804,2342,802,1146,17
G29009500046,STCTY-29095 TRACT-    0046     IN KANSAS CITY MO,3916,3865,51,3688,51,3828,37.5
G29009500047,STCTY-29095 TRACT-    0047     IN KANSAS CITY MO,4833,4755,78,4539,73,3347,34.15
G29009500048,STCTY-29095 TRACT-    0048     IN KANSAS CITY MO,5999,5841,158,5624,152,3893,38.14
G29009500049,STCTY-29095 TRACT-    0049     IN KANSAS CITY MO,6465,6367,98,6117,68,2429,26.18
G29009500050,STCTY-29095 TRACT-    0050     IN KANSAS CITY MO,4642,4548,94,4344,92,3739,38.83
G29009500051,STCTY-29095 TRACT-    0051     IN KANSAS CITY MO,3094,3029,65,2877,64,5598,34.75
G29009500052,STCTY-29095 TRACT-    0052     IN KANSAS CITY MO,6485,6380,105,5960,94,2601,34.46
G29009500053,STCTY-29095 TRACT-    0053     IN KANSAS CITY MO,5419,5327,92,4992,86,2830,32.73
G29009500054,STCTY-29095 TRACT-    0054     IN KANSAS CITY MO,4932,4884,48,4538,38,2584,32.62
G29009500055,STCTY-29095 TRACT-    0055     IN KANSAS CITY MO,4558,4542,16,4224,15,2558,31.88
G29009500056,STCTY-29095 TRACT-    0056     IN KANSAS CITY MO,8718,8679,39,8106,38,3264,36.71
G29009500057,STCTY-29095 TRACT-    0057     IN KANSAS CITY MO,3904,3900,4,3731,4,3324,36.4
G29009500058,STCTY-29095 TRACT-    0058     IN KANSAS CITY MO,3334,2543,791,2476,791,1686,18.38
G29009500059,STCTY-29095 TRACT-    0059     IN KANSAS CITY MO,1793,1408,385,1383,385,1610,18.22
G29009500060,STCTY-29095 TRACT-    0060     IN KANSAS CITY MO,1756,1756,0,1720,0,2710,26.26
G29009500061,STCTY-29095 TRACT-    0061     IN KANSAS CITY MO,5705,5697,8,5187,8,3539,42.08
G29009500062,STCTY-29095 TRACT-    0062     IN KANSAS CITY MO,3447,3439,8,3179,8,2717,32.49
G29009500063,STCTY-29095 TRACT-    0063     IN KANSAS CITY MO,4506,4480,26,4220,26,2588,32.58
G29009500064,STCTY-29095 TRACT-    0064     IN KANSAS CITY MO,4545,4523,22,4117,22,2769,33.2
G29009500065,STCTY-29095 TRACT-    0065     IN KANSAS CITY MO,3582,3520,62,3312,62,3144,36.95
G29009500066,STCTY-29095 TRACT-    0066     IN KANSAS CITY MO,3350,3277,73,3122,71,4432,40.56
G29009500067,STCTY-29095 TRACT-    0067     IN KANSAS CITY MO,4048,3972,76,3872,70,3206,38.95
G29009500068,STCTY-29095 TRACT-    0068     IN KANSAS CITY MO,3008,2852,156,2744,156,2819,27.02
G29009500069,STCTY-29095 TRACT-    0069     IN KANSAS CITY MO,3720,3391,329,3255,329,3012,42.26
G29009500070,STCTY-29095 TRACT-    0070     IN KANSAS CITY MO,4487,4472,15,4194,13,2927,34.52
G29009500071,STCTY-29095 TRACT-    0071     IN KANSAS CITY MO,4268,4254,14,3885,14,2993,36.17
G29009500072,STCTY-29095 TRACT-    0072     IN KANSAS CITY MO,3982,3875,107,3714,101,5601,57.69
G29009500073,STCTY-29095 TRACT-    0073     IN KANSAS CITY MO,3132,3069,63,2897,63,3766,54.04
G29009500074,STCTY-29095 TRACT-    0074     IN KANSAS CITY MO,4372,4310,62,4123,59,5670,45.96
G29009500075,STCTY-29095 TRACT-    0075     IN KANSAS CITY MO,4846,4833,13,4452,13,4218,48.02
G29009500076,STCTY-29095 TRACT-    0076     IN KANSAS CITY MO,4370,4360,10,4106,10,4141,43.2
G29009500077,STCTY-29095 TRACT-    0077     IN KANSAS CITY MO,2632,2267,365,2197,365,2855,32.94
G29009500078,STCTY-29095 TRACT-    0078     IN KANSAS CITY MO,2828,2822,6,2737,6,1919,22.09
G29009500079,STCTY-29095 TRACT-    0079     IN KANSAS CITY MO,4110,4108,2,3990,2,3168,32.21
G29009500080,STCTY-29095 TRACT-    0080     IN KANSAS CITY MO,3758,3755,3,3618,3,3717,40.64
G29009500081,STCTY-29095 TRACT-    0081     IN KANSAS CITY MO,3628,3617,11,3454,11,4379,46.24
G29009500082,STCTY-29095 TRACT-    0082     IN KANSAS CITY MO,4795,4775,20,4528,20,4996,55.24
G29009500083,STCTY-29095 TRACT-    0083     IN KANSAS CITY MO,3421,3357,64,3255,62,6622,0
G29009500084,STCTY-29095 TRACT-    0084     IN KANSAS CITY MO,3603,3435,168,3341,165,13412,85.44
G29009500085,STCTY-29095 TRACT-    0085     IN KANSAS CITY MO,3306,3218,88,3132,83,10571,97.66
G29009500086,STCTY-29095 TRACT-    0086     IN KANSAS CITY MO,6113,6054,59,5791,57,7116,76.04
G29009500087,STCTY-29095 TRACT-    0087     IN KANSAS CITY MO,3105,3105,0,2990,0,4201,44.95
G29009500088,STCTY-29095 TRACT-    0088     IN KANSAS CITY MO,4021,4019,2,3946,2,2915,30.5
G29009500089,STCTY-29095 TRACT-    0089     IN KANSAS CITY MO,1775,1772,3,1732,3,2478,26.11
G29009500090,STCTY-29095 TRACT-    0090     IN KANSAS CITY MO,3069,3064,5,2960,5,5087,48.31
G29009500091,STCTY-29095 TRACT-    0091     IN KANSAS CITY MO,3950,3927,23,3777,22,6380,52.38
G29009500092,STCTY-29095 TRACT-    0092     IN KANSAS CITY MO,3801,3775,26,3643,24,6355,48.07
G2901890SLC0001,STCTY-29189 TRACT-SLC 0001     IN ST.LOUIS MO-IL ADJ AREA,3426,3132,294,2975,292,3038,19.47
G2901890SLC0002,STCTY-29189 TRACT-SLC 0002     IN ST.LOUIS MO-IL ADJ AREA,2841,2833,8,2685,8,5083,22.19
G2901890SLC0003,STCTY-29189 TRACT-SLC 0003     IN ST.LOUIS MO-IL ADJ AREA,1119,1114,5,1069,5,0,0
G2901890SLC0004,STCTY-29189 TRACT-SLC 0004     IN ST.LOUIS MO-IL ADJ AREA,2126,2062,64,1992,64,2019,21.69
G2901890SLC0005,STCTY-29189 TRACT-SLC 0005     IN ST.LOUIS MO-IL ADJ AREA,1369,1363,6,1326,6,3209,19.13
G2901890SLC0006,STCTY-29189 TRACT-SLC 0006     IN ST.LOUIS MO-IL ADJ AREA,2008,1565,443,1500,443,987,0
G2901890SLC0007,STCTY-29189 TRACT-SLC 0007     IN ST.LOUIS MO-IL ADJ AREA,4643,4611,32,4483,25,2528,19.5
G2901890SLC0008,STCTY-29189 TRACT-SLC 0008     IN ST.LOUIS MO-IL ADJ AREA,169,95,74,91,74,0,0
G2901890SLC0009,STCTY-29189 TRACT-SLC 0009     IN ST.LOUIS MO-IL ADJ AREA,4762,1154,3608,1128,3607,1196,13.16
G2901890SLC0010,STCTY-29189 TRACT-SLC 0010     IN ST.LOUIS MO-IL ADJ AREA,2326,2305,21,2218,21,4495,38.35
G2901890SLC0011,STCTY-29189 TRACT-SLC 0011     IN ST.LOUIS MO-IL ADJ AREA,3398,3381,17,3249,17,4791,37.31
G2901890SLC0012,STCTY-29189 TRACT-SLC 0012     IN ST.LOUIS MO-IL ADJ AREA,719,719,0,696,0,3095,0
G2901890SLC0013,STCTY-29189 TRACT-SLC 0013     IN ST.LOUIS MO-IL ADJ AREA,4409,4405,4,4191,4,3679,30.03
G2901890SLC0014,STCTY-29189 TRACT-SLC 0014     IN ST.LOUIS MO-IL ADJ AREA,6062,6061,1,5765,1,3009,28.98
G2901890SLC0015,STCTY-29189 TRACT-SLC 0015     IN ST.LOUIS MO-IL ADJ AREA,6576,6571,5,6321,5,3797,33.51
G2901890SLC0016,STCTY-29189 TRACT-SLC 0016     IN ST.LOUIS MO-IL ADJ AREA,7973,7966,7,7702,6,4289,36.85
G2901890SLC0017,STCTY-29189 TRACT-SLC 0017     IN ST.LOUIS MO-IL ADJ AREA,2987,2983,4,2885,4,9688,52.09
G2901890SLC0018,STCTY-29189 TRACT-SLC 0018     IN ST.LOUIS MO-IL ADJ AREA,3991,3887,104,3630,87,6418,32.97
G2901890SLC0019,STCTY-29189 TRACT-SLC 0019     IN ST.LOUIS MO-IL ADJ AREA,2420,2420,0,2338,0,3771,34.13
G2901890SLC0020,STCTY-29189 TRACT-SLC 0020     IN ST.LOUIS MO-IL ADJ AREA,1941,1940,1,1886,1,3505,33.09
G2901890SLC0021,STCTY-29189 TRACT-SLC 0021     IN ST.LOUIS MO-IL ADJ AREA,1881,1881,0,1818,0,4215,34.36
G2901890SLC0022,STCTY-29189 TRACT-SLC 0022     IN ST.LOUIS MO-IL ADJ AREA,2174,2174,0,2112,0,2529,26.5
G2901890SLC0023,STCTY-29189 TRACT-SLC 0023     IN ST.LOUIS MO-IL ADJ AREA,5649,5612,37,5444,37,3502,31.12
G2901890SLC0024,STCTY-29189 TRACT-SLC 0024     IN ST.LOUIS MO-IL ADJ AREA,1642,1641,1,1609,1,2547,27.34
G2901890SLC0025,STCTY-29189 TRACT-SLC 0025     IN ST.LOUIS MO-IL ADJ AREA,2699,2546,153,2465,153,1898,18.08
G2901890SLC0026,STCTY-29189 TRACT-SLC 0026     IN ST.LOUIS MO-IL ADJ AREA,4000,3998,2,3866,2,4418,38.29
G2901890SLC0027,STCTY-29189 TRACT-SLC 0027     IN ST.LOUIS MO-IL ADJ AREA,3520,3518,2,3403,2,3901,34.5
G2901890SLC0028,STCTY-29189 TRACT-SLC 0028     IN ST.LOUIS MO-IL ADJ AREA,1995,1993,2,1916,1,3333,31.89
G2901890SLC0029,STCTY-29189 TRACT-SLC 0029     IN ST.LOUIS MO-IL ADJ AREA,2384,2341,43,2231,43,3286,32.5
G2901890SLC0030,STCTY-29189 TRACT-SLC 0030     IN ST.LOUIS MO-IL ADJ AREA,6151,5811,340,5585,340,2390,24.5
G2901890SLC0031,STCTY-29189 TRACT-SLC 0031     IN ST.LOUIS MO-IL ADJ AREA,2881,2732,149,2629,148,2979,25.7
G2901890SLC0032,STCTY-29189 TRACT-SLC 0032     IN ST.LOUIS MO-IL ADJ AREA,3210,3207,3,3049,2,2985,31.26
G2901890SLC0033,STCTY-29189 TRACT-SLC 0033     IN ST.LOUIS MO-IL ADJ AREA,10740,10617,123,8660,117,9056,48.7
G2901890SLC0034,STCTY-29189 TRACT-SLC 0034     IN ST.LOUIS MO-IL ADJ AREA,8688,8565,123,7929,122,10809,70.73
G2901890SLC0035,STCTY-29189 TRACT-SLC 0035     IN ST.LOUIS MO-IL ADJ AREA,4617,4607,10,4379,9,6183,45.62
G2901890SLC0036,STCTY-29189 TRACT-SLC 0036     IN ST.LOUIS MO-IL ADJ AREA,1121,1118,3,1036,1,3225,36.72
G2901890SLC0037,STCTY-29189 TRACT-SLC 0037     IN ST.LOUIS MO-IL ADJ AREA,4647,4600,47,4422,47,11411,84.33
G2901890SLC0038,STCTY-29189 TRACT-SLC 0038     IN ST.LOUIS MO-IL ADJ AREA,987,967,20,930,20,6422,0
G2901890SLC0039,STCTY-29189 TRACT-SLC 0039     IN ST.LOUIS MO-IL ADJ AREA,1291,803,488,774,488,1456,0
G2901890SLC0040,STCTY-29189 TRACT-SLC 0040     IN ST.LOUIS MO-IL ADJ AREA,1546,1538,8,1448,8,5077,26.22
G2901890SLC0041,STCTY-29189 TRACT-SLC 0041     IN ST.LOUIS MO-IL ADJ AREA,1931,1851,80,1754,79,6434,21.53
G2901890SLC0042,STCTY-29189 TRACT-SLC 0042     IN ST.LOUIS MO-IL ADJ AREA,1271,1200,71,1145,71,18352,0
G2901890SLC0043,STCTY-29189 TRACT-SLC 0043     IN ST.LOUIS MO-IL ADJ AREA,2710,2528,182,2443,168,20000,0
G2901890SLC0044,STCTY-29189 TRACT-SLC 0044     IN ST.LOUIS MO-IL ADJ AREA,2293,2211,82,2130,82,10029,55.59
G2901890SLC0045,STCTY-29189 TRACT-SLC 0045     IN ST.LOUIS MO-IL ADJ AREA,6578,6308,270,5973,269,14861,80.05
G2901890SLC0046,STCTY-29189 TRACT-SLC 0046     IN ST.LOUIS MO-IL ADJ AREA,4198,4144,54,3661,53,13252,51.91
G2901890SLC0047,STCTY-29189 TRACT-SLC 0047     IN ST.LOUIS MO-IL ADJ AREA,73,62,11,58,11,0,0
G2901890SLC0048,STCTY-29189 TRACT-SLC 0048     IN ST.LOUIS MO-IL ADJ AREA,5616,5604,12,5305,11,5458,44.27
G2901890SLC0049,STCTY-29189 TRACT-SLC 0049     IN ST.LOUIS MO-IL ADJ AREA,5520,4658,862,4451,862,5915,45.24
G2901890SLC0050,STCTY-29189 TRACT-SLC 0050     IN ST.LOUIS MO-IL ADJ AREA,1666,1629,37,1545,37,15625,52.56
G2901890SLC0051,STCTY-29189 TRACT-SLC 0051     IN ST.LOUIS MO-IL ADJ AREA,4390,4025,365,3852,365,4766,35.13
G2901890SLC0052,STCTY-29189 TRACT-SLC 0052     IN ST.LOUIS MO-IL ADJ AREA,2461,2332,129,2222,129,3696,34.21
G2901890SLC0053,STCTY-29189 TRACT-SLC 0053     IN ST.LOUIS MO-IL ADJ AREA,4128,4123,5,3963,4,4672,37.03
G2901890SLC0054,STCTY-29189 TRACT-SLC 0054     IN ST.LOUIS MO-IL ADJ AREA,4814,4813,1,4600,1,3624,31.68
G2901890SLC0055,STCTY-29189 TRACT-SLC 0055     IN ST.LOUIS MO-IL ADJ AREA,1472,1465,7,1385,7,3809,31.67
G2901890SLC0056,STCTY-29189 TRACT-SLC 0056     IN ST.LOUIS MO-IL ADJ AREA,2182,2179,3,2092,3,4856,42.22
G2901890SLC0057,STCTY-29189 TRACT-SLC 0057     IN ST.LOUIS MO-IL ADJ AREA,5318,5172,146,4976,146,5558,53.31
G2901890SLC0058,STCTY-29189 TRACT-SLC 0058     IN ST.LOUIS MO-IL ADJ AREA,2889,2856,33,2756,29,7821,64.1
G2901890SLC0059,STCTY-29189 TRACT-SLC 0059     IN ST.LOUIS MO-IL ADJ AREA,2998,2114,884,2049,884,4548,28.85
G2901890SLC0060,STCTY-29189 TRACT-SLC 0060     IN ST.LOUIS MO-IL ADJ AREA,3543,3496,47,3384,47,9681,70.44
G2901890SLC0061,STCTY-29189 TRACT-SLC 0061     IN ST.LOUIS MO-IL ADJ AREA,3646,3637,9,3491,9,5492,49.16
G2901890SLC0062,STCTY-29189 TRACT-SLC 0062     IN ST.LOUIS MO-IL ADJ AREA,1013,469,544,456,544,1950,19.08
G2901890SLC0063,STCTY-29189 TRACT-SLC 0063     IN ST.LOUIS MO-IL ADJ AREA,1821,1821,0,1751,0,4744,33.83
G2901890SLC0064,STCTY-29189 TRACT-SLC 0064     IN ST.LOUIS MO-IL ADJ AREA,153,153,0,148,0,0,0
G2901890SLC0065,STCTY-29189 TRACT-SLC 0065     IN ST.LOUIS MO-IL ADJ AREA,2526,2490,36,2391,36,7483,50.33
G2901890SLC0066,STCTY-29189 TRACT-SLC 0066     IN ST.LOUIS MO-IL ADJ AREA,168,157,11,144,6,0,0
G2901890SLC0067,STCTY-29189 TRACT-SLC 0067     IN ST.LOUIS MO-IL ADJ AREA,1572,1558,14,1497,14,4895,43.53
G2901890SLC0068,STCTY-29189 TRACT-SLC 0068     IN ST.LOUIS MO-IL ADJ AREA,2477,2378,99,2310,99,5961,45.67
G2901890SLC0069,STCTY-29189 TRACT-SLC 0069     IN ST.LOUIS MO-IL ADJ AREA,1797,1775,22,1706,22,8497,48.31
G2901890SLC0070,STCTY-29189 TRACT-SLC 0070     IN ST.LOUIS MO-IL ADJ AREA,1837,1545,292,1519,292,5257,30.81
G2901890SLC0071,STCTY-29189 TRACT-SLC 0071     IN ST.LOUIS MO-IL ADJ AREA,3461,3115,346,2999,346,3932,31.06
G2901890SLC0072,STCTY-29189 TRACT-SLC 0072     IN ST.LOUIS MO-IL ADJ AREA,988,986,2,960,2,6413,0
G2901890SLC0073,STCTY-29189 TRACT-SLC 0073     IN ST.LOUIS MO-IL ADJ AREA,1910,1820,90,1768,88,2875,15.31
G2901890SLC0074,STCTY-29189 TRACT-SLC 0074     IN ST.LOUIS MO-IL ADJ AREA,1863,1806,57,1753,57,3950,18.67
G2901890SLC0075,STCTY-29189 TRACT-SLC 0075     IN ST.LOUIS MO-IL ADJ AREA,2439,2379,60,2295,60,2714,16.13
G2901890SLC0076,STCTY-29189 TRACT-SLC 0076     IN ST.LOUIS MO-IL ADJ AREA,2091,2048,43,2006,43,1768,16.69
G2901890SLC0077,STCTY-29189 TRACT-SLC 0077     IN ST.LOUIS MO-IL ADJ AREA,3660,2816,844,2713,844,2213,16.82
G2901890SLC0078,STCTY-29189 TRACT-SLC 0078     IN ST.LOUIS MO-IL ADJ AREA,789,768,21,727,21,5800,0
G2901890SLC0079,STCTY-29189 TRACT-SLC 0079     IN ST.LOUIS MO-IL ADJ AREA,1791,1769,22,1684,22,5396,21.85
G2901890SLC0080,STCTY-29189 TRACT-SLC 0080     IN ST.LOUIS MO-IL ADJ AREA,1103,1103,0,1044,0,4766,0
G2901890SLC0081,STCTY-29189 TRACT-SLC 0081     IN ST.LOUIS MO-IL ADJ AREA,5066,5065,1,4541,1,3300,31.62
G2901890SLC0082,STCTY-29189 TRACT-SLC 0082     IN ST.LOUIS MO-IL ADJ AREA,2494,2494,0,2362,0,5163,37.76
G2901890SLC0083,STCTY-29189 TRACT-SLC 0083     IN ST.LOUIS MO-IL ADJ AREA,1888,1885,3,1754,2,5109,28.33
G2901890SLC0084,STCTY-29189 TRACT-SLC 0084     IN ST.LOUIS MO-IL ADJ AREA,1910,1909,1,1808,1,4385,0
G2901890SLC0085,STCTY-29189 TRACT-SLC 0085     IN ST.LOUIS MO-IL ADJ AREA,4439,4285,154,3995,151,4270,21.53
G2901890SLC0086,STCTY-29189 TRACT-SLC 0086     IN ST.LOUIS MO-IL ADJ AREA,3280,3279,1,3094,1,4058,29.14
G2901890SLC0087,STCTY-29189 TRACT-SLC 0087     IN ST.LOUIS MO-IL ADJ AREA,9217,9193,24,8608,18,2313,25.09
G2901890SLC0088,STCTY-29189 TRACT-SLC 0088     IN ST.LOUIS MO-IL ADJ AREA,765,763,2,754,2,0,0
G29051000001A,STCTY-29510 TRACT-    0001-A   IN ST.LOUIS MO,1169,1169,0,1057,0,2970,29.13
G29051000001B,STCTY-29510 TRACT-    0001-B   IN ST.LOUIS MO,1714,1713,1,1594,1,6266,43.12
G29051000001C,STCTY-29510 TRACT-    0001-C   IN ST.LOUIS MO,6229,6225,4,5913,4,6586,45.04
G29051000001D,STCTY-29510 TRACT-    0001-D   IN ST.LOUIS MO,4856,4674,182,4433,182,4486,34.76
G29051000001E,STCTY-29510 TRACT-    0001-E   IN ST.LOUIS MO,5583,5570,13,5268,13,2363,22.47
G29051000001F,STCTY-29510 TRACT-    0001-F   IN ST.LOUIS MO,2645,2557,88,2415,88,1419,17.24
G29051000001G,STCTY-29510 TRACT-    0001-G   IN ST.LOUIS MO,5814,5500,314,5041,314,2656,23.56
G29051000002A,STCTY-29510 TRACT-    0002-A   IN ST.LOUIS MO,2442,2442,0,2229,0,3944,36.26
G29051000002B,STCTY-29510 TRACT-    0002-B   IN ST.LOUIS MO,6660,6659,1,6299,1,5824,44.16
G29051000002C,STCTY-29510 TRACT-    0002-C   IN ST.LOUIS MO,1400,1400,0,1282,0,3333,32.52
G29051000002D,STCTY-29510 TRACT-    0002-D   IN ST.LOUIS MO,3582,3582,0,3312,0,3802,35.16
G29051000002E,STCTY-29510 TRACT-    0002-E   IN ST.LOUIS MO,2500,2499,1,2301,1,4422,37.88
G29051000003A,STCTY-29510 TRACT-    0003-A   IN ST.LOUIS MO,1424,1424,0,1369,0,6977,34.24
G29051000003B,STCTY-29510 TRACT-    0003-B   IN ST.LOUIS MO,3589,3589,0,3442,0,5204,38.03
G29051000003C,STCTY-29510 TRACT-    0003-C   IN ST.LOUIS MO,1302,1301,1,1247,0,3027,26.57
G29051000003D,STCTY-29510 TRACT-    0003-D   IN ST.LOUIS MO,3434,3433,1,3261,1,4132,37.83
G29051000003E,STCTY-29510 TRACT-    0003-E   IN ST.LOUIS MO,1285,1279,6,1233,6,3224,22.38
G29051000003F,STCTY-29510 TRACT-    0003-F   IN ST.LOUIS MO,1849,1849,0,1756,0,3612,30.62
G29051000003G,STCTY-29510 TRACT-    0003-G   IN ST.LOUIS MO,4092,4092,0,3859,0,4651,40.36
G29051000004A,STCTY-29510 TRACT-    0004-A   IN ST.LOUIS MO,4038,4035,3,3826,3,3825,31.27
G29051000004B,STCTY-29510 TRACT-    0004-B   IN ST.LOUIS MO,5602,5594,8,5164,8,4529,38.44
G29051000004C,STCTY-29510 TRACT-    0004-C   IN ST.LOUIS MO,3603,3528,75,3140,70,2992,31.57
G29051000004D,STCTY-29510 TRACT-    0004-D   IN ST.LOUIS MO,678,667,11,601,4,0,31.09
G29051000005A,STCTY-29510 TRACT-    0005-A   IN ST.LOUIS MO,4993,4915,78,4459,70,8201,55.42
G29051000005B,STCTY-29510 TRACT-    0005-B   IN ST.LOUIS MO,7402,7311,91,6132,90,6385,46.59
G29051000005C,STCTY-29510 TRACT-    0005-C   IN ST.LOUIS MO,7712,7490,222,7066,220,5375,44.31
G29051000005D,STCTY-29510 TRACT-    0005-D   IN ST.LOUIS MO,7008,6936,72,6144,71,3415,34.42
G29051000005E,STCTY-29510 TRACT-    0005-E   IN ST.LOUIS MO,9253,9197,56,8208,49,4776,37.71
G29051000006A,STCTY-29510 TRACT-    0006-A   IN ST.LOUIS MO,10995,10968,27,8519,26,3037,30.23
G29051000006B,STCTY-29510 TRACT-    0006-B   IN ST.LOUIS MO,6288,6272,16,5276,15,3107,31.94
G29051000006C,STCTY-29510 TRACT-    0006-C   IN ST.LOUIS MO,8442,8432,10,7590,0,2813,32.76
G29051000006D,STCTY-29510 TRACT-    0006-D   IN ST.LOUIS MO,7243,7046,197,6631,196,3090,33.91
G29051000006E,STCTY-29510 TRACT-    0006-E   IN ST.LOUIS MO,8373,8354,19,7489,19,3212,32.12
G29051000006F,STCTY-29510 TRACT-    0006-F   IN ST.LOUIS MO,8448,8419,29,7238,27,3320,31.45
G29051000006G,STCTY-29510 TRACT-    0006-G   IN ST.LOUIS MO,8183,8181,2,7645,2,3973,31.87
G29051000007A,STCTY-29510 TRACT-    0007-A   IN ST.LOUIS MO,809,806,3,765,3,4826,0
G29051000007B,STCTY-29510 TRACT-    0007-B   IN ST.LOUIS MO,3541,3541,0,3238,0,3331,32.07
G29051000007C,STCTY-29510 TRACT-    0007-C   IN ST.LOUIS MO,5512,5509,3,5128,1,3927,36.37
G29051000007D,STCTY-29510 TRACT-    0007-D   IN ST.LOUIS MO,6852,6850,2,6307,2,3025,29.5
G29051000007E,STCTY-29510 TRACT-    0007-E   IN ST.LOUIS MO,6444,6443,1,6110,0,3910,38.42
G29051000007F,STCTY-29510 TRACT-    0007-F   IN ST.LOUIS MO,4319,4308,11,4116,11,4092,36.8
G29051000007G,STCTY-29510 TRACT-    0007-G   IN ST.LOUIS MO,6803,6800,3,6476,3,5221,39.44
G29051000008A,STCTY-29510 TRACT-    0008-A   IN ST.LOUIS MO,3768,3766,2,3520,2,5603,29.66
G29051000008B,STCTY-29510 TRACT-    0008-B   IN ST.LOUIS MO,2025,2025,0,1928,0,6889,35.94
G29051000008C,STCTY-29510 TRACT-    0008-C   IN ST.LOUIS MO,1801,1801,0,1685,0,3562,26.47
G29051000008D,STCTY-29510 TRACT-    0008-D   IN ST.LOUIS MO,944,927,17,860,17,3071,25.47
G29051000008E,STCTY-29510 TRACT-    0008-E   IN ST.LOUIS MO,1496,1413,83,1305,83,0,21.87
G29051000008F,STCTY-29510 TRACT-    0008-F   IN ST.LOUIS MO,299,287,12,251,12,0,0
G29051000009A,STCTY-29510 TRACT-    0009-A   IN ST.LOUIS MO,6246,6242,4,5921,4,3967,37.41
G29051000009B,STCTY-29510 TRACT-    0009-B   IN ST.LOUIS MO,997,897,100,847,100,0,18.14
G29051000009C,STCTY-29510 TRACT-    0009-C   IN ST.LOUIS MO,5989,5881,108,5582,108,2777,24.87
G29051000009D,STCTY-29510 TRACT-    0009-D   IN ST.LOUIS MO,3698,3650,48,3459,48,1940,23.91
G29051000009E,STCTY-29510 TRACT-    0009-E   IN ST.LOUIS MO,5170,5129,41,4778,41,1917,21.65
G29051000010A,STCTY-29510 TRACT-    0010-A   IN ST.LOUIS MO,7624,7608,16,7125,15,3551,31.75
G29051000010B,STCTY-29510 TRACT-    0010-B   IN ST.LOUIS MO,7062,7011,51,6673,48,2969,32.1
G29051000010C,STCTY-29510 TRACT-    0010-C   IN ST.LOUIS MO,8505,6894,1611,6519,1611,3213,31.45
G29051000010D,STCTY-29510 TRACT-    0010-D   IN ST.LOUIS MO,6900,6883,17,6562,11,3755,35.09
G29051000010E,STCTY-29510 TRACT-    0010-E   IN ST.LOUIS MO,6933,6929,4,6524,2,2527,25.16
G29051000011A,STCTY-29510 TRACT-    0011-A   IN ST.LOUIS MO,13686,853,12833,770,12830,3271,27.47
G29051000011B,STCTY-29510 TRACT-    0011-B   IN ST.LOUIS MO,10803,5556,5247,5077,5242,2601,25.53
G29051000011C,STCTY-29510 TRACT-    0011-C   IN ST.LOUIS MO,10508,1031,9477,941,9474,2325,24.11
G29051000011D,STCTY-29510 TRACT-    0011-D   IN ST.LOUIS MO,8830,6588,2242,6208,2242,2289,25.8
G29051000011E,STCTY-29510 TRACT-    0011-E   IN ST.LOUIS MO,8903,7642,1261,7106,1259,1994,21.04
G29051000012A,STCTY-29510 TRACT-    0012-A   IN ST.LOUIS MO,8989,8752,237,8118,230,12278,48.48
G29051000012B,STCTY-29510 TRACT-    0012-B   IN ST.LOUIS MO,7948,7899,49,6952,32,3535,32.72
G29051000012C,STCTY-29510 TRACT-    0012-C   IN ST.LOUIS MO,8843,8727,116,7418,106,2387,27.67
G29051000012D,STCTY-29510 TRACT-    0012-D   IN ST.LOUIS MO,8110,7965,145,7428,141,7893,53.96
G29051000013A,STCTY-29510 TRACT-    0013-A   IN ST.LOUIS MO,8323,7801,522,6483,522,2856,27.66
G29051000013B,STCTY-29510 TRACT-    0013-B   IN ST.LOUIS MO,3602,3602,0,2430,0,2797,23.88
G29051000013C,STCTY-29510 TRACT-    0013-C   IN ST.LOUIS MO,2094,2065,29,1360,29,2121,24.46
G29051000013D,STCTY-29510 TRACT-    0013-D   IN ST.LOUIS MO,1819,1817,2,1633,2,3881,30.98
G29051000014A,STCTY-29510 TRACT-    0014-A   IN ST.LOUIS MO,8925,8901,24,8531,24,7159,42.6
G29051000014B,STCTY-29510 TRACT-    0014-B   IN ST.LOUIS MO,3267,3267,0,3135,0,5167,43.11
G29051000014C,STCTY-29510 TRACT-    0014-C   IN ST.LOUIS MO,8128,8127,1,7682,1,5739,43.2
G29051000015A,STCTY-29510 TRACT-    0015-A   IN ST.LOUIS MO,5325,5325,0,4859,0,3633,36.7
G29051000015B,STCTY-29510 TRACT-    0015-B   IN ST.LOUIS MO,3890,3890,0,3603,0,3386,33.39
G29051000015C,STCTY-29510 TRACT-    0015-C   IN ST.LOUIS MO,6618,6614,4,6192,4,3756,36.44
G29051000015D,STCTY-29510 TRACT-    0015-D   IN ST.LOUIS MO,4517,4513,4,4103,3,3636,35.58
G29051000015E,STCTY-29510 TRACT-    0015-E   IN ST.LOUIS MO,9469,9456,13,8779,13,3708,32.81
G29051000015F,STCTY-29510 TRACT-    0015-F   IN ST.LOUIS MO,8379,8133,246,7490,245,2886,30.4
G29051000015G,STCTY-29510 TRACT-    0015-G   IN ST.LOUIS MO,6331,6300,31,5907,31,3427,32.67
G29051000016A,STCTY-29510 TRACT-    0016-A   IN ST.LOUIS MO,4164,4163,1,3908,1,4822,38.15
G29051000016B,STCTY-29510 TRACT-    0016-B   IN ST.LOUIS MO,8275,8273,2,7707,2,4222,35
G29051000016C,STCTY-29510 TRACT-    0016-C   IN ST.LOUIS MO,9883,9866,17,9223,14,4216,37.58
G29051000016D,STCTY-29510 TRACT-    0016-D   IN ST.LOUIS MO,8847,8840,7,8046,7,2942,31.49
G29051000016E,STCTY-29510 TRACT-    0016-E   IN ST.LOUIS MO,8097,8070,27,7426,26,3399,33.76
G29051000017A,STCTY-29510 TRACT-    0017-A   IN ST.LOUIS MO,4175,4169,6,3955,6,6511,36.11
G29051000017B,STCTY-29510 TRACT-    0017-B   IN ST.LOUIS MO,14429,14411,18,13640,18,4264,34.25
G29051000017C,STCTY-29510 TRACT-    0017-C   IN ST.LOUIS MO,10056,10025,31,9550,21,4438,31.26
G29051000017D,STCTY-29510 TRACT-    0017-D   IN ST.LOUIS MO,8489,8456,33,7907,33,4350,34.86
G29051000018A,STCTY-29510 TRACT-    0018-A   IN ST.LOUIS MO,6868,6855,13,6583,12,2363,21.79
G29051000018B,STCTY-29510 TRACT-    0018-B   IN ST.LOUIS MO,8165,7895,270,7321,262,2735,26.25
G29051000018C,STCTY-29510 TRACT-    0018-C   IN ST.LOUIS MO,1928,1688,240,1545,240,0,19.91
G29051000018D,STCTY-29510 TRACT-    0018-D   IN ST.LOUIS MO,4287,139,4148,117,4147,0,18.83
G29051000018E,STCTY-29510 TRACT-    0018-E   IN ST.LOUIS MO,6820,3548,3272,3318,3271,2273,18.48
G29051000019A,STCTY-29510 TRACT-    0019-A   IN ST.LOUIS MO,10267,10131,136,9525,106,4257,34.97
G29051000019B,STCTY-29510 TRACT-    0019-B   IN ST.LOUIS MO,8236,6739,1497,6344,1408,4792,22.96
G29051000019C,STCTY-29510 TRACT-    0019-C   IN ST.LOUIS MO,8831,8502,329,7964,266,4065,22.27
G29051000020A,STCTY-29510 TRACT-    0020-A   IN ST.LOUIS MO,7273,5033,2240,4680,2240,1942,18.75
G29051000020B,STCTY-29510 TRACT-    0020-B   IN ST.LOUIS MO,5604,5559,45,5154,42,2186,21.53
G29051000020C,STCTY-29510 TRACT-    0020-C   IN ST.LOUIS MO,13114,13020,94,12096,94,1856,19.44
G29051000021A,STCTY-29510 TRACT-    0021-A   IN ST.LOUIS MO,10341,642,9699,552,9692,0,21.65
G29051000021B,STCTY-29510 TRACT-    0021-B   IN ST.LOUIS MO,12015,698,11317,567,11298,3643,21.31
G29051000021C,STCTY-29510 TRACT-    0021-C   IN ST.LOUIS MO,14874,2676,12198,2131,12196,1786,16.11
G29051000021D,STCTY-29510 TRACT-    0021-D   IN ST.LOUIS MO,6554,815,5739,700,5735,0,17.74
G29051000022A,STCTY-29510 TRACT-    0022-A   IN ST.LOUIS MO,10036,4066,5970,3683,5964,2457,17.52
G29051000022B,STCTY-29510 TRACT-    0022-B   IN ST.LOUIS MO,5799,561,5238,475,5238,0,16.41
G29051000022C,STCTY-29510 TRACT-    0022-C   IN ST.LOUIS MO,972,714,258,606,258,0,10.96
G29051000022D,STCTY-29510 TRACT-    0022-D   IN ST.LOUIS MO,9578,9305,273,8678,260,1890,13.25
G29051000023A,STCTY-29510 TRACT-    0023-A   IN ST.LOUIS MO,12475,12461,14,11712,10,2277,23.66
G29051000023B,STCTY-29510 TRACT-    0023-B   IN ST.LOUIS MO,11355,11339,16,10260,3,1821,16.08
G29051000023C,STCTY-29510 TRACT-    0023-C   IN ST.LOUIS MO,9923,9918,5,8792,3,1972,21.12
G29051000023D,STCTY-29510 TRACT-    0023-D   IN ST.LOUIS MO,17865,17683,182,15690,166,1302,14.71
G29051000023E,STCTY-29510 TRACT-    0023-E   IN ST.LOUIS MO,8050,6719,1331,6055,1331,1375,11.71
G29051000024A,STCTY-29510 TRACT-    0024-A   IN ST.LOUIS MO,10453,10444,9,9619,8,3062,28.3
G29051000024B,STCTY-29510 TRACT-    0024-B   IN ST.LOUIS MO,7981,7976,5,7213,5,2320,24.63
G29051000024C,STCTY-29510 TRACT-    0024-C   IN ST.LOUIS MO,11296,11293,3,10157,3,1940,20.58
G29051000024D,STCTY-29510 TRACT-    0024-D   IN ST.LOUIS MO,2538,2538,0,2299,0,0,17.74
G29051000024E,STCTY-29510 TRACT-    0024-E   IN ST.LOUIS MO,3595,3588,7,3299,7,2141,20.93
G29051000025A,STCTY-29510 TRACT-    0025-A   IN ST.LOUIS MO,2891,1938,953,1648,943,0,11.17
G29051000025B,STCTY-29510 TRACT-    0025-B   IN ST.LOUIS MO,10939,4323,6616,3280,6614,1462,12.94
G29051000025C,STCTY-29510 TRACT-    0025-C   IN ST.LOUIS MO,3165,3061,104,2602,52,0,13.84
G29051000025D,STCTY-29510 TRACT-    0025-D   IN ST.LOUIS MO,1055,985,70,823,59,0,6.44
G29051000026A,STCTY-29510 TRACT-    0026-A   IN ST.LOUIS MO,11689,11558,131,10386,131,1808,15.91
G29051000026B,STCTY-29510 TRACT-    0026-B   IN ST.LOUIS MO,4303,3816,487,3463,487,1430,13.36
G29051000026C,STCTY-29510 TRACT-    0026-C   IN ST.LOUIS MO,7267,7228,39,6859,39,1583,17.14
G29051000026D,STCTY-29510 TRACT-    0026-D   IN ST.LOUIS MO,5535,5528,7,5066,7,1675,16.74
G29051000026E,STCTY-29510 TRACT-    0026-E   IN ST.LOUIS MO,4822,4813,9,4441,7,1850,19.71
G34000100001,STCTY-34001 TRACT-    0001     IN ATLANTIC CITY NJ,989,989,0,896,0,0,28.8
G34000100002,STCTY-34001 TRACT-    0002     IN ATLANTIC CITY NJ,2632,2575,57,2197,56,6831,57.6
G34000100003,STCTY-34001 TRACT-    0003     IN ATLANTIC CITY NJ,2424,2422,2,2109,2,5703,43.28
G34000100004,STCTY-34001 TRACT-    0004     IN ATLANTIC CITY NJ,3405,3376,29,2801,29,9010,51.89
G34000100005,STCTY-34001 TRACT-    0005     IN ATLANTIC CITY NJ,3729,3722,7,3157,2,3406,35.74
G34000100006,STCTY-34001 TRACT-    0006     IN ATLANTIC CITY NJ,3481,3480,1,2661,1,3700,28.99
G34000100007,STCTY-34001 TRACT-    0007     IN ATLANTIC CITY NJ,2923,2902,21,2071,5,0,34.83
G34000100008,STCTY-34001 TRACT-    0008     IN ATLANTIC CITY NJ,5599,5544,55,4594,44,9167,41.29
G34000100009,STCTY-34001 TRACT-    0009     IN ATLANTIC CITY NJ,4170,4146,24,3561,10,0,38.11
G34000100010,STCTY-34001 TRACT-    0010     IN ATLANTIC CITY NJ,4092,459,3633,378,3628,0,23.79
G34000100011,STCTY-34001 TRACT-    0011     IN ATLANTIC CITY NJ,2278,33,2245,21,2245,0,30.99
G34000100012,STCTY-34001 TRACT-    0012     IN ATLANTIC CITY NJ,2830,101,2729,87,2728,3241,27.97
G34000100013,STCTY-34001 TRACT-    0013     IN ATLANTIC CITY NJ,551,551,0,516,0,0,0
G34000100014,STCTY-34001 TRACT-    0014     IN ATLANTIC CITY NJ,2269,1745,524,1589,508,3074,34.6
G34000100015,STCTY-34001 TRACT-    0015     IN ATLANTIC CITY NJ,3962,75,3887,48,3885,0,29.18
G34000100016,STCTY-34001 TRACT-    0016     IN ATLANTIC CITY NJ,3347,1829,1518,1487,1518,0,34.98
G34000100017,STCTY-34001 TRACT-    0017     IN ATLANTIC CITY NJ,3092,2103,989,1811,987,3393,32.33
G34000100018,STCTY-34001 TRACT-    0018     IN ATLANTIC CITY NJ,2586,2576,10,2081,6,0,36.31
G34000100019,STCTY-34001 TRACT-    0019     IN ATLANTIC CITY NJ,3269,3262,7,2362,6,0,42.1
G34000100020,STCTY-34001 TRACT-    0020     IN ATLANTIC CITY NJ,3958,3957,1,3469,0,2870,35.65
G34000100021,STCTY-34001 TRACT-    0021     IN ATLANTIC CITY NJ,2485,2485,0,2242,0,0,28.53
G34000100022,STCTY-34001 TRACT-    0022     IN ATLANTIC CITY NJ,16,8,8,7,8,0,0
G34000100023,STCTY-34001 TRACT-    0023     IN ATLANTIC CITY NJ,7,7,0,7,0,0,0
G34000700001,STCTY-34007 TRACT-    0001     IN CAMDEN NJ,4042,4042,0,3735,0,2412,31.49
G34000700002,STCTY-34007 TRACT-    0002     IN CAMDEN NJ,4428,4424,4,4044,4,2298,29.25
G34000700003,STCTY-34007 TRACT-    0003     IN CAMDEN NJ,4003,4003,0,3657,0,2688,29.85
G34000700004,STCTY-34007 TRACT-    0004     IN CAMDEN NJ,4446,4185,261,3920,261,2270,27.3
G34000700005,STCTY-34007 TRACT-    0005     IN CAMDEN NJ,6058,5904,154,5432,152,3477,37.18
G34000700006,STCTY-34007 TRACT-    0006     IN CAMDEN NJ,6296,6293,3,5863,2,3753,36.37
G34000700007,STCTY-34007 TRACT-    0007     IN CAMDEN NJ,6463,6439,24,5942,23,3152,32.71
G34000700008,STCTY-34007 TRACT-    0008     IN CAMDEN NJ,4577,4574,3,4097,0,2446,22.22
G34000700009,STCTY-34007 TRACT-    0009     IN CAMDEN NJ,5779,5768,11,5279,0,2427,25.61
G34000700010,STCTY-34007 TRACT-    0010     IN CAMDEN NJ,5556,3985,1571,3642,1565,2920,26.26
G34000700011,STCTY-34007 TRACT-    0011     IN CAMDEN NJ,5703,5016,687,4249,678,3120,26.53
G34000700012,STCTY-34007 TRACT-    0012     IN CAMDEN NJ,5181,4295,886,2998,881,2201,24.2
G34000700013,STCTY-34007 TRACT-    0013     IN CAMDEN NJ,3538,1936,1602,1550,1597,1963,21.99
G34000700014,STCTY-34007 TRACT-    0014     IN CAMDEN NJ,5478,5247,231,3882,231,2449,25.99
G34000700015,STCTY-34007 TRACT-    0015     IN CAMDEN NJ,4282,2478,1804,2142,1802,2241,26.04
G34000700016,STCTY-34007 TRACT-    0016     IN CAMDEN NJ,4106,2412,1694,2001,1688,2304,27.53
G34000700017,STCTY-34007 TRACT-    0017     IN CAMDEN NJ,4929,3272,1657,2642,1650,2109,22.84
G34000700018,STCTY-34007 TRACT-    0018     IN CAMDEN NJ,5467,3930,1537,3006,1533,2409,24.16
G34000700019,STCTY-34007 TRACT-    0019     IN CAMDEN NJ,4031,3685,346,2687,345,2596,32.23
G34000700020,STCTY-34007 TRACT-    0020     IN CAMDEN NJ,5329,5303,26,4382,26,3824,42.42
G34000700021,STCTY-34007 TRACT-    0021     IN CAMDEN NJ,4357,4354,3,3343,3,2623,30.36
G34000700022,STCTY-34007 TRACT-    0022     IN CAMDEN NJ,4393,4387,6,3418,6,2696,32.67
G34000700023,STCTY-34007 TRACT-    0023     IN CAMDEN NJ,2958,2958,0,2514,0,2369,32.61
G34000700024,STCTY-34007 TRACT-    0024     IN CAMDEN NJ,6136,6105,31,5574,31,2958,37.58
G34001300001,STCTY-34013 TRACT-    0001     IN NEWARK NJ,3120,3113,7,2671,7,6865,50.07
G34001300002,STCTY-34013 TRACT-    0002     IN NEWARK NJ,2767,2327,440,1728,440,0,29.53
G34001300003,STCTY-34013 TRACT-    0003     IN NEWARK NJ,2588,2308,280,1743,280,3595,32.78
G34001300004,STCTY-34013 TRACT-    0004     IN NEWARK NJ,2539,2117,422,1594,420,0,35.55
G34001300005,STCTY-34013 TRACT-    0005     IN NEWARK NJ,1738,1694,44,1353,44,0,42.45
G34001300006,STCTY-34013 TRACT-    0006     IN NEWARK NJ,4486,4443,43,3558,43,5049,46.79
G34001300007,STCTY-34013 TRACT-    0007     IN NEWARK NJ,5148,5140,8,4538,7,5682,50.94
G34001300008,STCTY-34013 TRACT-    0008     IN NEWARK NJ,4580,4364,216,3446,215,4500,37.78
G34001300009,STCTY-34013 TRACT-    0009     IN NEWARK NJ,5100,5082,18,4328,18,4119,43.39
G34001300010,STCTY-34013 TRACT-    0010     IN NEWARK NJ,3712,3528,184,2906,183,2830,33.29
G34001300011,STCTY-34013 TRACT-    0011     IN NEWARK NJ,4363,3165,1198,2544,1197,3061,26.13
G34001300012,STCTY-34013 TRACT-    0012     IN NEWARK NJ,3914,2783,1131,2137,1130,3591,27.2
G34001300013,STCTY-34013 TRACT-    0013     IN NEWARK NJ,4192,3424,768,2647,768,4040,35.09
G34001300014,STCTY-34013 TRACT-    0014     IN NEWARK NJ,5583,5542,41,4337,41,3809,37.76
G34001300015,STCTY-34013 TRACT-    0015     IN NEWARK NJ,4145,3950,195,3311,194,5550,30.88
G34001300016,STCTY-34013 TRACT-    0016     IN NEWARK NJ,5445,4986,459,4140,454,4757,39.9
G34001300017,STCTY-34013 TRACT-    0017     IN NEWARK NJ,4931,4329,602,3567,601,4779,36.66
G34001300018,STCTY-34013 TRACT-    0018     IN NEWARK NJ,4933,4808,125,3737,124,3563,34.38
G34001300019,STCTY-34013 TRACT-    0019     IN NEWARK NJ,2617,2518,99,2054,98,4776,36.35
G34001300020,STCTY-34013 TRACT-    0020     IN NEWARK NJ,4412,4397,15,3730,15,5981,46.19
G34001300021,STCTY-34013 TRACT-    0021     IN NEWARK NJ,4063,4059,4,3608,3,6228,47.93
G34001300022,STCTY-34013 TRACT-    0022     IN NEWARK NJ,5373,5327,46,4452,44,7533,54.37
G34001300023,STCTY-34013 TRACT-    0023     IN NEWARK NJ,4502,4501,1,3868,0,6202,51
G34001300024,STCTY-34013 TRACT-    0024     IN NEWARK NJ,4680,4678,2,3897,0,5290,42.16
G34001300025,STCTY-34013 TRACT-    0025     IN NEWARK NJ,5047,5033,14,4317,9,5474,49.06
G34001300026,STCTY-34013 TRACT-    0026     IN NEWARK NJ,4526,4510,16,3140,16,3310,36.01
G34001300027,STCTY-34013 TRACT-    0027     IN NEWARK NJ,4588,4533,55,3202,55,0,33.32
G34001300028,STCTY-34013 TRACT-    0028     IN NEWARK NJ,2576,2559,17,1848,17,0,32.88
G34001300029,STCTY-34013 TRACT-    0029     IN NEWARK NJ,4997,4897,100,3429,96,3591,25.25
G34001300030,STCTY-34013 TRACT-    0030     IN NEWARK NJ,5124,3270,1854,2326,1854,0,24.22
G34001300031,STCTY-34013 TRACT-    0031     IN NEWARK NJ,4018,3306,712,2317,710,0,27.65
G34001300032,STCTY-34013 TRACT-    0032     IN NEWARK NJ,5027,4969,58,3601,57,0,30.14
G34001300033,STCTY-34013 TRACT-    0033     IN NEWARK NJ,4275,4229,46,3330,45,0,28.04
G34001300034,STCTY-34013 TRACT-    0034     IN NEWARK NJ,3619,3619,0,2548,0,0,31.88
G34001300035,STCTY-34013 TRACT-    0035     IN NEWARK NJ,3446,3446,0,2348,0,0,39.15
G34001300036,STCTY-34013 TRACT-    0036     IN NEWARK NJ,3842,3834,8,2883,7,5263,35.47
G34001300037,STCTY-34013 TRACT-    0037     IN NEWARK NJ,2912,2894,18,2000,13,0,35.68
G34001300038,STCTY-34013 TRACT-    0038     IN NEWARK NJ,5702,4998,704,3789,699,3314,31.66
G34001300039,STCTY-34013 TRACT-    0039     IN NEWARK NJ,3316,2044,1272,1436,1269,0,27.82
G34001300040,STCTY-34013 TRACT-    0040     IN NEWARK NJ,4856,4347,509,3195,502,0,34.49
G34001300041,STCTY-34013 TRACT-    0041     IN NEWARK NJ,4444,4417,27,3445,27,8400,49.16
G34001300042,STCTY-34013 TRACT-    0042     IN NEWARK NJ,4566,4563,3,3519,3,5980,46.65
G34001300043,STCTY-34013 TRACT-    0043     IN NEWARK NJ,4459,4422,37,3276,30,4229,46.55
G34001300044,STCTY-34013 TRACT-    0044     IN NEWARK NJ,3308,3304,4,2248,4,4820,49.79
G34001300045,STCTY-34013 TRACT-    0045     IN NEWARK NJ,4919,4910,9,3469,8,6000,53.9
G34001300046,STCTY-34013 TRACT-    0046     IN NEWARK NJ,4447,4429,18,3112,18,7185,52.86
G34001300047,STCTY-34013 TRACT-    0047     IN NEWARK NJ,5331,5288,43,4099,43,9526,64.11
G34001300048,STCTY-34013 TRACT-    0048     IN NEWARK NJ,4809,4791,18,3530,17,5700,40.9
G34001300049,STCTY-34013 TRACT-    0049     IN NEWARK NJ,4830,4806,24,3568,22,7948,55.59
G34001300050,STCTY-34013 TRACT-    0050     IN NEWARK NJ,4339,4182,157,2934,157,3325,41.39
G34001300051,STCTY-34013 TRACT-    0051     IN NEWARK NJ,4856,4842,14,3420,14,4681,53.34
G34001300052,STCTY-34013 TRACT-    0052     IN NEWARK NJ,3714,3688,26,2520,25,6714,44.52
G34001300053,STCTY-34013 TRACT-    0053     IN NEWARK NJ,4982,4957,25,3422,25,8232,47.99
G34001300054,STCTY-34013 TRACT-    0054     IN NEWARK NJ,6500,6481,19,4912,16,5639,38.9
G34001300055,STCTY-34013 TRACT-    0055     IN NEWARK NJ,4093,4025,68,3017,64,3575,36.04
G34001300056,STCTY-34013 TRACT-    0056     IN NEWARK NJ,3506,3506,0,2257,0,0,41.57
G34001300057,STCTY-34013 TRACT-    0057     IN NEWARK NJ,6651,5315,1336,4362,1309,4237,30.83
G34001300058,STCTY-34013 TRACT-    0058     IN NEWARK NJ,4692,4672,20,3374,20,5684,45.37
G34001300059,STCTY-34013 TRACT-    0059     IN NEWARK NJ,5455,4959,496,3968,489,5860,38.68
G34001300060,STCTY-34013 TRACT-    0060     IN NEWARK NJ,4312,1774,2538,1176,2537,0,30.06
G34001300061,STCTY-34013 TRACT-    0061     IN NEWARK NJ,3210,1475,1735,913,1733,0,24.21
G34001300062,STCTY-34013 TRACT-    0062     IN NEWARK NJ,5260,1129,4131,690,4118,0,28.24
G34001300063,STCTY-34013 TRACT-    0063     IN NEWARK NJ,3329,1249,2080,734,2077,0,22.63
G34001300064,STCTY-34013 TRACT-    0064     IN NEWARK NJ,6041,3567,2474,2575,2462,4071,29.25
G34001300065,STCTY-34013 TRACT-    0065     IN NEWARK NJ,3477,2260,1217,1618,1217,0,24
G34001300066,STCTY-34013 TRACT-    0066     IN NEWARK NJ,6220,1417,4803,934,4795,0,31.57
G34001300067,STCTY-34013 TRACT-    0067     IN NEWARK NJ,4373,4005,368,3232,351,0,42.29
G34001300068,STCTY-34013 TRACT-    0068     IN NEWARK NJ,5102,4088,1014,3294,968,3388,24.45
G34001300069,STCTY-34013 TRACT-    0069     IN NEWARK NJ,4636,4165,471,3122,456,3371,25.98
G34001300070,STCTY-34013 TRACT-    0070     IN NEWARK NJ,4976,4966,10,3761,10,3776,30.94
G34001300071,STCTY-34013 TRACT-    0071     IN NEWARK NJ,3471,3470,1,2624,1,4131,28.13
G34001300072,STCTY-34013 TRACT-    0072     IN NEWARK NJ,4338,4328,10,3328,0,3516,29.14
G34001300073,STCTY-34013 TRACT-    0073     IN NEWARK NJ,4512,4511,1,3444,0,2657,26.08
G34001300074,STCTY-34013 TRACT-    0074     IN NEWARK NJ,2560,2560,0,2027,0,3200,29.95
G34001300075,STCTY-34013 TRACT-    0075     IN NEWARK NJ,8031,7881,150,6421,146,3841,28.48
G34001300076,STCTY-34013 TRACT-    0076     IN NEWARK NJ,3551,3355,196,2229,196,3231,21.26
G34001300077,STCTY-34013 TRACT-    0077     IN NEWARK NJ,3770,3759,11,2563,8,2956,28.98
G34001300078,STCTY-34013 TRACT-    0078     IN NEWARK NJ,3791,3569,222,2469,222,1716,30.35
G34001300079,STCTY-34013 TRACT-    0079     IN NEWARK NJ,4362,4119,243,2484,241,4735,23.84
G34001300080,STCTY-34013 TRACT-    0080     IN NEWARK NJ,3818,2903,915,2136,772,5250,25.52
G34001300081,STCTY-34013 TRACT-    0081     IN NEWARK NJ,5582,3735,1847,2826,1820,0,27.69
G34001300082,STCTY-34013 TRACT-    0082     IN NEWARK NJ,4627,2386,2241,1789,2239,0,22.58
G34001300083,STCTY-34013 TRACT-    0083     IN NEWARK NJ,4329,3049,1280,2238,1278,0,25.45
G34001300084,STCTY-34013 TRACT-    0084     IN NEWARK NJ,3469,2311,1158,1779,1150,3690,22.57
G34001300085,STCTY-34013 TRACT-    0085     IN NEWARK NJ,6863,6389,474,5207,455,5350,32.06
G34001300086,STCTY-34013 TRACT-    0086     IN NEWARK NJ,4766,4299,467,3239,466,3548,22.82
G34001300087,STCTY-34013 TRACT-    0087     IN NEWARK NJ,6167,6008,159,4785,151,4983,34.1
G34001300088,STCTY-34013 TRACT-    0088     IN NEWARK NJ,5219,4777,442,3461,438,3023,25.13
G34001300089,STCTY-34013 TRACT-    0089     IN NEWARK NJ,4294,4084,210,3015,210,0,27.66
G34001300090,STCTY-34013 TRACT-    0090     IN NEWARK NJ,4144,3982,162,2881,162,0,23.98
G34001300091,STCTY-34013 TRACT-    0091     IN NEWARK NJ,4580,4386,194,3226,192,3378,36.7
G34001300092,STCTY-34013 TRACT-    0092     IN NEWARK NJ,4273,4174,99,3518,99,5405,41.96
G34001300093,STCTY-34013 TRACT-    0093     IN NEWARK NJ,4151,4119,32,3520,31,4740,44.38
G34001300094,STCTY-34013 TRACT-    0094     IN NEWARK NJ,3928,3888,40,3245,40,12525,52.52
G34001300095,STCTY-34013 TRACT-    0095     IN NEWARK NJ,4103,4071,32,3510,32,8826,50.31
G34001300096,STCTY-34013 TRACT-    0096     IN NEWARK NJ,4586,3880,706,3150,706,3880,37.14
G34001300097,STCTY-34013 TRACT-    0097     IN NEWARK NJ,4627,4609,18,3805,15,3946,42.46
G34001300098,STCTY-34013 TRACT-    0098     IN NEWARK NJ,209,209,0,165,0,0,0
G34001700001,STCTY-34017 TRACT-    0001     IN JERSEY CITY NJ,5445,5445,0,4572,0,3590,40.37
G34001700002,STCTY-34017 TRACT-    0002     IN JERSEY CITY NJ,5078,5076,2,4129,0,3983,33.57
G34001700003,STCTY-34017 TRACT-    0003     IN JERSEY CITY NJ,4892,4886,6,3971,2,3608,35.69
G34001700004,STCTY-34017 TRACT-    0004     IN JERSEY CITY NJ,3627,3611,16,3050,15,3777,37.58
G34001700005,STCTY-34017 TRACT-    0005     IN JERSEY CITY NJ,4658,4656,2,3915,0,4541,35.76
G34001700006,STCTY-34017 TRACT-    0006     IN JERSEY CITY NJ,6607,6594,13,5622,0,4683,40.42
G34001700007,STCTY-34017 TRACT-    0007     IN JERSEY CITY NJ,5198,5187,11,4348,3,4267,31.93
G34001700008,STCTY-34017 TRACT-    0008     IN JERSEY CITY NJ,4994,4994,0,4010,0,4500,33.64
G34001700009,STCTY-34017 TRACT-    0009     IN JERSEY CITY NJ,3823,3818,5,3146,5,3813,37.13
G34001700010,STCTY-34017 TRACT-    0010     IN JERSEY CITY NJ,4468,4467,1,3828,1,4667,42.47
G34001700011,STCTY-34017 TRACT-    0011     IN JERSEY CITY NJ,4004,4003,1,3363,1,4034,35.23
G34001700012,STCTY-34017 TRACT-    0012     IN JERSEY CITY NJ,4724,4714,10,3836,0,3528,31.2
G34001700013,STCTY-34017 TRACT-    0013     IN JERSEY CITY NJ,3541,3539,2,2974,2,4100,37.91
G34001700014,STCTY-34017 TRACT-    0014     IN JERSEY CITY NJ,5194,5194,0,4267,0,4625,36.99
G34001700015,STCTY-34017 TRACT-    0015     IN JERSEY CITY NJ,4268,4218,50,3501,50,0,22.83
G34001700016,STCTY-34017 TRACT-    0016     IN JERSEY CITY NJ,4035,4035,0,3065,0,0,23.07
G34001700017,STCTY-34017 TRACT-    0017     IN JERSEY CITY NJ,4979,4957,22,3737,22,3289,26.87
G34001700018,STCTY-34017 TRACT-    0018     IN JERSEY CITY NJ,4823,4823,0,3892,0,0,41.96
G34001700019,STCTY-34017 TRACT-    0019     IN JERSEY CITY NJ,4361,4305,56,3506,48,6361,38.18
G34001700020,STCTY-34017 TRACT-    0020     IN JERSEY CITY NJ,5420,5354,66,4386,44,4722,44.17
G34001700021,STCTY-34017 TRACT-    0021     IN JERSEY CITY NJ,4395,4388,7,3647,7,4318,37.58
G34001700022,STCTY-34017 TRACT-    0022     IN JERSEY CITY NJ,4378,4216,162,3056,162,2563,27.03
G34001700023,STCTY-34017 TRACT-    0023     IN JERSEY CITY NJ,4909,4402,507,3163,505,0,27.39
G34001700024,STCTY-34017 TRACT-    0024     IN JERSEY CITY NJ,4961,4960,1,3966,0,4000,31.55
G34001700025,STCTY-34017 TRACT-    0025     IN JERSEY CITY NJ,4260,4248,12,3269,11,3932,27.54
G34001700026,STCTY-34017 TRACT-    0026     IN JERSEY CITY NJ,4788,4677,111,3415,107,0,24.29
G34001700027,STCTY-34017 TRACT-    0027     IN JERSEY CITY NJ,5848,5774,74,4906,74,3424,37.39
G34001700028,STCTY-34017 TRACT-    0028     IN JERSEY CITY NJ,6081,6068,13,5296,12,5453,53.73
G34001700029,STCTY-34017 TRACT-    0029     IN JERSEY CITY NJ,4833,4780,53,4056,50,5125,53.13
G34001700030,STCTY-34017 TRACT-    0030     IN JERSEY CITY NJ,3743,3490,253,2742,253,2956,35.6
G34001700031,STCTY-34017 TRACT-    0031     IN JERSEY CITY NJ,4680,4671,9,3968,7,4139,40.72
G34001700032,STCTY-34017 TRACT-    0032     IN JERSEY CITY NJ,4312,4279,33,3135,33,1474,27.62
G34001700033,STCTY-34017 TRACT-    0033     IN JERSEY CITY NJ,4482,3309,1173,2609,1171,2185,25.57
G34001700034,STCTY-34017 TRACT-    0034     IN JERSEY CITY NJ,4332,4175,157,3321,156,2000,23.29
G34001700035,STCTY-34017 TRACT-    0035     IN JERSEY CITY NJ,3873,3811,62,2947,61,3150,30.18
G34001700036,STCTY-34017 TRACT-    0036     IN JERSEY CITY NJ,4914,4513,401,3492,401,2370,26.32
G34001700037,STCTY-34017 TRACT-    0037     IN JERSEY CITY NJ,4186,4092,94,3096,78,3667,26.23
G34001700038,STCTY-34017 TRACT-    0038     IN JERSEY CITY NJ,3842,3628,214,2764,212,0,24
G34001700039,STCTY-34017 TRACT-    0039     IN JERSEY CITY NJ,2822,2799,23,2055,17,0,20.94
G34001700040,STCTY-34017 TRACT-    0040     IN JERSEY CITY NJ,5908,5881,27,4899,27,3938,37.5
G34001700041,STCTY-34017 TRACT-    0041     IN JERSEY CITY NJ,11099,10285,814,8892,809,6413,54.86
G34001700042,STCTY-34017 TRACT-    0042     IN JERSEY CITY NJ,5437,4942,495,4158,494,4402,44.59
G34001700043,STCTY-34017 TRACT-    0043     IN JERSEY CITY NJ,4689,3866,823,3237,821,4461,40.19
G34001700044,STCTY-34017 TRACT-    0044     IN JERSEY CITY NJ,3989,1585,2404,1247,2404,4267,34.11
G34001700045,STCTY-34017 TRACT-    0045     IN JERSEY CITY NJ,5718,5535,183,4778,183,3744,39.99
G34001700046,STCTY-34017 TRACT-    0046     IN JERSEY CITY NJ,4270,3935,335,3031,321,2927,30.94
G34001700047,STCTY-34017 TRACT-    0047     IN JERSEY CITY NJ,5032,4436,596,3292,590,2438,29.44
G34001700048,STCTY-34017 TRACT-    0048     IN JERSEY CITY NJ,4197,4167,30,3336,30,3732,34.09
G34001700049,STCTY-34017 TRACT-    0049     IN JERSEY CITY NJ,4779,4661,118,4001,117,4912,46.23
G34001700050,STCTY-34017 TRACT-    0050     IN JERSEY CITY NJ,4348,1360,2988,1041,2979,3423,34.97
G34001700051,STCTY-34017 TRACT-    0051     IN JERSEY CITY NJ,3817,3114,703,2521,702,4000,38.51
G34001700052,STCTY-34017 TRACT-    0052     IN JERSEY CITY NJ,6355,6212,143,5151,141,3412,41.78
G34001700053,STCTY-34017 TRACT-    0053     IN JERSEY CITY NJ,4483,4438,45,3702,45,3857,39.76
G34001700054,STCTY-34017 TRACT-    0054     IN JERSEY CITY NJ,4117,4095,22,3406,22,5119,49.27
G34001700055,STCTY-34017 TRACT-    0055     IN JERSEY CITY NJ,5481,5399,82,4415,80,3483,36.85
G34001700056,STCTY-34017 TRACT-    0056     IN JERSEY CITY NJ,4709,4691,18,3826,18,4200,47.74
G34001700057,STCTY-34017 TRACT-    0057     IN JERSEY CITY NJ,3350,3348,2,2763,1,3500,39.43
G34001700058,STCTY-34017 TRACT-    0058     IN JERSEY CITY NJ,4159,4153,6,3473,6,3740,42.12
G34001700059,STCTY-34017 TRACT-    0059     IN JERSEY CITY NJ,6508,6506,2,5415,2,3409,37.22
G34001700060,STCTY-34017 TRACT-    0060     IN JERSEY CITY NJ,5893,5852,41,4903,38,3795,40.59
G34001700061,STCTY-34017 TRACT-    0061     IN JERSEY CITY NJ,3874,3811,63,3148,63,3517,34.34
G34001700062,STCTY-34017 TRACT-    0062     IN JERSEY CITY NJ,4533,4533,0,3795,0,4582,37.84
G34001700063,STCTY-34017 TRACT-    0063     IN JERSEY CITY NJ,4650,4637,13,3987,13,3948,40.82
G3400170C0001,STCTY-34017 TRACT-  C 0001     IN JERSEY CITY NJ ADJ AREA,2955,2819,136,2271,136,3435,42.74
G3400170C0002,STCTY-34017 TRACT-  C 0002     IN JERSEY CITY NJ ADJ AREA,2911,2896,15,2330,15,4885,45.38
G3400170C0003,STCTY-34017 TRACT-  C 0003     IN JERSEY CITY NJ ADJ AREA,4866,4849,17,3830,17,3648,36.06
G3400170C0004,STCTY-34017 TRACT-  C 0004     IN JERSEY CITY NJ ADJ AREA,4496,4295,201,3636,201,3856,43.27
G3400170C0005,STCTY-34017 TRACT-  C 0005     IN JERSEY CITY NJ ADJ AREA,4372,4366,6,3606,2,5306,50.71
G3400170C0006,STCTY-34017 TRACT-  C 0006     IN JERSEY CITY NJ ADJ AREA,2241,2239,2,1855,2,5378,48.01
G3400170C0007,STCTY-34017 TRACT-  C 0007     IN JERSEY CITY NJ ADJ AREA,4114,4107,7,3322,7,4009,34.74
G3400170C0008,STCTY-34017 TRACT-  C 0008     IN JERSEY CITY NJ ADJ AREA,3035,3025,10,2389,10,5917,49.08
G3400170C0009,STCTY-34017 TRACT-  C 0009     IN JERSEY CITY NJ ADJ AREA,3045,3042,3,2165,3,4241,50.02
G3400170C0010,STCTY-34017 TRACT-  C 0010     IN JERSEY CITY NJ ADJ AREA,4408,4345,63,3245,63,3853,36.86
G3400170C0011,STCTY-34017 TRACT-  C 0011     IN JERSEY CITY NJ ADJ AREA,2826,2621,205,1758,205,2480,32.26
G3400170C0012,STCTY-34017 TRACT-  C 0012     IN JERSEY CITY NJ ADJ AREA,4514,4255,259,3034,256,3111,28.78
G3400170C0013,STCTY-34017 TRACT-  C 0013     IN JERSEY CITY NJ ADJ AREA,2638,2635,3,1935,3,2329,21.23
G3400170C0014,STCTY-34017 TRACT-  C 0014     IN JERSEY CITY NJ ADJ AREA,2424,2378,46,1693,45,0,25.2
G3400170C0015,STCTY-34017 TRACT-  C 0015     IN JERSEY CITY NJ ADJ AREA,4513,3836,677,2561,676,2661,28.42
G3400170C0016,STCTY-34017 TRACT-  C 0016     IN JERSEY CITY NJ ADJ AREA,3501,3493,8,2640,8,3145,45.73
G3400170C0017,STCTY-34017 TRACT-  C 0017     IN JERSEY CITY NJ ADJ AREA,3849,3773,76,2798,75,2474,36.77
G3400170C0018,STCTY-34017 TRACT-  C 0018     IN JERSEY CITY NJ ADJ AREA,3004,2995,9,2387,9,2360,30.25
G3400170C0019,STCTY-34017 TRACT-  C 0019     IN JERSEY CITY NJ ADJ AREA,3844,3844,0,3165,0,3240,29.41
G3400170C0020,STCTY-34017 TRACT-  C 0020     IN JERSEY CITY NJ ADJ AREA,3140,3139,1,2482,1,2500,35.99
G3400170C0021,STCTY-34017 TRACT-  C 0021     IN JERSEY CITY NJ ADJ AREA,3724,3703,21,3023,18,3987,45.95
G3400170C0022,STCTY-34017 TRACT-  C 0022     IN JERSEY CITY NJ ADJ AREA,4778,4764,14,4088,2,4278,42.85
G3400170C0023,STCTY-34017 TRACT-  C 0023     IN JERSEY CITY NJ ADJ AREA,2356,2346,10,1904,0,5617,45.27
G3400170C0024,STCTY-34017 TRACT-  C 0024     IN JERSEY CITY NJ ADJ AREA,3302,3294,8,2733,1,7048,56.82
G3400170C0025,STCTY-34017 TRACT-  C 0025     IN JERSEY CITY NJ ADJ AREA,3323,3309,14,2623,5,6958,50.97
G3400170C0026,STCTY-34017 TRACT-  C 0026     IN JERSEY CITY NJ ADJ AREA,4123,4121,2,3191,2,4443,44.94
G3400170C0027,STCTY-34017 TRACT-  C 0027     IN JERSEY CITY NJ ADJ AREA,4019,4012,7,3003,6,4120,37.75
G3400170C0028,STCTY-34017 TRACT-  C 0028     IN JERSEY CITY NJ ADJ AREA,4400,4301,99,3143,96,3406,35.42
G3400170C0029,STCTY-34017 TRACT-  C 0029     IN JERSEY CITY NJ ADJ AREA,4287,4287,0,3004,0,3854,38.48
G3400170C0030,STCTY-34017 TRACT-  C 0030     IN JERSEY CITY NJ ADJ AREA,3819,3818,1,2663,1,3660,38.7
G3400170C0031,STCTY-34017 TRACT-  C 0031     IN JERSEY CITY NJ ADJ AREA,2156,2156,0,1480,0,4615,37.91
G3400170C0032,STCTY-34017 TRACT-  C 0032     IN JERSEY CITY NJ ADJ AREA,4730,4725,5,3188,4,3627,36.76
G3400170C0033,STCTY-34017 TRACT-  C 0033     IN JERSEY CITY NJ ADJ AREA,2952,2859,93,1946,93,4573,40.92
G3400170C0034,STCTY-34017 TRACT-  C 0034     IN JERSEY CITY NJ ADJ AREA,2273,2258,15,1808,15,3206,30.42
G3400170C0035,STCTY-34017 TRACT-  C 0035     IN JERSEY CITY NJ ADJ AREA,3568,3567,1,2801,1,3767,30.12
G3400170C0036,STCTY-34017 TRACT-  C 0036     IN JERSEY CITY NJ ADJ AREA,2397,2395,2,1834,0,3050,33.05
G3400170C0037,STCTY-34017 TRACT-  C 0037     IN JERSEY CITY NJ ADJ AREA,3372,3347,25,2631,24,2736,27.74
G3400170C0038,STCTY-34017 TRACT-  C 0038     IN JERSEY CITY NJ ADJ AREA,2017,1952,65,1567,64,3294,29.37
G3400170C0039,STCTY-34017 TRACT-  C 0039     IN JERSEY CITY NJ ADJ AREA,2817,2814,3,2236,2,3178,32.21
G3400170C0040,STCTY-34017 TRACT-  C 0040     IN JERSEY CITY NJ ADJ AREA,4081,4079,2,3193,1,6971,52.73
G3400170C0041,STCTY-34017 TRACT-  C 0041     IN JERSEY CITY NJ ADJ AREA,3821,3818,3,3024,2,6731,45.72
G3400170C0042,STCTY-34017 TRACT-  C 0042     IN JERSEY CITY NJ ADJ AREA,4999,4994,5,3840,1,6585,50.41
G3400170C0043,STCTY-34017 TRACT-  C 0043     IN JERSEY CITY NJ ADJ AREA,4196,4190,6,3240,6,7522,50.41
G3400170C0044,STCTY-34017 TRACT-  C 0044     IN JERSEY CITY NJ ADJ AREA,4098,4097,1,3356,1,4201,43.47
G3400170C0045,STCTY-34017 TRACT-  C 0045     IN JERSEY CITY NJ ADJ AREA,4130,4116,14,3145,14,3087,31.28
G3400170C0046,STCTY-34017 TRACT-  C 0046     IN JERSEY CITY NJ ADJ AREA,4203,4174,29,3494,29,2869,35.47
G3400170C0047,STCTY-34017 TRACT-  C 0047     IN JERSEY CITY NJ ADJ AREA,3530,3501,29,2830,29,2861,33.37
G3400170C0048,STCTY-34017 TRACT-  C 0048     IN JERSEY CITY NJ ADJ AREA,3896,3890,6,2905,6,3580,35.23
G3400170C0049,STCTY-34017 TRACT-  C 0049     IN JERSEY CITY NJ ADJ AREA,2760,2760,0,2215,0,3402,36.88
G3400170C0050,STCTY-34017 TRACT-  C 0050     IN JERSEY CITY NJ ADJ AREA,4100,4098,2,3040,0,3451,32.79
G3400170C0051,STCTY-34017 TRACT-  C 0051     IN JERSEY CITY NJ ADJ AREA,2100,2084,16,1542,15,4762,33.94
G3400170C0052,STCTY-34017 TRACT-  C 0052     IN JERSEY CITY NJ ADJ AREA,6298,6293,5,4734,4,6563,39.87
G3400170C0053,STCTY-34017 TRACT-  C 0053     IN JERSEY CITY NJ ADJ AREA,4319,4318,1,3146,0,4909,37.07
G3400170C0054,STCTY-34017 TRACT-  C 0054     IN JERSEY CITY NJ ADJ AREA,5209,5156,53,3759,52,3563,36.07
G3400170C0055,STCTY-34017 TRACT-  C 0055     IN JERSEY CITY NJ ADJ AREA,4235,4148,87,3080,84,3452,33.26
G3400170C0056,STCTY-34017 TRACT-  C 0056     IN JERSEY CITY NJ ADJ AREA,3845,3844,1,2856,1,0,34.49
G3400170C0057,STCTY-34017 TRACT-  C 0057     IN JERSEY CITY NJ ADJ AREA,3663,3652,11,2742,1,5969,35.61
G3400170C0058,STCTY-34017 TRACT-  C 0058     IN JERSEY CITY NJ ADJ AREA,3649,3649,0,2731,0,6210,38.12
G3400170C0059,STCTY-34017 TRACT-  C 0059     IN JERSEY CITY NJ ADJ AREA,5510,5509,1,4152,0,0,36.63
G3400170C0060,STCTY-34017 TRACT-  C 0060     IN JERSEY CITY NJ ADJ AREA,2711,2708,3,1836,0,3962,34.84
G3400170C0061,STCTY-34017 TRACT-  C 0061     IN JERSEY CITY NJ ADJ AREA,3280,3274,6,2644,0,0,34.84
G3400170C0062,STCTY-34017 TRACT-  C 0062     IN JERSEY CITY NJ ADJ AREA,3870,3869,1,2908,1,3923,38.62
G3400170C0063,STCTY-34017 TRACT-  C 0063     IN JERSEY CITY NJ ADJ AREA,3649,3642,7,2844,5,5093,34.31
G3400170C0064,STCTY-34017 TRACT-  C 0064     IN JERSEY CITY NJ ADJ AREA,2988,2987,1,2331,0,0,32.32
G3400170C0065,STCTY-34017 TRACT-  C 0065     IN JERSEY CITY NJ ADJ AREA,2731,2731,0,2131,0,0,35.13
G3400170C0066,STCTY-34017 TRACT-  C 0066     IN JERSEY CITY NJ ADJ AREA,2530,2528,2,1986,0,4615,35.16
G3400170C0067,STCTY-34017 TRACT-  C 0067     IN JERSEY CITY NJ ADJ AREA,1746,1745,1,1271,1,0,34.71
G3400170C0068,STCTY-34017 TRACT-  C 0068     IN JERSEY CITY NJ ADJ AREA,3194,3192,2,2381,0,0,30.34
G3400170C0069,STCTY-34017 TRACT-  C 0069     IN JERSEY CITY NJ ADJ AREA,2559,2554,5,1783,2,4200,34.04
G3400170C0070,STCTY-34017 TRACT-  C 0070     IN JERSEY CITY NJ ADJ AREA,3777,3774,3,2506,3,0,30.61
G3400170C0071,STCTY-34017 TRACT-  C 0071     IN JERSEY CITY NJ ADJ AREA,4984,4982,2,3850,1,5286,40.6
G3400170C0072,STCTY-34017 TRACT-  C 0072     IN JERSEY CITY NJ ADJ AREA,2962,2960,2,2238,0,3531,35.07
G3400170C0073,STCTY-34017 TRACT-  C 0073     IN JERSEY CITY NJ ADJ AREA,2148,2147,1,1622,1,3370,35.1
G3400170C0074,STCTY-34017 TRACT-  C 0074     IN JERSEY CITY NJ ADJ AREA,2339,2339,0,1826,0,0,37.23
G3400170C0075,STCTY-34017 TRACT-  C 0075     IN JERSEY CITY NJ ADJ AREA,3159,3154,5,2257,4,3667,31.95
G3400170C0076,STCTY-34017 TRACT-  C 0076     IN JERSEY CITY NJ ADJ AREA,2829,2828,1,2048,1,0,33.33
G3400170C0077,STCTY-34017 TRACT-  C 0077     IN JERSEY CITY NJ ADJ AREA,2664,2664,0,1902,0,0,26.24
G3400170C0078,STCTY-34017 TRACT-  C 0078     IN JERSEY CITY NJ ADJ AREA,4764,4754,10,3448,10,4467,33.5
G3400170C0079,STCTY-34017 TRACT-  C 0079     IN JERSEY CITY NJ ADJ AREA,2025,2009,16,1668,16,9875,31.26
G3400170C0080,STCTY-34017 TRACT-  C 0080     IN JERSEY CITY NJ ADJ AREA,4423,4418,5,3527,5,10667,44.53
G3400170C0081,STCTY-34017 TRACT-  C 0081     IN JERSEY CITY NJ ADJ AREA,3765,3757,8,2912,7,6938,46.01
G3400170C0082,STCTY-34017 TRACT-  C 0082     IN JERSEY CITY NJ ADJ AREA,4150,4146,4,3166,2,5203,41.36
G3400170C0083,STCTY-34017 TRACT-  C 0083     IN JERSEY CITY NJ ADJ AREA,4071,4070,1,3150,0,0,43.32
G3400170C0084,STCTY-34017 TRACT-  C 0084     IN JERSEY CITY NJ ADJ AREA,4451,4431,20,3528,20,5383,34.4
G3400170C0085,STCTY-34017 TRACT-  C 0085     IN JERSEY CITY NJ ADJ AREA,4412,4401,11,3418,11,0,30.62
G3400170C0086,STCTY-34017 TRACT-  C 0086     IN JERSEY CITY NJ ADJ AREA,4067,4065,2,3077,1,4708,30.6
G3400170C0087,STCTY-34017 TRACT-  C 0087     IN JERSEY CITY NJ ADJ AREA,3980,3973,7,2939,4,9856,44.22
G3400170C0088,STCTY-34017 TRACT-  C 0088     IN JERSEY CITY NJ ADJ AREA,5991,5986,5,3979,1,2438,29.97
G3400170C0089,STCTY-34017 TRACT-  C 0089     IN JERSEY CITY NJ ADJ AREA,3614,3609,5,2701,5,0,24.43
G3400170C0090,STCTY-34017 TRACT-  C 0090     IN JERSEY CITY NJ ADJ AREA,4830,4828,2,3383,0,0,26.25
G3400170C0091,STCTY-34017 TRACT-  C 0091     IN JERSEY CITY NJ ADJ AREA,4688,4666,22,3061,21,0,23.36
G3400170C0092,STCTY-34017 TRACT-  C 0092     IN JERSEY CITY NJ ADJ AREA,3853,3735,118,2882,117,0,24.74
G3400170C0093,STCTY-34017 TRACT-  C 0093     IN JERSEY CITY NJ ADJ AREA,3350,3265,85,2214,80,0,25.89
G3400170C0094,STCTY-34017 TRACT-  C 0094     IN JERSEY CITY NJ ADJ AREA,2808,2790,18,1629,0,0,31.55
G3400170C0095,STCTY-34017 TRACT-  C 0095     IN JERSEY CITY NJ ADJ AREA,1811,1811,0,1489,0,4276,37.35
G3400170C0096,STCTY-34017 TRACT-  C 0096     IN JERSEY CITY NJ ADJ AREA,2086,2084,2,1738,2,3591,35.53
G3400170C0097,STCTY-34017 TRACT-  C 0097     IN JERSEY CITY NJ ADJ AREA,5857,5759,98,4037,96,3844,37.72
G34002100001,STCTY-34021 TRACT-    0001     IN TRENTON NJ,3724,3724,0,2983,0,2447,24.59
G34002100002,STCTY-34021 TRACT-    0002     IN TRENTON NJ,5479,5479,0,4004,0,2300,28.38
G34002100003,STCTY-34021 TRACT-    0003     IN TRENTON NJ,5161,5160,1,4009,1,3408,34.44
G34002100004,STCTY-34021 TRACT-    0004     IN TRENTON NJ,6545,6537,8,4744,7,2719,28.17
G34002100005,STCTY-34021 TRACT-    0005     IN TRENTON NJ,5545,5534,11,3871,1,2313,30.41
G34002100006,STCTY-34021 TRACT-    0006     IN TRENTON NJ,5275,5270,5,4500,5,3825,43.44
G34002100007,STCTY-34021 TRACT-    0007     IN TRENTON NJ,4515,4514,1,3200,1,2853,30.13
G34002100008,STCTY-34021 TRACT-    0008     IN TRENTON NJ,5246,4843,403,3644,403,2672,29.38
G34002100009,STCTY-34021 TRACT-    0009     IN TRENTON NJ,7080,6861,219,5723,211,3486,34.12
G34002100010,STCTY-34021 TRACT-    0010     IN TRENTON NJ,7711,6560,1151,4974,1145,2497,24.16
G34002100011,STCTY-34021 TRACT-    0011     IN TRENTON NJ,7214,6531,683,5901,683,4708,43.7
G34002100012,STCTY-34021 TRACT-    0012     IN TRENTON NJ,3480,3454,26,3167,26,6869,66.4
G34002100013,STCTY-34021 TRACT-    0013     IN TRENTON NJ,6598,6205,393,5156,393,7383,59.5
G34002100014,STCTY-34021 TRACT-    0014     IN TRENTON NJ,5613,5438,175,4921,175,4349,42.5
G34002100015,STCTY-34021 TRACT-    0015     IN TRENTON NJ,6022,3380,2642,2914,2638,2887,28.35
G34002100016,STCTY-34021 TRACT-    0016     IN TRENTON NJ,4890,4520,370,3976,369,3767,32.3
G34002100017,STCTY-34021 TRACT-    0017     IN TRENTON NJ,6355,5434,921,4248,921,2715,29.96
G34002100018,STCTY-34021 TRACT-    0018     IN TRENTON NJ,6058,5895,163,4639,163,2739,28.49
G34002100019,STCTY-34021 TRACT-    0019     IN TRENTON NJ,3532,3283,249,2515,249,2020,24.39
G34002100020,STCTY-34021 TRACT-    0020     IN TRENTON NJ,4877,3469,1408,2816,1407,2136,23.12
G34002100021,STCTY-34021 TRACT-    0021     IN TRENTON NJ,6407,5963,444,5104,444,4054,36.33
G34002100022,STCTY-34021 TRACT-    0022     IN TRENTON NJ,7370,7303,67,6492,66,3763,37.53
G34003100001,STCTY-34031 TRACT-    0001     IN PATERSON NJ,3270,3270,0,2615,0,4450,37.26
G34003100002,STCTY-34031 TRACT-    0002     IN PATERSON NJ,6593,6592,1,5227,0,2330,30.99
G34003100003,STCTY-34031 TRACT-    0003     IN PATERSON NJ,5356,5355,1,4202,0,2347,30.45
G34003100004,STCTY-34031 TRACT-    0004     IN PATERSON NJ,2721,2381,340,1783,336,0,22.89
G34003100005,STCTY-34031 TRACT-    0005     IN PATERSON NJ,3303,3177,126,2505,124,1757,23.22
G34003100006,STCTY-34031 TRACT-    0006     IN PATERSON NJ,5142,5141,1,3782,1,2346,28.93
G34003100007,STCTY-34031 TRACT-    0007     IN PATERSON NJ,3994,3844,150,2842,150,1936,23.29
G34003100008,STCTY-34031 TRACT-    0008     IN PATERSON NJ,4101,4079,22,2960,22,2268,26.85
G34003100009,STCTY-34031 TRACT-    0009     IN PATERSON NJ,4211,4160,51,2802,51,1873,24.64
G34003100010,STCTY-34031 TRACT-    0010     IN PATERSON NJ,4331,4291,40,2958,40,2397,28.8
G34003100011,STCTY-34031 TRACT-    0011     IN PATERSON NJ,4543,4538,5,3277,4,3490,38.13
G34003100012,STCTY-34031 TRACT-    0012     IN PATERSON NJ,3967,3936,31,2659,31,2875,39.03
G34003100013,STCTY-34031 TRACT-    0013     IN PATERSON NJ,4067,3763,304,2873,297,4339,40.09
G34003100014,STCTY-34031 TRACT-    0014     IN PATERSON NJ,4748,3998,750,2488,749,2652,32.99
G34003100015,STCTY-34031 TRACT-    0015     IN PATERSON NJ,5074,4280,794,2774,794,2848,28.64
G34003100016,STCTY-34031 TRACT-    0016     IN PATERSON NJ,3985,3054,931,2082,908,0,26.26
G34003100017,STCTY-34031 TRACT-    0017     IN PATERSON NJ,4539,4442,97,3463,76,3471,33.37
G34003100018,STCTY-34031 TRACT-    0018     IN PATERSON NJ,4410,4282,128,2799,116,1973,24.09
G34003100019,STCTY-34031 TRACT-    0019     IN PATERSON NJ,4209,4208,1,3337,1,2492,30.85
G34003100020,STCTY-34031 TRACT-    0020     IN PATERSON NJ,4261,4215,46,3185,46,1815,22.18
G34003100021,STCTY-34031 TRACT-    0021     IN PATERSON NJ,3435,3422,13,2758,13,2245,30.35
G34003100022,STCTY-34031 TRACT-    0022     IN PATERSON NJ,4713,4646,67,3285,65,2122,23.22
G34003100023,STCTY-34031 TRACT-    0023     IN PATERSON NJ,6804,6568,236,5131,235,2863,34.48
G34003100024,STCTY-34031 TRACT-    0024     IN PATERSON NJ,3955,3929,26,3252,25,5119,45.18
G34003100025,STCTY-34031 TRACT-    0025     IN PATERSON NJ,4410,4341,69,3297,68,8877,50.39
G34003100026,STCTY-34031 TRACT-    0026     IN PATERSON NJ,5119,5088,31,4084,29,6612,50.31
G34003100027,STCTY-34031 TRACT-    0027     IN PATERSON NJ,4792,4789,3,3703,2,3124,41.38
G34003100028,STCTY-34031 TRACT-    0028     IN PATERSON NJ,3998,3996,2,2867,0,2128,28.79
G34003100029,STCTY-34031 TRACT-    0029     IN PATERSON NJ,3414,3329,85,2674,80,2100,24.17
G34003100030,STCTY-34031 TRACT-    0030     IN PATERSON NJ,6519,6516,3,5122,3,2789,34.29
G34003100031,STCTY-34031 TRACT-    0031     IN PATERSON NJ,5672,5670,2,4426,2,3718,37.89
G34003900001,STCTY-34039 TRACT-    0001     IN ELIZABETH NJ,320,314,6,216,6,0,0
G34003900002,STCTY-34039 TRACT-    0002     IN ELIZABETH NJ,6295,5757,538,4089,530,3517,29.9
G34003900003,STCTY-34039 TRACT-    0003     IN ELIZABETH NJ,5123,4631,492,3126,491,2722,25.74
G34003900004,STCTY-34039 TRACT-    0004     IN ELIZABETH NJ,7304,6509,795,4719,778,2976,24.75
G34003900005,STCTY-34039 TRACT-    0005     IN ELIZABETH NJ,6832,6662,170,5019,169,3805,28.29
G34003900006,STCTY-34039 TRACT-    0006     IN ELIZABETH NJ,4002,3958,44,3016,39,4287,34.42
G34003900007,STCTY-34039 TRACT-    0007     IN ELIZABETH NJ,7689,7414,275,5975,273,4142,41.2
G34003900008,STCTY-34039 TRACT-    0008     IN ELIZABETH NJ,3755,3341,414,2640,399,4463,36.49
G34003900009,STCTY-34039 TRACT-    0009     IN ELIZABETH NJ,5287,5140,147,3662,147,3171,29.89
G34003900010,STCTY-34039 TRACT-    0010     IN ELIZABETH NJ,3718,3643,75,2747,73,3375,32.07
G34003900011,STCTY-34039 TRACT-    0011     IN ELIZABETH NJ,6452,6203,249,4518,246,3690,31.42
G34003900012,STCTY-34039 TRACT-    0012     IN ELIZABETH NJ,7367,6096,1271,4828,1270,3723,34.68
G34003900013,STCTY-34039 TRACT-    0013     IN ELIZABETH NJ,6820,6784,36,5248,36,4409,40.04
G34003900014,STCTY-34039 TRACT-    0014     IN ELIZABETH NJ,3703,3627,76,3067,76,3947,45.53
G34003900015,STCTY-34039 TRACT-    0015     IN ELIZABETH NJ,3866,3859,7,3127,6,5756,48.48
G34003900016,STCTY-34039 TRACT-    0016     IN ELIZABETH NJ,4569,4466,103,3708,102,6521,46.7
G34003900017,STCTY-34039 TRACT-    0017     IN ELIZABETH NJ,2870,2817,53,2440,51,14006,59.01
G34003900018,STCTY-34039 TRACT-    0018     IN ELIZABETH NJ,4924,4919,5,4230,5,6635,54.99
G34003900019,STCTY-34039 TRACT-    0019     IN ELIZABETH NJ,4741,4523,218,3804,216,6121,46.82
G34003900020,STCTY-34039 TRACT-    0020     IN ELIZABETH NJ,7670,7656,14,6220,14,6107,54.11
G34003900021,STCTY-34039 TRACT-    0021     IN ELIZABETH NJ,6605,6591,14,5906,14,8146,71.45
G3600050000100,STCTY-36005 HEALTH AREA-    0001.00  IN NEW YORK NY,8953,8593,360,6800,324,10453,62.19
G3600050000200,STCTY-36005 HEALTH AREA-    0002.00  IN NEW YORK NY,13515,13445,70,9819,59,8131,49.26
G3600050000310,STCTY-36005 HEALTH AREA-    0003.10  IN NEW YORK NY,18833,18772,61,12803,46,8345,46.97
G3600050000320,STCTY-36005 HEALTH AREA-    0003.20  IN NEW YORK NY,23583,23439,144,17439,140,12711,51.61
G3600050000410,STCTY-36005 HEALTH AREA-    0004.10  IN NEW YORK NY,32829,32691,138,22854,127,8026,50.46
G3600050000420,STCTY-36005 HEALTH AREA-    0004.20  IN NEW YORK NY,29310,29197,113,22292,104,6940,52.55
G3600050000510,STCTY-36005 HEALTH AREA-    0005.10  IN NEW YORK NY,16883,16817,66,13760,65,7580,48.52
G3600050000520,STCTY-36005 HEALTH AREA-    0005.20  IN NEW YORK NY,21978,21832,146,16091,141,5624,46.29
G3600050000610,STCTY-36005 HEALTH AREA-    0006.10  IN NEW YORK NY,23769,22999,770,16572,767,4582,45.17
G3600050000620,STCTY-36005 HEALTH AREA-    0006.20  IN NEW YORK NY,18835,18099,736,13187,729,4808,44.37
G3600050000710,STCTY-36005 HEALTH AREA-    0007.10  IN NEW YORK NY,3811,3788,23,2864,23,4293,39.42
G3600050000720,STCTY-36005 HEALTH AREA-    0007.20  IN NEW YORK NY,4863,4566,297,3691,273,5982,44.06
G3600050000810,STCTY-36005 HEALTH AREA-    0008.10  IN NEW YORK NY,27917,27795,122,15367,119,5479,46.2
G3600050000820,STCTY-36005 HEALTH AREA-    0008.20  IN NEW YORK NY,12011,11974,37,8599,36,6229,44.63
G3600050000900,STCTY-36005 HEALTH AREA-    0009.00  IN NEW YORK NY,36125,36047,78,26226,61,7599,50.66
G3600050001000,STCTY-36005 HEALTH AREA-    0010.00  IN NEW YORK NY,27482,27396,86,19294,61,4949,40.37
G3600050001100,STCTY-36005 HEALTH AREA-    0011.00  IN NEW YORK NY,25874,25834,40,16021,37,4530,35.42
G3600050001210,STCTY-36005 HEALTH AREA-    0012.10  IN NEW YORK NY,23626,23544,82,14841,78,6100,54.58
G3600050001220,STCTY-36005 HEALTH AREA-    0012.20  IN NEW YORK NY,21122,20922,200,14718,192,4175,43.26
G3600050001310,STCTY-36005 HEALTH AREA-    0013.10  IN NEW YORK NY,17411,17403,8,13053,8,6094,43.93
G3600050001320,STCTY-36005 HEALTH AREA-    0013.20  IN NEW YORK NY,12038,11974,64,9248,63,4687,43.41
G3600050001410,STCTY-36005 HEALTH AREA-    0014.10  IN NEW YORK NY,3899,3898,1,3043,1,7079,45.84
G3600050001420,STCTY-36005 HEALTH AREA-    0014.20  IN NEW YORK NY,22561,22541,20,16304,7,5159,46.05
G3600050001510,STCTY-36005 HEALTH AREA-    0015.10  IN NEW YORK NY,18191,18089,102,13583,89,7863,53.14
G3600050001520,STCTY-36005 HEALTH AREA-    0015.20  IN NEW YORK NY,23552,23521,31,15485,22,9811,47.24
G3600050001600,STCTY-36005 HEALTH AREA-    0016.00  IN NEW YORK NY,33624,33527,97,21754,81,9696,50.25
G3600050001700,STCTY-36005 HEALTH AREA-    0017.00  IN NEW YORK NY,23250,23196,54,16646,41,6246,43.37
G3600050001800,STCTY-36005 HEALTH AREA-    0018.00  IN NEW YORK NY,19116,18935,181,11769,175,4409,35.76
G3600050001900,STCTY-36005 HEALTH AREA-    0019.00  IN NEW YORK NY,29750,29638,112,18203,97,5295,39.64
G3600050002000,STCTY-36005 HEALTH AREA-    0020.00  IN NEW YORK NY,31970,31717,253,17292,228,4813,42.77
G3600050002110,STCTY-36005 HEALTH AREA-    0021.10  IN NEW YORK NY,22714,22683,31,12307,26,0,42.5
G3600050002120,STCTY-36005 HEALTH AREA-    0021.20  IN NEW YORK NY,18906,18451,455,10310,442,4286,40.37
G3600050002210,STCTY-36005 HEALTH AREA-    0022.10  IN NEW YORK NY,30516,30388,128,20248,124,6572,48.3
G3600050002220,STCTY-36005 HEALTH AREA-    0022.20  IN NEW YORK NY,34886,34785,101,23158,76,5968,47.97
G3600050002310,STCTY-36005 HEALTH AREA-    0023.10  IN NEW YORK NY,28921,28807,114,17978,107,6750,51.43
G3600050002320,STCTY-36005 HEALTH AREA-    0023.20  IN NEW YORK NY,19393,19289,104,11842,101,0,53.56
G3600050002400,STCTY-36005 HEALTH AREA-    0024.00  IN NEW YORK NY,21082,19524,1558,11135,1549,0,33.38
G3600050002500,STCTY-36005 HEALTH AREA-    0025.00  IN NEW YORK NY,33990,33731,259,20238,235,5098,45.58
G3600050002600,STCTY-36005 HEALTH AREA-    0026.00  IN NEW YORK NY,24208,23098,1110,14668,1101,5026,35.02
G3600050002700,STCTY-36005 HEALTH AREA-    0027.00  IN NEW YORK NY,27201,25498,1703,14343,1690,4655,39.11
G3600050002800,STCTY-36005 HEALTH AREA-    0028.00  IN NEW YORK NY,19256,16464,2792,9523,2783,4400,36.5
G3600050002900,STCTY-36005 HEALTH AREA-    0029.00  IN NEW YORK NY,29997,29875,122,17130,103,4824,41.7
G3600050003010,STCTY-36005 HEALTH AREA-    0030.10  IN NEW YORK NY,23150,23089,61,14786,52,5257,47.46
G3600050003020,STCTY-36005 HEALTH AREA-    0030.20  IN NEW YORK NY,26073,26044,29,17052,19,4543,45.23
G3600050003030,STCTY-36005 HEALTH AREA-    0030.30  IN NEW YORK NY,9151,9137,14,7216,14,3052,43.81
G3600050003100,STCTY-36005 HEALTH AREA-    0031.00  IN NEW YORK NY,16332,16317,15,12290,6,4532,44.66
G3600050003210,STCTY-36005 HEALTH AREA-    0032.10  IN NEW YORK NY,13735,13714,21,10658,18,4831,41.65
G3600050003220,STCTY-36005 HEALTH AREA-    0032.20  IN NEW YORK NY,8718,8712,6,7092,5,2614,43.31
G3600050003310,STCTY-36005 HEALTH AREA-    0033.10  IN NEW YORK NY,23665,23573,92,17126,63,5321,47.77
G3600050003320,STCTY-36005 HEALTH AREA-    0033.20  IN NEW YORK NY,36178,35666,512,23928,500,5750,49.43
G3600050003400,STCTY-36005 HEALTH AREA-    0034.00  IN NEW YORK NY,17288,16686,602,12006,591,4607,34.64
G3600050003500,STCTY-36005 HEALTH AREA-    0035.00  IN NEW YORK NY,26927,24463,2464,16365,2451,4424,37.41
G3600050003600,STCTY-36005 HEALTH AREA-    0036.00  IN NEW YORK NY,22442,21143,1299,11983,1262,0,38.76
G3600050003700,STCTY-36005 HEALTH AREA-    0037.00  IN NEW YORK NY,23960,22173,1787,12770,1732,0,42.06
G3600050003800,STCTY-36005 HEALTH AREA-    0038.00  IN NEW YORK NY,18364,17266,1098,11598,1095,6960,39.75
G3600050003900,STCTY-36005 HEALTH AREA-    0039.00  IN NEW YORK NY,19273,19034,239,12738,234,4692,33.82
G3600050004000,STCTY-36005 HEALTH AREA-    0040.00  IN NEW YORK NY,24385,24005,380,16004,361,3836,34.7
G3600050004100,STCTY-36005 HEALTH AREA-    0041.00  IN NEW YORK NY,22932,22401,531,14556,502,4950,37.36
G3600050004200,STCTY-36005 HEALTH AREA-    0042.00  IN NEW YORK NY,23558,23251,307,13809,274,5278,38.08
G3600050004300,STCTY-36005 HEALTH AREA-    0043.00  IN NEW YORK NY,15117,14951,166,9295,165,4596,42.51
G3600050004400,STCTY-36005 HEALTH AREA-    0044.00  IN NEW YORK NY,24089,23754,335,15330,320,0,34.17
G3600050004500,STCTY-36005 HEALTH AREA-    0045.00  IN NEW YORK NY,19737,19683,54,13367,41,7607,35.21
G3600050004600,STCTY-36005 HEALTH AREA-    0046.00  IN NEW YORK NY,16773,16685,88,11643,60,7324,31.49
G3600050004700,STCTY-36005 HEALTH AREA-    0047.00  IN NEW YORK NY,22053,21737,316,14172,308,4533,33.47
G3600050004800,STCTY-36005 HEALTH AREA-    0048.00  IN NEW YORK NY,3060,2053,1007,1561,925,0,0
G36002900001,STCTY-36029 TRACT-    0001     IN BUFFALO NY,2841,2839,2,2500,2,3668,38.2
G36002900002,STCTY-36029 TRACT-    0002     IN BUFFALO NY,7048,7048,0,6092,0,3619,38.32
G36002900003,STCTY-36029 TRACT-    0003     IN BUFFALO NY,2039,2011,28,1614,28,3274,29.66
G36002900004,STCTY-36029 TRACT-    0004     IN BUFFALO NY,3102,3101,1,2683,1,1894,26.56
G36002900005,STCTY-36029 TRACT-    0005     IN BUFFALO NY,6930,6929,1,5883,1,1797,25.79
G36002900006,STCTY-36029 TRACT-    0006     IN BUFFALO NY,5803,5803,0,5122,0,4209,38.43
G36002900007,STCTY-36029 TRACT-    0007     IN BUFFALO NY,3527,3527,0,3182,0,4945,44.33
G36002900008,STCTY-36029 TRACT-    0008     IN BUFFALO NY,7763,7763,0,6922,0,4208,44.32
G36002900009,STCTY-36029 TRACT-    0009     IN BUFFALO NY,3259,3258,1,2986,1,4371,50.77
G36002900010,STCTY-36029 TRACT-    0010     IN BUFFALO NY,8555,8554,1,7720,0,3486,38.85
G36002900011,STCTY-36029 TRACT-    0011     IN BUFFALO NY,4646,4646,0,4209,0,3639,36.51
G36002900012,STCTY-36029 TRACT-    0012     IN BUFFALO NY,11148,10372,776,7914,776,2378,26.14
G36002900013,STCTY-36029 TRACT-    0013     IN BUFFALO NY,10311,9451,860,6420,796,2722,23.69
G36002900014,STCTY-36029 TRACT-    0014     IN BUFFALO NY,12624,3547,9077,2538,9039,2300,27.19
G36002900015,STCTY-36029 TRACT-    0015     IN BUFFALO NY,13157,10233,2924,8469,2922,2309,26.02
G36002900016,STCTY-36029 TRACT-    0016     IN BUFFALO NY,14424,14407,17,11712,17,2258,23.55
G36002900017,STCTY-36029 TRACT-    0017     IN BUFFALO NY,6433,6417,16,5204,16,2329,24.44
G36002900018,STCTY-36029 TRACT-    0018     IN BUFFALO NY,3397,3388,9,2792,2,2035,24.55
G36002900019,STCTY-36029 TRACT-    0019     IN BUFFALO NY,5307,5307,0,4515,0,2666,28.04
G36002900020,STCTY-36029 TRACT-    0020     IN BUFFALO NY,3657,3654,3,3213,0,2694,28.8
G36002900021,STCTY-36029 TRACT-    0021     IN BUFFALO NY,1500,1500,0,1273,0,2639,31.26
G36002900022,STCTY-36029 TRACT-    0022     IN BUFFALO NY,3751,3751,0,3143,0,2175,27.57
G36002900023,STCTY-36029 TRACT-    0023     IN BUFFALO NY,6096,6094,2,5032,1,2766,32.68
G36002900024,STCTY-36029 TRACT-    0024     IN BUFFALO NY,10764,10755,9,9258,9,2515,27.89
G36002900025,STCTY-36029 TRACT-    0025     IN BUFFALO NY,16788,14963,1825,12345,1772,2372,26.29
G36002900026,STCTY-36029 TRACT-    0026     IN BUFFALO NY,5499,5278,221,4506,221,2883,26.75
G36002900027,STCTY-36029 TRACT-    0027     IN BUFFALO NY,23108,23101,7,18690,5,2666,27.37
G36002900028,STCTY-36029 TRACT-    0028     IN BUFFALO NY,12061,12061,0,10100,0,2331,27.18
G36002900029,STCTY-36029 TRACT-    0029     IN BUFFALO NY,8727,8723,4,7431,2,2979,33.24
G36002900030,STCTY-36029 TRACT-    0030     IN BUFFALO NY,4658,4657,1,4000,0,3507,34.53
G36002900031,STCTY-36029 TRACT-    0031     IN BUFFALO NY,15492,15458,34,13338,23,3174,31.14
G36002900032,STCTY-36029 TRACT-    0032     IN BUFFALO NY,17606,16157,1449,13840,1427,3470,33.4
G36002900033,STCTY-36029 TRACT-    0033     IN BUFFALO NY,17054,16980,74,14129,60,4760,40.58
G36002900034,STCTY-36029 TRACT-    0034     IN BUFFALO NY,8106,8095,11,6760,11,3516,37.16
G36002900035,STCTY-36029 TRACT-    0035     IN BUFFALO NY,11133,11124,9,9380,9,3285,32.91
G36002900036,STCTY-36029 TRACT-    0036     IN BUFFALO NY,8246,8241,5,7207,0,3169,35.2
G36002900037,STCTY-36029 TRACT-    0037     IN BUFFALO NY,7769,7760,9,6790,5,3620,38.81
G36002900038,STCTY-36029 TRACT-    0038     IN BUFFALO NY,4531,4527,4,3907,4,3549,39.67
G36002900039,STCTY-36029 TRACT-    0039     IN BUFFALO NY,8002,7918,84,7007,72,4750,41.98
G36002900040,STCTY-36029 TRACT-    0040     IN BUFFALO NY,8997,8985,12,8010,8,4314,39.81
G36002900041,STCTY-36029 TRACT-    0041     IN BUFFALO NY,7576,7575,1,6475,0,3834,40.91
G36002900042,STCTY-36029 TRACT-    0042     IN BUFFALO NY,6472,6471,1,5881,0,4955,44.76
G36002900043,STCTY-36029 TRACT-    0043     IN BUFFALO NY,8156,8156,0,7345,0,4859,45.63
G36002900044,STCTY-36029 TRACT-    0044     IN BUFFALO NY,7180,7180,0,6478,0,4469,38.16
G36002900045,STCTY-36029 TRACT-    0045     IN BUFFALO NY,5835,5818,17,5346,17,10377,59.53
G36002900046,STCTY-36029 TRACT-    0046     IN BUFFALO NY,3804,3802,2,3458,0,6120,43.31
G36002900047,STCTY-36029 TRACT-    0047     IN BUFFALO NY,7914,7911,3,7130,2,5875,49.43
G36002900048,STCTY-36029 TRACT-    0048     IN BUFFALO NY,5696,5680,16,5185,15,7438,56.94
G36002900049,STCTY-36029 TRACT-    0049     IN BUFFALO NY,9928,9915,13,8124,6,5247,47.79
G36002900050,STCTY-36029 TRACT-    0050     IN BUFFALO NY,3300,3297,3,2836,3,4912,46.28
G36002900051,STCTY-36029 TRACT-    0051     IN BUFFALO NY,4680,4674,6,4156,4,5216,48.87
G36002900052,STCTY-36029 TRACT-    0052     IN BUFFALO NY,8608,8590,18,7785,16,6971,50.01
G36002900053,STCTY-36029 TRACT-    0053     IN BUFFALO NY,1142,1139,3,1040,3,10375,55.5
G36002900054,STCTY-36029 TRACT-    0054     IN BUFFALO NY,4667,4641,26,4085,25,14275,58.92
G36002900055,STCTY-36029 TRACT-    0055     IN BUFFALO NY,9614,9610,4,6919,0,2214,26.08
G36002900056,STCTY-36029 TRACT-    0056     IN BUFFALO NY,4993,4993,0,3698,0,2907,34.51
G36002900057,STCTY-36029 TRACT-    0057     IN BUFFALO NY,4166,4166,0,3364,0,3493,38.49
G36002900058,STCTY-36029 TRACT-    0058     IN BUFFALO NY,12267,12267,0,9879,0,3663,39.14
G36002900059,STCTY-36029 TRACT-    0059     IN BUFFALO NY,6809,6809,0,5461,0,2536,29.79
G36002900060,STCTY-36029 TRACT-    0060     IN BUFFALO NY,10061,10014,47,8324,20,3306,32.79
G36002900061,STCTY-36029 TRACT-    0061     IN BUFFALO NY,10080,10059,21,8192,5,3580,33.96
G36002900062,STCTY-36029 TRACT-    0062     IN BUFFALO NY,3692,3612,80,2639,78,0,35.52
G36002900063,STCTY-36029 TRACT-    0063     IN BUFFALO NY,9865,9801,64,8231,50,7868,47.05
G36002900064,STCTY-36029 TRACT-    0064     IN BUFFALO NY,1081,1079,2,950,2,0,46.34
G36002900065,STCTY-36029 TRACT-    0065     IN BUFFALO NY,8703,8679,24,7454,19,6838,46.03
G36002900066,STCTY-36029 TRACT-    0066     IN BUFFALO NY,6157,6124,33,5113,25,7091,40.69
G36002900067,STCTY-36029 TRACT-    0067     IN BUFFALO NY,9336,9281,55,7936,46,7377,49.79
G36002900068,STCTY-36029 TRACT-    0068     IN BUFFALO NY,9007,8940,67,7359,30,5474,31.53
G36002900069,STCTY-36029 TRACT-    0069     IN BUFFALO NY,16562,16503,59,12868,30,3376,32.5
G36002900070,STCTY-36029 TRACT-    0070     IN BUFFALO NY,8391,8338,53,6396,29,3290,30.44
G36002900071,STCTY-36029 TRACT-    0071     IN BUFFALO NY,20768,20624,144,15231,17,2650,25.16
G36002900072,STCTY-36029 TRACT-    0072     IN BUFFALO NY,3532,3487,45,2655,22,0,21.41
G3600470000100,STCTY-36047 HEALTH AREA-    0001.00  IN NEW YORK NY,18790,18763,27,14256,4,3385,32.8
G3600470000200,STCTY-36047 HEALTH AREA-    0002.00  IN NEW YORK NY,22432,22421,11,17265,0,2825,31.61
G3600470000300,STCTY-36047 HEALTH AREA-    0003.00  IN NEW YORK NY,16632,16631,1,12534,0,2989,29.47
G3600470000400,STCTY-36047 HEALTH AREA-    0004.00  IN NEW YORK NY,17725,17576,149,11822,146,4450,26.52
G3600470000500,STCTY-36047 HEALTH AREA-    0005.00  IN NEW YORK NY,29997,29495,502,18142,435,3380,36.05
G3600470000600,STCTY-36047 HEALTH AREA-    0006.00  IN NEW YORK NY,31954,31641,313,18574,263,3862,33.4
G3600470000700,STCTY-36047 HEALTH AREA-    0007.00  IN NEW YORK NY,24961,24902,59,17544,53,3414,30.86
G3600470000800,STCTY-36047 HEALTH AREA-    0008.00  IN NEW YORK NY,18615,18581,34,12955,28,3788,30.28
G3600470000900,STCTY-36047 HEALTH AREA-    0009.00  IN NEW YORK NY,18105,18077,28,14511,19,3170,26.29
G3600470001000,STCTY-36047 HEALTH AREA-    0010.00  IN NEW YORK NY,13138,11987,1151,9032,804,5446,24.76
G3600470001100,STCTY-36047 HEALTH AREA-    0011.00  IN NEW YORK NY,12830,10707,2123,7966,2052,4934,28.49
G3600470001200,STCTY-36047 HEALTH AREA-    0012.00  IN NEW YORK NY,22599,21458,1141,17268,1089,7340,38.18
G3600470001300,STCTY-36047 HEALTH AREA-    0013.00  IN NEW YORK NY,23942,14707,9235,11824,9186,6072,34.3
G3600470001400,STCTY-36047 HEALTH AREA-    0014.00  IN NEW YORK NY,26387,25326,1061,18711,976,2852,27.55
G3600470001500,STCTY-36047 HEALTH AREA-    0015.00  IN NEW YORK NY,17586,16864,722,10604,674,4150,27.71
G3600470001600,STCTY-36047 HEALTH AREA-    0016.00  IN NEW YORK NY,15366,13287,2079,8583,1955,2235,25.12
G3600470001700,STCTY-36047 HEALTH AREA-    0017.00  IN NEW YORK NY,21033,20541,492,13797,469,2362,25.91
G3600470001800,STCTY-36047 HEALTH AREA-    0018.00  IN NEW YORK NY,20188,18500,1688,11546,1652,3000,33.33
G3600470001900,STCTY-36047 HEALTH AREA-    0019.00  IN NEW YORK NY,22253,20918,1335,13785,1297,3611,33.67
G3600470002000,STCTY-36047 HEALTH AREA-    0020.00  IN NEW YORK NY,23763,10875,12888,7587,12871,3601,34.36
G3600470002100,STCTY-36047 HEALTH AREA-    0021.00  IN NEW YORK NY,19545,15532,4013,11204,3987,4072,33.55
G3600470002200,STCTY-36047 HEALTH AREA-    0022.00  IN NEW YORK NY,19197,19186,11,13065,3,2205,30.78
G3600470002300,STCTY-36047 HEALTH AREA-    0023.00  IN NEW YORK NY,29343,28638,705,21983,479,9430,45.47
G3600470002400,STCTY-36047 HEALTH AREA-    0024.00  IN NEW YORK NY,19074,18084,990,13475,742,4506,29.23
G3600470002500,STCTY-36047 HEALTH AREA-    0025.00  IN NEW YORK NY,14628,14604,24,10986,8,3549,32.16
G3600470002600,STCTY-36047 HEALTH AREA-    0026.00  IN NEW YORK NY,21852,19902,1950,14151,1869,6336,32.1
G3600470002710,STCTY-36047 HEALTH AREA-    0027.10  IN NEW YORK NY,22478,17453,5025,12895,4999,5494,31.84
G3600470002720,STCTY-36047 HEALTH AREA-    0027.20  IN NEW YORK NY,16278,16153,125,11848,123,0,52.91
G3600470002800,STCTY-36047 HEALTH AREA-    0028.00  IN NEW YORK NY,28494,14459,14035,11540,14006,5153,34.18
G3600470002900,STCTY-36047 HEALTH AREA-    0029.00  IN NEW YORK NY,33160,30998,2162,23353,2156,8031,46.08
G3600470003000,STCTY-36047 HEALTH AREA-    0030.00  IN NEW YORK NY,29060,17662,11398,13977,11356,4364,33.9
G3600470003100,STCTY-36047 HEALTH AREA-    0031.00  IN NEW YORK NY,28045,27162,883,21779,873,4591,32.43
G3600470003200,STCTY-36047 HEALTH AREA-    0032.00  IN NEW YORK NY,25116,25097,19,17254,10,3082,31.32
G3600470003300,STCTY-36047 HEALTH AREA-    0033.00  IN NEW YORK NY,29342,29328,14,20977,2,2714,32.54
G3600470003400,STCTY-36047 HEALTH AREA-    0034.00  IN NEW YORK NY,29296,29280,16,22508,2,3327,33.29
G3600470003500,STCTY-36047 HEALTH AREA-    0035.00  IN NEW YORK NY,26879,26859,20,21807,5,3412,34.1
G3600470003600,STCTY-36047 HEALTH AREA-    0036.00  IN NEW YORK NY,20205,11619,8586,8656,8557,4056,31.04
G3600470003700,STCTY-36047 HEALTH AREA-    0037.00  IN NEW YORK NY,14506,14100,406,10115,405,3546,30.48
G3600470003800,STCTY-36047 HEALTH AREA-    0038.00  IN NEW YORK NY,23128,23076,52,18209,50,5021,35.86
G3600470003900,STCTY-36047 HEALTH AREA-    0039.00  IN NEW YORK NY,23678,23662,16,19875,5,3952,38.7
G3600470004000,STCTY-36047 HEALTH AREA-    0040.00  IN NEW YORK NY,24225,23748,477,15312,323,3571,28.57
G3600470004100,STCTY-36047 HEALTH AREA-    0041.00  IN NEW YORK NY,30340,30210,130,22225,115,3369,24.23
G3600470004200,STCTY-36047 HEALTH AREA-    0042.00  IN NEW YORK NY,21045,21039,6,15054,3,5425,32.15
G3600470004300,STCTY-36047 HEALTH AREA-    0043.00  IN NEW YORK NY,15722,15681,41,11759,13,3564,28.21
G3600470004400,STCTY-36047 HEALTH AREA-    0044.00  IN NEW YORK NY,20203,20141,62,14490,5,3914,29.69
G3600470004500,STCTY-36047 HEALTH AREA-    0045.00  IN NEW YORK NY,26459,26344,115,20077,93,11090,47.63
G3600470004600,STCTY-36047 HEALTH AREA-    0046.00  IN NEW YORK NY,26708,26657,51,20393,23,5303,38.66
G3600470004700,STCTY-36047 HEALTH AREA-    0047.00  IN NEW YORK NY,29931,29903,28,22962,13,4244,34.05
G3600470004800,STCTY-36047 HEALTH AREA-    0048.00  IN NEW YORK NY,34011,33759,252,24698,245,6072,48.34
G3600470004900,STCTY-36047 HEALTH AREA-    0049.00  IN NEW YORK NY,29970,29540,430,20798,410,8666,52.64
G3600470005010,STCTY-36047 HEALTH AREA-    0050.10  IN NEW YORK NY,24167,23764,403,15632,401,6117,47.7
G3600470005020,STCTY-36047 HEALTH AREA-    0050.20  IN NEW YORK NY,17428,17288,140,10789,131,4910,45.89
G3600470005100,STCTY-36047 HEALTH AREA-    0051.00  IN NEW YORK NY,24875,24005,870,13997,850,3511,36.99
G3600470005200,STCTY-36047 HEALTH AREA-    0052.00  IN NEW YORK NY,16440,12378,4062,7995,4056,2741,31.58
G3600470005310,STCTY-36047 HEALTH AREA-    0053.10  IN NEW YORK NY,20439,20372,67,15365,55,4540,47.54
G3600470005320,STCTY-36047 HEALTH AREA-    0053.20  IN NEW YORK NY,32865,32672,193,25945,162,12326,56.4
G3600470005400,STCTY-36047 HEALTH AREA-    0054.00  IN NEW YORK NY,30646,30092,554,23889,527,7275,47.93
G3600470005510,STCTY-36047 HEALTH AREA-    0055.10  IN NEW YORK NY,29709,29404,305,19998,294,5952,49.02
G3600470005520,STCTY-36047 HEALTH AREA-    0055.20  IN NEW YORK NY,32830,32600,230,24366,213,5869,45.24
G3600470005600,STCTY-36047 HEALTH AREA-    0056.00  IN NEW YORK NY,23906,23661,245,13264,194,3750,36.09
G3600470005700,STCTY-36047 HEALTH AREA-    0057.00  IN NEW YORK NY,21516,18891,2625,11275,2587,3957,29.86
G3600470005810,STCTY-36047 HEALTH AREA-    0058.10  IN NEW YORK NY,28029,27944,85,17008,73,4741,47.04
G3600470005820,STCTY-36047 HEALTH AREA-    0058.20  IN NEW YORK NY,23783,23702,81,13282,77,3787,43.14
G3600470005900,STCTY-36047 HEALTH AREA-    0059.00  IN NEW YORK NY,24224,20691,3533,11413,3516,2750,30.08
G3600470006000,STCTY-36047 HEALTH AREA-    0060.00  IN NEW YORK NY,22151,20683,1468,11572,1468,3412,33.15
G3600470006100,STCTY-36047 HEALTH AREA-    0061.00  IN NEW YORK NY,25393,24565,828,14723,815,3119,32.94
G3600470006200,STCTY-36047 HEALTH AREA-    0062.00  IN NEW YORK NY,29314,28191,1123,18327,1109,2943,34.64
G3600470006300,STCTY-36047 HEALTH AREA-    0063.00  IN NEW YORK NY,28632,28576,56,15813,46,3855,37.87
G3600470006410,STCTY-36047 HEALTH AREA-    0064.10  IN NEW YORK NY,16382,16315,67,11932,48,3560,35.39
G3600470006420,STCTY-36047 HEALTH AREA-    0064.20  IN NEW YORK NY,22004,21708,296,13716,282,3366,41.25
G3600470006430,STCTY-36047 HEALTH AREA-    0064.30  IN NEW YORK NY,73,73,0,56,0,0,0
G3600470006500,STCTY-36047 HEALTH AREA-    0065.00  IN NEW YORK NY,29258,29219,39,20144,17,4112,35.06
G3600470006600,STCTY-36047 HEALTH AREA-    0066.00  IN NEW YORK NY,31572,31554,18,20414,4,4227,39.04
G3600470006700,STCTY-36047 HEALTH AREA-    0067.00  IN NEW YORK NY,35175,35156,19,21369,17,5035,43.85
G3600470006800,STCTY-36047 HEALTH AREA-    0068.00  IN NEW YORK NY,32662,32517,145,20503,132,5046,51.02
G3600470006900,STCTY-36047 HEALTH AREA-    0069.00  IN NEW YORK NY,25904,25871,33,15740,17,3700,37.96
G3600470007000,STCTY-36047 HEALTH AREA-    0070.00  IN NEW YORK NY,32090,31943,147,23236,124,5500,46.75
G3600470007110,STCTY-36047 HEALTH AREA-    0071.10  IN NEW YORK NY,13686,13605,81,8998,71,6539,47.71
G3600470007120,STCTY-36047 HEALTH AREA-    0071.20  IN NEW YORK NY,27196,26930,266,19151,255,6932,50.84
G3600470007210,STCTY-36047 HEALTH AREA-    0072.10  IN NEW YORK NY,36097,35805,292,29563,268,12514,56.51
G3600470007220,STCTY-36047 HEALTH AREA-    0072.20  IN NEW YORK NY,16669,16531,138,13318,136,11284,54.22
G3600470007310,STCTY-36047 HEALTH AREA-    0073.10  IN NEW YORK NY,28049,27735,314,20137,277,8091,51.37
G3600470007320,STCTY-36047 HEALTH AREA-    0073.20  IN NEW YORK NY,24941,24747,194,18250,173,7461,54.85
G3600470007410,STCTY-36047 HEALTH AREA-    0074.10  IN NEW YORK NY,26643,26623,20,21790,17,6873,47.32
G3600470007420,STCTY-36047 HEALTH AREA-    0074.20  IN NEW YORK NY,12628,12583,45,9807,44,5998,53.27
G3600470007510,STCTY-36047 HEALTH AREA-    0075.10  IN NEW YORK NY,15483,15443,40,11089,34,4406,38.18
G3600470007520,STCTY-36047 HEALTH AREA-    0075.20  IN NEW YORK NY,16040,15987,53,11612,48,3506,36.7
G3600470007600,STCTY-36047 HEALTH AREA-    0076.00  IN NEW YORK NY,30963,30916,47,23319,27,8897,49.73
G3600470007700,STCTY-36047 HEALTH AREA-    0077.00  IN NEW YORK NY,23281,23278,3,16559,0,5695,41.6
G3600470007810,STCTY-36047 HEALTH AREA-    0078.10  IN NEW YORK NY,27059,26994,65,20679,51,8750,49.16
G3600470007820,STCTY-36047 HEALTH AREA-    0078.20  IN NEW YORK NY,12885,12862,23,9423,9,6625,46.19
G3600470007910,STCTY-36047 HEALTH AREA-    0079.10  IN NEW YORK NY,18634,18617,17,14084,17,7342,49.41
G3600470007920,STCTY-36047 HEALTH AREA-    0079.20  IN NEW YORK NY,19490,19479,11,14840,10,6987,47.47
G3600470008010,STCTY-36047 HEALTH AREA-    0080.10  IN NEW YORK NY,24060,23923,137,17152,134,6442,38.62
G3600470008020,STCTY-36047 HEALTH AREA-    0080.20  IN NEW YORK NY,16026,16019,7,10969,5,6058,42.25
G3600470008110,STCTY-36047 HEALTH AREA-    0081.10  IN NEW YORK NY,18831,18815,16,12282,10,5750,43.29
G3600470008120,STCTY-36047 HEALTH AREA-    0081.20  IN NEW YORK NY,23041,23011,30,14665,26,5063,43.39
G3600470008200,STCTY-36047 HEALTH AREA-    0082.00  IN NEW YORK NY,33338,33108,230,21936,228,5341,40.11
G3600470008300,STCTY-36047 HEALTH AREA-    0083.00  IN NEW YORK NY,33894,33734,160,20888,132,5976,48.33
G3600470008400,STCTY-36047 HEALTH AREA-    0084.00  IN NEW YORK NY,29037,28730,307,17494,289,7275,46.61
G3600470008510,STCTY-36047 HEALTH AREA-    0085.10  IN NEW YORK NY,28261,28059,202,19206,200,6615,48.64
G3600470008521,STCTY-36047 HEALTH AREA-    0085.21  IN NEW YORK NY,20019,19968,51,12794,51,6652,49.54
G3600470008522,STCTY-36047 HEALTH AREA-    0085.22  IN NEW YORK NY,17801,17783,18,11691,16,5575,46.29
G3600470008610,STCTY-36047 HEALTH AREA-    0086.10  IN NEW YORK NY,24014,23975,39,15797,36,5935,41.27
G3600470008620,STCTY-36047 HEALTH AREA-    0086.20  IN NEW YORK NY,25474,25413,61,16812,58,4446,40.77
G3600470008710,STCTY-36047 HEALTH AREA-    0087.10  IN NEW YORK NY,22425,22284,141,16099,112,7477,53.36
G3600470008721,STCTY-36047 HEALTH AREA-    0087.21  IN NEW YORK NY,19260,18650,610,13488,608,5539,42.2
G3600470008722,STCTY-36047 HEALTH AREA-    0087.22  IN NEW YORK NY,18272,18192,80,13542,77,6291,49.28
G3600470008810,STCTY-36047 HEALTH AREA-    0088.10  IN NEW YORK NY,28479,28191,288,23249,274,7572,55.42
G3600470008821,STCTY-36047 HEALTH AREA-    0088.21  IN NEW YORK NY,25909,25787,122,21231,119,6021,52.52
G3600470008822,STCTY-36047 HEALTH AREA-    0088.22  IN NEW YORK NY,19197,19156,41,15657,14,5047,45.94
G3600470008900,STCTY-36047 HEALTH AREA-    0089.00  IN NEW YORK NY,8713,8713,0,7179,0,3804,39.97
G3600470009010,STCTY-36047 HEALTH AREA-    0090.10  IN NEW YORK NY,20152,19808,344,12058,330,6964,39.02
G3600470009020,STCTY-36047 HEALTH AREA-    0090.20  IN NEW YORK NY,21363,20657,706,12641,646,5940,36.21
G3600470009110,STCTY-36047 HEALTH AREA-    0091.10  IN NEW YORK NY,21209,21088,121,11117,117,3458,52.34
G3600470009120,STCTY-36047 HEALTH AREA-    0091.20  IN NEW YORK NY,15333,15098,235,9699,231,9987,54.34
G3600470009200,STCTY-36047 HEALTH AREA-    0092.00  IN NEW YORK NY,1437,1432,5,1331,2,0,0
G3600470009300,STCTY-36047 HEALTH AREA-    0093.00  IN NEW YORK NY,1315,1254,61,1223,43,0,0
G36005500001,STCTY-36055 TRACT-    0001     IN ROCHESTER NY,1178,1147,31,923,23,0,19.59
G36005500002,STCTY-36055 TRACT-    0002     IN ROCHESTER NY,1211,1204,7,847,4,0,23.03
G36005500003,STCTY-36055 TRACT-    0003     IN ROCHESTER NY,2702,1821,881,1506,879,0,25.59
G36005500004,STCTY-36055 TRACT-    0004     IN ROCHESTER NY,5383,5170,213,4626,212,4475,30.36
G36005500005,STCTY-36055 TRACT-    0005     IN ROCHESTER NY,4171,4158,13,3648,0,0,28.3
G36005500006,STCTY-36055 TRACT-    0006     IN ROCHESTER NY,2196,2170,26,1545,25,2875,32.73
G36005500007,STCTY-36055 TRACT-    0007     IN ROCHESTER NY,1715,1715,0,1214,0,2344,35.89
G36005500008,STCTY-36055 TRACT-    0008     IN ROCHESTER NY,3299,3298,1,2252,1,3167,26.12
G36005500009,STCTY-36055 TRACT-    0009     IN ROCHESTER NY,2514,2477,37,2114,20,0,25.97
G36005500010,STCTY-36055 TRACT-    0010     IN ROCHESTER NY,5006,4945,61,4253,61,5991,38.78
G36005500011,STCTY-36055 TRACT-    0011     IN ROCHESTER NY,1605,1418,187,991,187,0,25.15
G36005500012,STCTY-36055 TRACT-    0012     IN ROCHESTER NY,3431,2710,721,1939,718,3381,27.5
G36005500013,STCTY-36055 TRACT-    0013     IN ROCHESTER NY,4797,4627,170,3051,170,3067,26.51
G36005500014,STCTY-36055 TRACT-    0014     IN ROCHESTER NY,4592,4542,50,3018,50,2809,30.46
G36005500015,STCTY-36055 TRACT-    0015     IN ROCHESTER NY,4483,4476,7,3105,7,2627,25.74
G36005500016,STCTY-36055 TRACT-    0016     IN ROCHESTER NY,3008,3000,8,2068,1,3189,29.72
G36005500017,STCTY-36055 TRACT-    0017     IN ROCHESTER NY,4050,4047,3,2774,1,3167,28.85
G36005500018,STCTY-36055 TRACT-    0018     IN ROCHESTER NY,2976,2971,5,2478,0,4172,42.65
G36005500019,STCTY-36055 TRACT-    0019     IN ROCHESTER NY,5594,5594,0,4568,0,4362,43.84
G36005500020,STCTY-36055 TRACT-    0020     IN ROCHESTER NY,6177,6176,1,5433,1,5364,49.47
G36005500021,STCTY-36055 TRACT-    0021     IN ROCHESTER NY,4314,4313,1,3851,1,5516,51.28
G36005500022,STCTY-36055 TRACT-    0022     IN ROCHESTER NY,4045,4043,2,3461,2,4753,42.11
G36005500023,STCTY-36055 TRACT-    0023     IN ROCHESTER NY,6383,6383,0,5385,0,3676,36.49
G36005500024,STCTY-36055 TRACT-    0024     IN ROCHESTER NY,4600,4594,6,3554,6,3503,37.32
G36005500025,STCTY-36055 TRACT-    0025     IN ROCHESTER NY,2942,2942,0,2074,0,3018,32.85
G36005500026,STCTY-36055 TRACT-    0026     IN ROCHESTER NY,4295,4269,26,3653,25,3304,33.32
G36005500027,STCTY-36055 TRACT-    0027     IN ROCHESTER NY,4260,3999,261,3155,255,3139,33.9
G36005500028,STCTY-36055 TRACT-    0028     IN ROCHESTER NY,3748,3735,13,3224,2,5731,24.54
G36005500029,STCTY-36055 TRACT-    0029     IN ROCHESTER NY,5285,5265,20,4628,10,5888,41.49
G36005500030,STCTY-36055 TRACT-    0030     IN ROCHESTER NY,3660,3654,6,3138,1,4787,34.45
G36005500031,STCTY-36055 TRACT-    0031     IN ROCHESTER NY,5810,5775,35,4987,23,8457,47.07
G36005500032,STCTY-36055 TRACT-    0032     IN ROCHESTER NY,3255,3253,2,2858,1,4345,29.86
G36005500033,STCTY-36055 TRACT-    0033     IN ROCHESTER NY,2111,2110,1,1873,0,2886,36.67
G36005500034,STCTY-36055 TRACT-    0034     IN ROCHESTER NY,3061,3059,2,2699,2,3620,34.59
G36005500035,STCTY-36055 TRACT-    0035     IN ROCHESTER NY,2197,2195,2,1929,1,4895,37.86
G36005500036,STCTY-36055 TRACT-    0036     IN ROCHESTER NY,4835,4822,13,4319,13,3983,39.18
G36005500037,STCTY-36055 TRACT-    0037     IN ROCHESTER NY,4422,4417,5,3679,5,5377,46.32
G36005500038,STCTY-36055 TRACT-    0038     IN ROCHESTER NY,7080,6990,90,5637,88,5480,44.68
G36005500039,STCTY-36055 TRACT-    0039     IN ROCHESTER NY,1811,1809,2,1282,1,3671,42.05
G36005500040,STCTY-36055 TRACT-    0040     IN ROCHESTER NY,2254,2254,0,1775,0,3218,35.81
G36005500041,STCTY-36055 TRACT-    0041     IN ROCHESTER NY,3671,3671,0,2665,0,2464,31.99
G36005500042,STCTY-36055 TRACT-    0042     IN ROCHESTER NY,3258,3258,0,2566,0,2989,35.29
G36005500043,STCTY-36055 TRACT-    0043     IN ROCHESTER NY,2177,2177,0,1468,0,1875,20.63
G36005500044,STCTY-36055 TRACT-    0044     IN ROCHESTER NY,4319,4317,2,3022,1,2616,28.67
G36005500045,STCTY-36055 TRACT-    0045     IN ROCHESTER NY,2739,2700,39,2121,26,4889,33.15
G36005500046,STCTY-36055 TRACT-    0046     IN ROCHESTER NY,3810,3807,3,3125,3,5997,51.77
G36005500047,STCTY-36055 TRACT-    0047     IN ROCHESTER NY,2615,2615,0,1915,0,4172,39.07
G36005500048,STCTY-36055 TRACT-    0048     IN ROCHESTER NY,3800,3797,3,2870,3,3704,35.74
G36005500049,STCTY-36055 TRACT-    0049     IN ROCHESTER NY,3548,3548,0,2573,0,3424,35.77
G36005500050,STCTY-36055 TRACT-    0050     IN ROCHESTER NY,4389,4388,1,3256,0,3811,39.66
G36005500051,STCTY-36055 TRACT-    0051     IN ROCHESTER NY,2603,2603,0,1906,0,3851,39.83
G36005500052,STCTY-36055 TRACT-    0052     IN ROCHESTER NY,4038,4036,2,2878,2,3126,32.54
G36005500053,STCTY-36055 TRACT-    0053     IN ROCHESTER NY,3858,3858,0,2784,0,3287,33.67
G36005500054,STCTY-36055 TRACT-    0054     IN ROCHESTER NY,4837,4789,48,3932,48,4945,45
G36005500055,STCTY-36055 TRACT-    0055     IN ROCHESTER NY,4452,4452,0,3023,0,2954,28.64
G36005500056,STCTY-36055 TRACT-    0056     IN ROCHESTER NY,4885,4792,93,3783,92,3228,31.54
G36005500057,STCTY-36055 TRACT-    0057     IN ROCHESTER NY,3040,3034,6,2680,0,4095,38.11
G36005500058,STCTY-36055 TRACT-    0058     IN ROCHESTER NY,4978,4978,0,4369,0,4964,45.78
G36005500059,STCTY-36055 TRACT-    0059     IN ROCHESTER NY,3306,3272,34,2762,32,4263,38.64
G36005500060,STCTY-36055 TRACT-    0060     IN ROCHESTER NY,4634,4634,0,4032,0,5059,48.68
G36005500061,STCTY-36055 TRACT-    0061     IN ROCHESTER NY,2557,2557,0,2206,0,5271,54.01
G36005500062,STCTY-36055 TRACT-    0062     IN ROCHESTER NY,4313,4310,3,3827,1,6019,45.71
G36005500063,STCTY-36055 TRACT-    0063     IN ROCHESTER NY,4482,4482,0,3970,0,5386,43.05
G36005500064,STCTY-36055 TRACT-    0064     IN ROCHESTER NY,5270,5224,46,4563,46,3603,37.24
G36005500065,STCTY-36055 TRACT-    0065     IN ROCHESTER NY,3328,3314,14,2839,14,3265,34.32
G36005500066,STCTY-36055 TRACT-    0066     IN ROCHESTER NY,3113,3107,6,2740,6,4547,39.64
G36005500067,STCTY-36055 TRACT-    0067     IN ROCHESTER NY,4085,4076,9,3672,3,6388,45.28
G36005500068,STCTY-36055 TRACT-    0068     IN ROCHESTER NY,3814,3811,3,3370,3,5401,47.73
G36005500069,STCTY-36055 TRACT-    0069     IN ROCHESTER NY,2777,2774,3,2421,3,3573,37.03
G36005500070,STCTY-36055 TRACT-    0070     IN ROCHESTER NY,3997,3995,2,3573,0,5190,44.62
G36005500071,STCTY-36055 TRACT-    0071     IN ROCHESTER NY,4401,4400,1,3904,1,5397,52.1
G36005500072,STCTY-36055 TRACT-    0072     IN ROCHESTER NY,2120,2120,0,1622,0,2734,35.91
G36005500073,STCTY-36055 TRACT-    0073     IN ROCHESTER NY,2143,2143,0,1815,0,3353,33.35
G36005500074,STCTY-36055 TRACT-    0074     IN ROCHESTER NY,2876,2865,11,2360,11,2641,35.2
G36005500075,STCTY-36055 TRACT-    0075     IN ROCHESTER NY,4240,4237,3,3653,3,4504,39.91
G36005500076,STCTY-36055 TRACT-    0076     IN ROCHESTER NY,4181,4174,7,3422,2,5124,44.98
G36005500077,STCTY-36055 TRACT-    0077     IN ROCHESTER NY,2774,2760,14,2387,11,4580,44.35
G36005500078,STCTY-36055 TRACT-    0078     IN ROCHESTER NY,4757,4741,16,4260,13,9782,54.03
G36005500079,STCTY-36055 TRACT-    0079     IN ROCHESTER NY,2995,2989,6,2208,6,3362,33.82
G36005500080,STCTY-36055 TRACT-    0080     IN ROCHESTER NY,3831,3819,12,3041,12,3805,36.53
G36005500081,STCTY-36055 TRACT-    0081     IN ROCHESTER NY,4058,4032,26,3234,24,4074,41.46
G36005500082,STCTY-36055 TRACT-    0082     IN ROCHESTER NY,3299,3270,29,2601,29,4399,34.77
G36005500083,STCTY-36055 TRACT-    0083     IN ROCHESTER NY,2435,2383,52,1836,52,4207,34.57
G36005500084,STCTY-36055 TRACT-    0084     IN ROCHESTER NY,3352,3343,9,2523,9,3947,34.42
G36005500085,STCTY-36055 TRACT-    0085     IN ROCHESTER NY,3350,3347,3,2864,3,3896,37.82
G36005500086,STCTY-36055 TRACT-    0086     IN ROCHESTER NY,3443,3441,2,3027,2,5051,49.81
G36005500087,STCTY-36055 TRACT-    0087     IN ROCHESTER NY,5347,5343,4,4402,4,3356,34.84
G36005500088,STCTY-36055 TRACT-    0088     IN ROCHESTER NY,2224,2224,0,1863,0,4148,43.08
G3600610000110,STCTY-36061 HEALTH AREA-    0001.10  IN NEW YORK NY,21187,21131,56,16061,29,7500,48.48
G3600610000120,STCTY-36061 HEALTH AREA-    0001.20  IN NEW YORK NY,21844,21751,93,15097,41,0,47.22
G3600610000210,STCTY-36061 HEALTH AREA-    0002.10  IN NEW YORK NY,26859,26709,150,16839,69,0,48.62
G3600610000221,STCTY-36061 HEALTH AREA-    0002.21  IN NEW YORK NY,22536,22356,180,14573,49,0,47.87
G3600610000222,STCTY-36061 HEALTH AREA-    0002.22  IN NEW YORK NY,17026,16833,193,11798,118,4184,64.09
G3600610000300,STCTY-36061 HEALTH AREA-    0003.00  IN NEW YORK NY,29312,29062,250,17888,171,0,55.94
G3600610000400,STCTY-36061 HEALTH AREA-    0004.00  IN NEW YORK NY,34812,34672,140,21827,80,0,45.74
G3600610000500,STCTY-36061 HEALTH AREA-    0005.00  IN NEW YORK NY,30827,28499,2328,16796,2272,0,52.43
G3600610000610,STCTY-36061 HEALTH AREA-    0006.10  IN NEW YORK NY,17457,17368,89,10806,69,0,53.16
G3600610000620,STCTY-36061 HEALTH AREA-    0006.20  IN NEW YORK NY,20199,19964,235,12458,114,0,49.69
G3600610000710,STCTY-36061 HEALTH AREA-    0007.10  IN NEW YORK NY,15432,1712,13720,1168,13716,0,48.02
G3600610000720,STCTY-36061 HEALTH AREA-    0007.20  IN NEW YORK NY,22100,3032,19068,2205,19020,12209,43.67
G3600610000800,STCTY-36061 HEALTH AREA-    0008.00  IN NEW YORK NY,32314,68,32246,43,32232,0,38.26
G3600610000900,STCTY-36061 HEALTH AREA-    0009.00  IN NEW YORK NY,28894,23701,5193,14325,5062,8939,47.11
G3600610001000,STCTY-36061 HEALTH AREA-    0010.00  IN NEW YORK NY,28203,118,28085,89,28066,8690,43.72
G3600610001100,STCTY-36061 HEALTH AREA-    0011.00  IN NEW YORK NY,24192,17224,6968,11788,6841,0,35.98
G3600610001200,STCTY-36061 HEALTH AREA-    0012.00  IN NEW YORK NY,22590,90,22500,59,22472,8711,37.11
G3600610001300,STCTY-36061 HEALTH AREA-    0013.00  IN NEW YORK NY,25087,376,24711,220,24701,0,35.84
G3600610001400,STCTY-36061 HEALTH AREA-    0014.00  IN NEW YORK NY,18538,15851,2687,10927,2362,0,38.82
G3600610001500,STCTY-36061 HEALTH AREA-    0015.00  IN NEW YORK NY,23999,1415,22584,743,22523,0,35.91
G3600610001600,STCTY-36061 HEALTH AREA-    0016.00  IN NEW YORK NY,26166,13704,12462,8361,12437,10134,33.22
G3600610001700,STCTY-36061 HEALTH AREA-    0017.00  IN NEW YORK NY,19726,18924,802,13033,789,3917,26.48
G3600610001800,STCTY-36061 HEALTH AREA-    0018.00  IN NEW YORK NY,28538,15114,13424,12262,13305,0,53.08
G3600610001900,STCTY-36061 HEALTH AREA-    0019.00  IN NEW YORK NY,26436,1841,24595,1485,24490,0,37.95
G3600610002000,STCTY-36061 HEALTH AREA-    0020.00  IN NEW YORK NY,28833,15860,12973,12475,12874,0,31.53
G3600610002100,STCTY-36061 HEALTH AREA-    0021.00  IN NEW YORK NY,12251,12133,118,8400,96,0,25.02
G3600610002200,STCTY-36061 HEALTH AREA-    0022.00  IN NEW YORK NY,22308,22149,159,14903,128,6250,27.33
G3600610002310,STCTY-36061 HEALTH AREA-    0023.10  IN NEW YORK NY,24341,24013,328,16985,208,0,69.89
G3600610002320,STCTY-36061 HEALTH AREA-    0023.20  IN NEW YORK NY,15835,12397,3438,8111,3384,0,38.55
G3600610002400,STCTY-36061 HEALTH AREA-    0024.00  IN NEW YORK NY,24904,3665,21239,2970,21107,0,41.26
G3600610002500,STCTY-36061 HEALTH AREA-    0025.00  IN NEW YORK NY,26957,23709,3248,18405,3183,0,30.84
G3600610002600,STCTY-36061 HEALTH AREA-    0026.00  IN NEW YORK NY,15168,15029,139,9610,80,0,24.21
G3600610002710,STCTY-36061 HEALTH AREA-    0027.10  IN NEW YORK NY,10857,10764,93,7436,61,0,81.51
G3600610002720,STCTY-36061 HEALTH AREA-    0027.20  IN NEW YORK NY,28919,26381,2538,17444,2367,0,36.55
G3600610002800,STCTY-36061 HEALTH AREA-    0028.00  IN NEW YORK NY,23683,20837,2846,14653,2745,0,40.29
G3600610002900,STCTY-36061 HEALTH AREA-    0029.00  IN NEW YORK NY,23064,20863,2201,13920,2160,20000,33.74
G3600610003000,STCTY-36061 HEALTH AREA-    0030.00  IN NEW YORK NY,12770,9131,3639,6533,3558,0,23.12
G3600610003110,STCTY-36061 HEALTH AREA-    0031.10  IN NEW YORK NY,22830,22572,258,14424,187,0,75.17
G3600610003120,STCTY-36061 HEALTH AREA-    0031.20  IN NEW YORK NY,24127,23718,409,16872,359,0,89.97
G3600610003210,STCTY-36061 HEALTH AREA-    0032.10  IN NEW YORK NY,14537,14170,367,9156,328,0,40.41
G3600610003220,STCTY-36061 HEALTH AREA-    0032.20  IN NEW YORK NY,25655,25268,387,16550,259,17063,53.25
G3600610003300,STCTY-36061 HEALTH AREA-    0033.00  IN NEW YORK NY,19432,18364,1068,11032,1033,0,28.64
G3600610003400,STCTY-36061 HEALTH AREA-    0034.00  IN NEW YORK NY,30159,29637,522,21078,449,0,84.82
G3600610003500,STCTY-36061 HEALTH AREA-    0035.00  IN NEW YORK NY,32121,31734,387,20983,266,20000,69.66
G3600610003600,STCTY-36061 HEALTH AREA-    0036.00  IN NEW YORK NY,34314,33809,505,22389,441,20000,100
G3600610003700,STCTY-36061 HEALTH AREA-    0037.00  IN NEW YORK NY,22366,22269,97,12227,78,0,33.77
G3600610003800,STCTY-36061 HEALTH AREA-    0038.00  IN NEW YORK NY,23720,23653,67,15961,41,0,35.46
G3600610003900,STCTY-36061 HEALTH AREA-    0039.00  IN NEW YORK NY,22313,18774,3539,13199,3458,0,35.91
G3600610004000,STCTY-36061 HEALTH AREA-    0040.00  IN NEW YORK NY,31475,30994,481,21476,256,20000,68.63
G3600610004100,STCTY-36061 HEALTH AREA-    0041.00  IN NEW YORK NY,24817,24163,654,16503,574,20000,100
G3600610004200,STCTY-36061 HEALTH AREA-    0042.00  IN NEW YORK NY,23627,23521,106,14680,79,0,35.5
G3600610004300,STCTY-36061 HEALTH AREA-    0043.00  IN NEW YORK NY,19796,19767,29,12021,4,0,28.29
G3600610004400,STCTY-36061 HEALTH AREA-    0044.00  IN NEW YORK NY,15246,15203,43,9302,15,0,34.46
G3600610004500,STCTY-36061 HEALTH AREA-    0045.00  IN NEW YORK NY,7306,7248,58,5521,56,0,24.64
G3600610004600,STCTY-36061 HEALTH AREA-    0046.00  IN NEW YORK NY,15841,15165,676,10832,584,0,43.33
G3600610004700,STCTY-36061 HEALTH AREA-    0047.00  IN NEW YORK NY,34238,32346,1892,22756,1620,0,37.61
G3600610004800,STCTY-36061 HEALTH AREA-    0048.00  IN NEW YORK NY,27488,27246,242,19711,153,0,73.28
G3600610004900,STCTY-36061 HEALTH AREA-    0049.00  IN NEW YORK NY,21334,21145,189,13637,73,20000,43.71
G3600610005000,STCTY-36061 HEALTH AREA-    0050.00  IN NEW YORK NY,15365,15313,52,9787,19,0,40.88
G3600610005100,STCTY-36061 HEALTH AREA-    0051.00  IN NEW YORK NY,17148,16745,403,10380,258,0,30.01
G3600610005200,STCTY-36061 HEALTH AREA-    0052.00  IN NEW YORK NY,27710,27490,220,19585,103,0,46.38
G3600610005300,STCTY-36061 HEALTH AREA-    0053.00  IN NEW YORK NY,21103,20895,208,15342,81,20000,50.2
G3600610005400,STCTY-36061 HEALTH AREA-    0054.00  IN NEW YORK NY,16751,16682,69,12547,31,0,53.72
G3600610005500,STCTY-36061 HEALTH AREA-    0055.00  IN NEW YORK NY,18244,18010,234,12064,202,0,29.61
G3600610005600,STCTY-36061 HEALTH AREA-    0056.00  IN NEW YORK NY,27091,26819,272,19377,208,0,40.55
G3600610005700,STCTY-36061 HEALTH AREA-    0057.00  IN NEW YORK NY,25210,24970,240,18171,187,0,56.46
G3600610005800,STCTY-36061 HEALTH AREA-    0058.00  IN NEW YORK NY,21823,21656,167,14122,5,0,27.86
G3600610005900,STCTY-36061 HEALTH AREA-    0059.00  IN NEW YORK NY,18789,18523,266,12527,183,0,35.09
G3600610006000,STCTY-36061 HEALTH AREA-    0060.00  IN NEW YORK NY,16010,15626,384,10598,342,0,23.43
G3600610006100,STCTY-36061 HEALTH AREA-    0061.00  IN NEW YORK NY,16157,15773,384,12577,356,0,48.2
G3600610006200,STCTY-36061 HEALTH AREA-    0062.00  IN NEW YORK NY,25889,25657,232,14284,79,0,27.01
G3600610006300,STCTY-36061 HEALTH AREA-    0063.00  IN NEW YORK NY,11993,11937,56,6917,52,0,22.55
G3600610006400,STCTY-36061 HEALTH AREA-    0064.00  IN NEW YORK NY,21308,21230,78,15113,58,0,37.21
G3600610006500,STCTY-36061 HEALTH AREA-    0065.00  IN NEW YORK NY,14677,14592,85,7953,19,0,28.83
G3600610006600,STCTY-36061 HEALTH AREA-    0066.00  IN NEW YORK NY,13218,13185,33,7293,17,0,27.57
G3600610006700,STCTY-36061 HEALTH AREA-    0067.00  IN NEW YORK NY,20741,20645,96,11004,87,0,27.1
G3600610006800,STCTY-36061 HEALTH AREA-    0068.00  IN NEW YORK NY,10025,10011,14,6777,10,0,26.91
G3600610006900,STCTY-36061 HEALTH AREA-    0069.00  IN NEW YORK NY,18542,18175,367,11599,28,0,25.56
G3600610007000,STCTY-36061 HEALTH AREA-    0070.00  IN NEW YORK NY,10910,10806,104,6003,32,0,24.43
G3600610007100,STCTY-36061 HEALTH AREA-    0071.00  IN NEW YORK NY,13003,12896,107,6224,37,0,22.9
G3600610007200,STCTY-36061 HEALTH AREA-    0072.00  IN NEW YORK NY,12105,12048,57,5947,39,0,23.37
G3600610007300,STCTY-36061 HEALTH AREA-    0073.00  IN NEW YORK NY,9210,9171,39,4811,26,0,24.73
G3600610007400,STCTY-36061 HEALTH AREA-    0074.00  IN NEW YORK NY,10600,9675,925,4837,47,0,23.24
G3600610007500,STCTY-36061 HEALTH AREA-    0075.00  IN NEW YORK NY,16880,15348,1532,7678,377,0,23.71
G3600610007600,STCTY-36061 HEALTH AREA-    0076.00  IN NEW YORK NY,12981,12760,221,7096,204,0,23.72
G3600610007700,STCTY-36061 HEALTH AREA-    0077.00  IN NEW YORK NY,20401,14908,5493,8815,329,0,25.18
G3600610007800,STCTY-36061 HEALTH AREA-    0078.00  IN NEW YORK NY,18959,18296,663,12316,320,0,29
G3600610007900,STCTY-36061 HEALTH AREA-    0079.00  IN NEW YORK NY,11271,11173,98,5842,40,0,22.91
G3600610008000,STCTY-36061 HEALTH AREA-    0080.00  IN NEW YORK NY,10906,10601,305,5971,291,0,26.66
G3600610008100,STCTY-36061 HEALTH AREA-    0081.00  IN NEW YORK NY,4275,4229,46,4026,36,0,0
G3600610008200,STCTY-36061 HEALTH AREA-    0082.00  IN NEW YORK NY,736,718,18,496,11,0,0
G3600610008300,STCTY-36061 HEALTH AREA-    0083.00  IN NEW YORK NY,5846,5280,566,2919,534,0,0
G3600610008400,STCTY-36061 HEALTH AREA-    0084.00  IN NEW YORK NY,3836,3502,334,1596,308,0,0
G3600610CV008500,STCTY-36061 HEALTH AREA- CV 0085.00  IN NEW YORK NY,3305,3068,237,1838,117,0,0
G36006700001,STCTY-36067 TRACT-    0001     IN SYRACUSE NY,60,60,0,46,0,0,0
G36006700002,STCTY-36067 TRACT-    0002     IN SYRACUSE NY,5288,5285,3,4764,2,3940,31.07
G36006700003,STCTY-36067 TRACT-    0003     IN SYRACUSE NY,1928,1923,5,1743,1,4929,41.07
G36006700004,STCTY-36067 TRACT-    0004     IN SYRACUSE NY,4634,4634,0,4087,0,5103,43.69
G36006700005,STCTY-36067 TRACT-    0005     IN SYRACUSE NY,2623,2623,0,2051,0,2742,24.85
G36006700006,STCTY-36067 TRACT-    0006     IN SYRACUSE NY,4182,4182,0,3509,0,2778,32.1
G36006700007,STCTY-36067 TRACT-    0007     IN SYRACUSE NY,2103,2103,0,1681,0,4285,37.35
G36006700008,STCTY-36067 TRACT-    0008     IN SYRACUSE NY,3620,3620,0,3037,0,3887,36.35
G36006700009,STCTY-36067 TRACT-    0009     IN SYRACUSE NY,3518,3500,18,3238,17,10460,51.17
G36006700010,STCTY-36067 TRACT-    0010     IN SYRACUSE NY,3361,3361,0,2989,0,4795,38.15
G36006700011,STCTY-36067 TRACT-    0011     IN SYRACUSE NY,398,398,0,294,0,0,0
G36006700012,STCTY-36067 TRACT-    0012     IN SYRACUSE NY,970,970,0,750,0,0,26.08
G36006700013,STCTY-36067 TRACT-    0013     IN SYRACUSE NY,3202,3202,0,2246,0,2441,25.94
G36006700014,STCTY-36067 TRACT-    0014     IN SYRACUSE NY,4312,4312,0,3166,0,3095,32.69
G36006700015,STCTY-36067 TRACT-    0015     IN SYRACUSE NY,3391,3391,0,2807,0,3108,34.64
G36006700016,STCTY-36067 TRACT-    0016     IN SYRACUSE NY,2692,2684,8,2384,7,11429,34.5
G36006700017,STCTY-36067 TRACT-    0017     IN SYRACUSE NY,4593,4592,1,4147,0,6085,44.11
G36006700018,STCTY-36067 TRACT-    0018     IN SYRACUSE NY,3525,3525,0,3199,0,5480,44.27
G36006700019,STCTY-36067 TRACT-    0019     IN SYRACUSE NY,3694,3694,0,3418,0,6300,45.96
G36006700020,STCTY-36067 TRACT-    0020     IN SYRACUSE NY,4542,4542,0,3622,0,3232,28.98
G36006700021,STCTY-36067 TRACT-    0021     IN SYRACUSE NY,4267,4267,0,3175,0,2633,24.32
G36006700022,STCTY-36067 TRACT-    0022     IN SYRACUSE NY,3141,3141,0,2649,0,3591,29.02
G36006700023,STCTY-36067 TRACT-    0023     IN SYRACUSE NY,5010,5004,6,3822,2,3852,26.84
G36006700024,STCTY-36067 TRACT-    0024     IN SYRACUSE NY,4787,4771,16,3772,12,3164,30.35
G36006700025,STCTY-36067 TRACT-    0025     IN SYRACUSE NY,3558,3558,0,2769,0,3645,27.35
G36006700026,STCTY-36067 TRACT-    0026     IN SYRACUSE NY,929,928,1,795,0,0,35.43
G36006700027,STCTY-36067 TRACT-    0027     IN SYRACUSE NY,2907,2907,0,2475,0,4468,40.45
G36006700028,STCTY-36067 TRACT-    0028     IN SYRACUSE NY,3206,3206,0,2749,0,4759,41.6
G36006700029,STCTY-36067 TRACT-    0029     IN SYRACUSE NY,2081,2081,0,1744,0,3573,30.32
G36006700030,STCTY-36067 TRACT-    0030     IN SYRACUSE NY,5119,5065,54,4135,25,3457,23.85
G36006700031,STCTY-36067 TRACT-    0031     IN SYRACUSE NY,2583,2522,61,2223,54,0,27.73
G36006700032,STCTY-36067 TRACT-    0032     IN SYRACUSE NY,4784,3752,1032,3011,951,0,20.26
G36006700033,STCTY-36067 TRACT-    0033     IN SYRACUSE NY,4872,4467,405,3501,397,4438,30.47
G36006700034,STCTY-36067 TRACT-    0034     IN SYRACUSE NY,3734,3574,160,3078,160,4727,37.72
G36006700035,STCTY-36067 TRACT-    0035     IN SYRACUSE NY,4105,4100,5,3469,5,5622,44.03
G36006700036,STCTY-36067 TRACT-    0036     IN SYRACUSE NY,2632,2627,5,2349,5,7128,56.71
G36006700037,STCTY-36067 TRACT-    0037     IN SYRACUSE NY,1223,1162,61,1143,57,0,0
G36006700038,STCTY-36067 TRACT-    0038     IN SYRACUSE NY,4106,4106,0,3676,0,3862,35.72
G36006700039,STCTY-36067 TRACT-    0039     IN SYRACUSE NY,8131,8131,0,7393,0,4556,34.52
G36006700040,STCTY-36067 TRACT-    0040     IN SYRACUSE NY,5428,5416,12,4821,0,3543,29.45
G36006700041,STCTY-36067 TRACT-    0041     IN SYRACUSE NY,3285,3272,13,2945,0,3606,30.43
G36006700042,STCTY-36067 TRACT-    0042     IN SYRACUSE NY,5139,4764,375,3945,324,2978,24.02
G36006700043,STCTY-36067 TRACT-    0043     IN SYRACUSE NY,2000,1993,7,1575,6,0,41.75
G36006700044,STCTY-36067 TRACT-    0044     IN SYRACUSE NY,2895,2881,14,2680,14,9113,50.09
G36006700045,STCTY-36067 TRACT-    0045     IN SYRACUSE NY,5032,5030,2,4656,2,7546,52.85
G36006700046,STCTY-36067 TRACT-    0046     IN SYRACUSE NY,1147,1135,12,1025,7,12102,0
G36006700047,STCTY-36067 TRACT-    0047     IN SYRACUSE NY,1690,1683,7,1557,5,12668,0
G36006700048,STCTY-36067 TRACT-    0048     IN SYRACUSE NY,873,873,0,815,0,7400,0
G36006700049,STCTY-36067 TRACT-    0049     IN SYRACUSE NY,1805,1805,0,1634,0,5792,43.42
G36006700050,STCTY-36067 TRACT-    0050     IN SYRACUSE NY,3953,3950,3,3730,2,9653,51.92
G36006700051,STCTY-36067 TRACT-    0051     IN SYRACUSE NY,3661,3660,1,3348,0,5288,39.34
G36006700052,STCTY-36067 TRACT-    0052     IN SYRACUSE NY,5894,5892,2,5361,0,4558,36.17
G36006700053,STCTY-36067 TRACT-    0053     IN SYRACUSE NY,4947,4931,16,4497,15,5705,35.98
G36006700054,STCTY-36067 TRACT-    0054     IN SYRACUSE NY,5896,5893,3,5466,1,5038,39.54
G36006700055,STCTY-36067 TRACT-    0055     IN SYRACUSE NY,880,876,4,765,0,5417,37.36
G36006700056,STCTY-36067 TRACT-    0056     IN SYRACUSE NY,885,885,0,816,0,6804,56.25
G36006700057,STCTY-36067 TRACT-    0057     IN SYRACUSE NY,2219,2219,0,2041,0,5816,38.09
G36006700058,STCTY-36067 TRACT-    0058     IN SYRACUSE NY,3675,3675,0,3374,0,5108,41.5
G36006700059,STCTY-36067 TRACT-    0059     IN SYRACUSE NY,4108,4107,1,3756,1,4982,39.21
G36006700060,STCTY-36067 TRACT-    0060     IN SYRACUSE NY,2637,2631,6,2430,2,5105,38.02
G36006700061,STCTY-36067 TRACT-    0061     IN SYRACUSE NY,4107,4099,8,3747,8,6000,44.96
G3600810000110,STCTY-36081 HEALTH AREA-    0001.10  IN NEW YORK NY,21306,21289,17,13090,7,5454,44.19
G3600810000120,STCTY-36081 HEALTH AREA-    0001.20  IN NEW YORK NY,22571,22537,34,15948,19,5408,42.06
G3600810000210,STCTY-36081 HEALTH AREA-    0002.10  IN NEW YORK NY,14045,14029,16,11172,11,5116,37.06
G3600810000220,STCTY-36081 HEALTH AREA-    0002.20  IN NEW YORK NY,16086,16012,74,12914,68,6035,50.33
G3600810000300,STCTY-36081 HEALTH AREA-    0003.00  IN NEW YORK NY,28561,28528,33,20057,28,4703,40.95
G3600810000400,STCTY-36081 HEALTH AREA-    0004.00  IN NEW YORK NY,36958,36872,86,24596,25,5199,43.48
G3600810000500,STCTY-36081 HEALTH AREA-    0005.00  IN NEW YORK NY,34601,34587,14,26145,2,5071,40.96
G3600810000610,STCTY-36081 HEALTH AREA-    0006.10  IN NEW YORK NY,19907,17275,2632,12677,2622,5128,44.52
G3600810000620,STCTY-36081 HEALTH AREA-    0006.20  IN NEW YORK NY,20861,20821,40,15734,29,5661,51.32
G3600810000710,STCTY-36081 HEALTH AREA-    0007.10  IN NEW YORK NY,19120,18996,124,13113,102,5141,40.3
G3600810000720,STCTY-36081 HEALTH AREA-    0007.20  IN NEW YORK NY,22514,22121,393,16649,382,5140,23.14
G3600810000800,STCTY-36081 HEALTH AREA-    0008.00  IN NEW YORK NY,22894,22865,29,16729,21,4938,51.07
G3600810000910,STCTY-36081 HEALTH AREA-    0009.10  IN NEW YORK NY,21010,20960,50,15649,21,5994,47.43
G3600810000920,STCTY-36081 HEALTH AREA-    0009.20  IN NEW YORK NY,16540,16501,39,11956,37,5848,48.65
G3600810001010,STCTY-36081 HEALTH AREA-    0010.10  IN NEW YORK NY,27726,27626,100,22197,64,7424,59.01
G3600810001020,STCTY-36081 HEALTH AREA-    0010.20  IN NEW YORK NY,30087,30010,77,21845,43,5710,52.06
G3600810001100,STCTY-36081 HEALTH AREA-    0011.00  IN NEW YORK NY,29688,28085,1603,19130,1564,4616,43.04
G3600810001200,STCTY-36081 HEALTH AREA-    0012.00  IN NEW YORK NY,22055,20408,1647,16021,1612,5165,47.38
G3600810001310,STCTY-36081 HEALTH AREA-    0013.10  IN NEW YORK NY,22291,22138,153,18683,129,8266,55.39
G3600810001320,STCTY-36081 HEALTH AREA-    0013.20  IN NEW YORK NY,18376,18029,347,14772,296,6791,49.52
G3600810001410,STCTY-36081 HEALTH AREA-    0014.10  IN NEW YORK NY,10349,10328,21,7771,16,5267,46.59
G3600810001420,STCTY-36081 HEALTH AREA-    0014.20  IN NEW YORK NY,22330,22305,25,17214,11,5992,53.78
G3600810001500,STCTY-36081 HEALTH AREA-    0015.00  IN NEW YORK NY,16626,16480,146,11605,141,4260,35.87
G3600810001600,STCTY-36081 HEALTH AREA-    0016.00  IN NEW YORK NY,18996,18993,3,14676,1,3799,33.3
G3600810001700,STCTY-36081 HEALTH AREA-    0017.00  IN NEW YORK NY,31357,31345,12,24508,1,3659,39.31
G3600810001810,STCTY-36081 HEALTH AREA-    0018.10  IN NEW YORK NY,20865,20854,11,16376,8,5362,44.11
G3600810001821,STCTY-36081 HEALTH AREA-    0018.21  IN NEW YORK NY,15668,15656,12,11976,11,4994,40.59
G3600810001822,STCTY-36081 HEALTH AREA-    0018.22  IN NEW YORK NY,16093,16076,17,12741,14,5735,45.58
G3600810001910,STCTY-36081 HEALTH AREA-    0019.10  IN NEW YORK NY,21154,21009,145,16776,118,6633,62.12
G3600810001920,STCTY-36081 HEALTH AREA-    0019.20  IN NEW YORK NY,23023,22691,332,18406,248,11652,69.58
G3600810002000,STCTY-36081 HEALTH AREA-    0020.00  IN NEW YORK NY,18335,18074,261,14338,242,5594,51.09
G3600810002111,STCTY-36081 HEALTH AREA-    0021.11  IN NEW YORK NY,12972,12745,227,10663,181,5811,52.66
G3600810002112,STCTY-36081 HEALTH AREA-    0021.12  IN NEW YORK NY,16182,15714,468,12935,429,6254,52.64
G3600810002121,STCTY-36081 HEALTH AREA-    0021.21  IN NEW YORK NY,14129,13917,212,11664,197,7104,60.44
G3600810002122,STCTY-36081 HEALTH AREA-    0021.22  IN NEW YORK NY,18581,18388,193,14677,185,4822,51.85
G3600810002200,STCTY-36081 HEALTH AREA-    0022.00  IN NEW YORK NY,21848,21840,8,15884,6,3679,36.1
G3600810002300,STCTY-36081 HEALTH AREA-    0023.00  IN NEW YORK NY,23065,23059,6,16811,2,3678,36.64
G3600810002400,STCTY-36081 HEALTH AREA-    0024.00  IN NEW YORK NY,26613,26604,9,21795,1,4292,39.77
G3600810002500,STCTY-36081 HEALTH AREA-    0025.00  IN NEW YORK NY,25774,25753,21,21907,14,4904,45.37
G3600810002600,STCTY-36081 HEALTH AREA-    0026.00  IN NEW YORK NY,26100,25990,110,21726,54,6239,47.9
G3600810002700,STCTY-36081 HEALTH AREA-    0027.00  IN NEW YORK NY,32101,31999,102,25402,79,6082,50.09
G3600810002810,STCTY-36081 HEALTH AREA-    0028.10  IN NEW YORK NY,19262,19144,118,15713,96,7299,54.04
G3600810002820,STCTY-36081 HEALTH AREA-    0028.20  IN NEW YORK NY,18033,17972,61,15590,43,5836,49.52
G3600810002910,STCTY-36081 HEALTH AREA-    0029.10  IN NEW YORK NY,17130,17114,16,15131,11,5508,52.77
G3600810002920,STCTY-36081 HEALTH AREA-    0029.20  IN NEW YORK NY,19541,19509,32,16907,16,5440,52.61
G3600810003000,STCTY-36081 HEALTH AREA-    0030.00  IN NEW YORK NY,31949,31915,34,25382,12,4560,39.68
G3600810003100,STCTY-36081 HEALTH AREA-    0031.00  IN NEW YORK NY,31621,31507,114,25796,106,5098,43.85
G3600810003200,STCTY-36081 HEALTH AREA-    0032.00  IN NEW YORK NY,35017,34957,60,28707,51,4692,43.32
G3600810003300,STCTY-36081 HEALTH AREA-    0033.00  IN NEW YORK NY,25692,23737,1955,18155,1949,4187,39.85
G3600810003400,STCTY-36081 HEALTH AREA-    0034.00  IN NEW YORK NY,27569,19354,8215,15105,8202,4200,38
G3600810003510,STCTY-36081 HEALTH AREA-    0035.10  IN NEW YORK NY,18862,14986,3876,12444,3866,5666,43.93
G3600810003520,STCTY-36081 HEALTH AREA-    0035.20  IN NEW YORK NY,25086,25041,45,22094,22,5577,54.62
G3600810003531,STCTY-36081 HEALTH AREA-    0035.31  IN NEW YORK NY,21357,21255,102,17937,93,5232,52.19
G3600810003532,STCTY-36081 HEALTH AREA-    0035.32  IN NEW YORK NY,21528,21293,235,18291,235,4818,47.46
G3600810003611,STCTY-36081 HEALTH AREA-    0036.11  IN NEW YORK NY,17574,17556,18,14961,9,4383,38.73
G3600810003612,STCTY-36081 HEALTH AREA-    0036.12  IN NEW YORK NY,16867,16855,12,14149,2,3631,37.03
G3600810003620,STCTY-36081 HEALTH AREA-    0036.20  IN NEW YORK NY,10894,10880,14,9276,10,4096,41.72
G3600810003700,STCTY-36081 HEALTH AREA-    0037.00  IN NEW YORK NY,18509,17323,1186,13621,1182,8371,42.46
G3600810003800,STCTY-36081 HEALTH AREA-    0038.00  IN NEW YORK NY,20284,19329,955,14525,943,5956,46.53
G3600810003900,STCTY-36081 HEALTH AREA-    0039.00  IN NEW YORK NY,1501,1495,6,1431,1,0,0
G3600850000100,STCTY-36085 HEALTH AREA-    0001.00  IN NEW YORK NY,10710,10576,134,7738,128,4231,33.29
G3600850000200,STCTY-36085 HEALTH AREA-    0002.00  IN NEW YORK NY,19732,19300,432,15104,420,4241,38.25
G3600850000300,STCTY-36085 HEALTH AREA-    0003.00  IN NEW YORK NY,20342,19703,639,16119,639,5652,43.94
G3600850000400,STCTY-36085 HEALTH AREA-    0004.00  IN NEW YORK NY,27271,26534,737,20536,719,5890,43.09
G3600850000500,STCTY-36085 HEALTH AREA-    0005.00  IN NEW YORK NY,14315,13855,460,11068,434,5160,38.83
G3600850000600,STCTY-36085 HEALTH AREA-    0006.00  IN NEW YORK NY,20111,19362,749,15221,717,5397,46.11
G3600850000700,STCTY-36085 HEALTH AREA-    0007.00  IN NEW YORK NY,14959,14864,95,12340,54,4607,38.1
G3600850000800,STCTY-36085 HEALTH AREA-    0008.00  IN NEW YORK NY,16025,15771,254,13121,246,4396,35.57
G3600850000910,STCTY-36085 HEALTH AREA-    0009.10  IN NEW YORK NY,15950,15940,10,12398,2,4188,38.28
G3600850000920,STCTY-36085 HEALTH AREA-    0009.20  IN NEW YORK NY,13114,13080,34,10529,29,4979,45.19
G3600850001000,STCTY-36085 HEALTH AREA-    0010.00  IN NEW YORK NY,1912,1890,22,1580,9,0,36.47
G36011900001,STCTY-36119 TRACT-    0001     IN YONKERS NY,12202,12053,149,8975,147,3931,33.65
G36011900002,STCTY-36119 TRACT-    0002     IN YONKERS NY,11500,11280,220,8990,211,10219,49.53
G36011900003,STCTY-36119 TRACT-    0003     IN YONKERS NY,6859,5865,994,4020,988,2929,28.95
G36011900004,STCTY-36119 TRACT-    0004     IN YONKERS NY,9744,8715,1029,7121,1023,4560,39.84
G36011900005,STCTY-36119 TRACT-    0005     IN YONKERS NY,5789,5615,174,4203,172,2365,27.79
G36011900006,STCTY-36119 TRACT-    0006     IN YONKERS NY,5582,5506,76,4587,73,4966,37.95
G36011900007,STCTY-36119 TRACT-    0007     IN YONKERS NY,2694,2679,15,2274,15,10435,48.18
G36011900008,STCTY-36119 TRACT-    0008     IN YONKERS NY,7827,7808,19,6652,19,6467,45.34
G36011900009,STCTY-36119 TRACT-    0009     IN YONKERS NY,1152,1152,0,954,0,5478,41.89
G36011900010,STCTY-36119 TRACT-    0010     IN YONKERS NY,4585,4537,48,3127,48,2147,26.05
G36011900011,STCTY-36119 TRACT-    0011     IN YONKERS NY,10187,10102,85,7646,85,3311,34.2
G36011900012,STCTY-36119 TRACT-    0012     IN YONKERS NY,6121,6009,112,4119,112,2910,33.6
G36011900013,STCTY-36119 TRACT-    0013     IN YONKERS NY,11951,11870,81,9558,67,9287,51.21
G36011900014,STCTY-36119 TRACT-    0014     IN YONKERS NY,5959,5939,20,4899,20,8481,57.08
G36011900015,STCTY-36119 TRACT-    0015     IN YONKERS NY,7878,7844,34,6353,32,6500,49.2
G36011900016,STCTY-36119 TRACT-    0016     IN YONKERS NY,3661,3647,14,2771,13,4321,36.35
G36011900017,STCTY-36119 TRACT-    0017     IN YONKERS NY,4675,4662,13,3857,13,6936,49.19
G36011900018,STCTY-36119 TRACT-    0018     IN YONKERS NY,1015,279,736,209,736,0,39.29
G36011900019,STCTY-36119 TRACT-    0019     IN YONKERS NY,564,563,1,498,1,7873,0
G36011900020,STCTY-36119 TRACT-    0020     IN YONKERS NY,439,435,4,339,2,0,0
G36011900021,STCTY-36119 TRACT-    0021     IN YONKERS NY,4042,3943,99,3504,99,11922,92.06
G36011900022,STCTY-36119 TRACT-    0022     IN YONKERS NY,7112,6925,187,6149,185,13419,84.57
G36011900023,STCTY-36119 TRACT-    0023     IN YONKERS NY,2440,2413,27,1958,27,6680,40.86
G36011900024,STCTY-36119 TRACT-    0024     IN YONKERS NY,8620,8600,20,7021,20,5607,48.6
G3900350A0001,STCTY-39035 TRACT-  A 0001     IN CLEVELAND OH,7745,7730,15,6909,15,5926,47.51
G3900350A0002,STCTY-39035 TRACT-  A 0002     IN CLEVELAND OH,4251,4251,0,3367,0,3342,35.68
G3900350A0003,STCTY-39035 TRACT-  A 0003     IN CLEVELAND OH,2768,2767,1,2417,0,5203,40.01
G3900350A0004,STCTY-39035 TRACT-  A 0004     IN CLEVELAND OH,4162,4161,1,3304,1,4142,39.96
G3900350A0005,STCTY-39035 TRACT-  A 0005     IN CLEVELAND OH,4853,4852,1,3920,1,3729,36.87
G3900350A0006,STCTY-39035 TRACT-  A 0006     IN CLEVELAND OH,3938,3932,6,3333,0,3366,38.65
G3900350A0007,STCTY-39035 TRACT-  A 0007     IN CLEVELAND OH,4632,4631,1,3963,0,4025,34.96
G3900350A0008,STCTY-39035 TRACT-  A 0008     IN CLEVELAND OH,5694,5686,8,4665,8,2635,32.41
G3900350A0009,STCTY-39035 TRACT-  A 0009     IN CLEVELAND OH,3313,3313,0,2764,0,3599,31.52
G3900350B0001,STCTY-39035 TRACT-  B 0001     IN CLEVELAND OH,6985,6980,5,5537,4,4677,41.48
G3900350B0002,STCTY-39035 TRACT-  B 0002     IN CLEVELAND OH,3560,3560,0,2961,0,4633,43.58
G3900350B0003,STCTY-39035 TRACT-  B 0003     IN CLEVELAND OH,3332,3332,0,2796,0,4565,41.54
G3900350B0004,STCTY-39035 TRACT-  B 0004     IN CLEVELAND OH,8088,8088,0,6821,0,4045,38.67
G3900350B0005,STCTY-39035 TRACT-  B 0005     IN CLEVELAND OH,5536,5529,7,4583,6,3173,29.12
G3900350B0006,STCTY-39035 TRACT-  B 0006     IN CLEVELAND OH,5455,5454,1,4270,1,2494,26.53
G3900350B0007,STCTY-39035 TRACT-  B 0007     IN CLEVELAND OH,6698,6697,1,5258,1,2658,28.01
G3900350B0008,STCTY-39035 TRACT-  B 0008     IN CLEVELAND OH,3784,3783,1,2919,0,2500,28.12
G3900350B0009,STCTY-39035 TRACT-  B 0009     IN CLEVELAND OH,4254,4254,0,3032,0,2810,28.78
G3900350BD0001,STCTY-39035 TRACT- BD 0001     IN CLEVELAND OH ADJ AREA,2453,2448,5,2202,5,4493,37.68
G3900350BD0002,STCTY-39035 TRACT- BD 0002     IN CLEVELAND OH ADJ AREA,2188,2187,1,1885,1,4275,33.52
G3900350BD0003,STCTY-39035 TRACT- BD 0003     IN CLEVELAND OH ADJ AREA,2749,2749,0,2250,0,3097,30.84
G3900350BE0001,STCTY-39035 TRACT- BE 0001     IN CLEVELAND OH ADJ AREA,85,85,0,77,0,0,0
G3900350BE0002,STCTY-39035 TRACT- BE 0002     IN CLEVELAND OH ADJ AREA,3389,3354,35,3044,35,3850,37.83
G3900350BE0003,STCTY-39035 TRACT- BE 0003     IN CLEVELAND OH ADJ AREA,2551,2432,119,2268,119,4663,36.77
G3900350C0001,STCTY-39035 TRACT-  C 0001     IN CLEVELAND OH,3174,3174,0,2269,0,3556,28.36
G3900350C0002,STCTY-39035 TRACT-  C 0002     IN CLEVELAND OH,2387,2385,2,1918,1,0,21.41
G3900350C0003,STCTY-39035 TRACT-  C 0003     IN CLEVELAND OH,4251,4201,50,3634,50,0,25.01
G3900350C0004,STCTY-39035 TRACT-  C 0004     IN CLEVELAND OH,6903,6901,2,5716,0,3015,31.14
G3900350C0005,STCTY-39035 TRACT-  C 0005     IN CLEVELAND OH,6032,6032,0,4730,0,2638,25.73
G3900350C0006,STCTY-39035 TRACT-  C 0006     IN CLEVELAND OH,4995,4974,21,3887,21,3779,25.15
G3900350C0007,STCTY-39035 TRACT-  C 0007     IN CLEVELAND OH,2361,2263,98,1606,97,0,15.53
G3900350C0008,STCTY-39035 TRACT-  C 0008     IN CLEVELAND OH,6010,6007,3,4469,3,2625,25.83
G3900350C0009,STCTY-39035 TRACT-  C 0009     IN CLEVELAND OH,8082,8074,8,5962,1,2161,25.04
G3900350CC0001,STCTY-39035 TRACT- CC 0001     IN CLEVELAND OH ADJ AREA,3356,3349,7,3129,7,6843,46.55
G3900350CC0002,STCTY-39035 TRACT- CC 0002     IN CLEVELAND OH ADJ AREA,3200,3198,2,2839,1,3783,34.37
G3900350CC0003,STCTY-39035 TRACT- CC 0003     IN CLEVELAND OH ADJ AREA,1772,1771,1,1571,1,3156,37.67
G3900350CC0004,STCTY-39035 TRACT- CC 0004     IN CLEVELAND OH ADJ AREA,1715,1715,0,1558,0,5277,37.69
G3900350CC0005,STCTY-39035 TRACT- CC 0005     IN CLEVELAND OH ADJ AREA,1585,1585,0,1426,0,1971,0
G3900350CC0006,STCTY-39035 TRACT- CC 0006     IN CLEVELAND OH ADJ AREA,754,754,0,720,0,6060,0
G3900350CC0007,STCTY-39035 TRACT- CC 0007     IN CLEVELAND OH ADJ AREA,407,406,1,348,1,0,0
G3900350CC0008,STCTY-39035 TRACT- CC 0008     IN CLEVELAND OH ADJ AREA,4700,4699,1,4268,1,5572,43.82
G3900350CC0009,STCTY-39035 TRACT- CC 0009     IN CLEVELAND OH ADJ AREA,208,208,0,180,0,0,0
G3900350CC0010,STCTY-39035 TRACT- CC 0010     IN CLEVELAND OH ADJ AREA,76,74,2,67,2,0,0
G3900350CC0011,STCTY-39035 TRACT- CC 0011     IN CLEVELAND OH ADJ AREA,1122,1114,8,1004,8,4208,0
G3900350CC0012,STCTY-39035 TRACT- CC 0012     IN CLEVELAND OH ADJ AREA,1225,1207,18,1067,18,0,0
G3900350CC0013,STCTY-39035 TRACT- CC 0013     IN CLEVELAND OH ADJ AREA,1193,1193,0,1077,0,3477,0
G3900350CC0014,STCTY-39035 TRACT- CC 0014     IN CLEVELAND OH ADJ AREA,1023,1021,2,903,1,2750,0
G3900350CC0015,STCTY-39035 TRACT- CC 0015     IN CLEVELAND OH ADJ AREA,445,417,28,314,28,0,0
G3900350CC0016,STCTY-39035 TRACT- CC 0016     IN CLEVELAND OH ADJ AREA,1108,1108,0,965,0,3735,0
G3900350CC0017,STCTY-39035 TRACT- CC 0017     IN CLEVELAND OH ADJ AREA,1330,1330,0,1186,0,6800,0
G3900350CC0018,STCTY-39035 TRACT- CC 0018     IN CLEVELAND OH ADJ AREA,1581,1581,0,1361,0,3957,0
G3900350CC0019,STCTY-39035 TRACT- CC 0019     IN CLEVELAND OH ADJ AREA,978,978,0,864,0,3843,0
G3900350CC0020,STCTY-39035 TRACT- CC 0020     IN CLEVELAND OH ADJ AREA,1858,1858,0,1512,0,5039,35.56
G3900350CC0021,STCTY-39035 TRACT- CC 0021     IN CLEVELAND OH ADJ AREA,1972,1971,1,1603,1,2864,33.42
G3900350CC0022,STCTY-39035 TRACT- CC 0022     IN CLEVELAND OH ADJ AREA,674,674,0,533,0,0,0
G3900350CC0023,STCTY-39035 TRACT- CC 0023     IN CLEVELAND OH ADJ AREA,496,494,2,438,2,0,0
G3900350CC0024,STCTY-39035 TRACT- CC 0024     IN CLEVELAND OH ADJ AREA,555,555,0,467,0,0,0
G3900350CC0025,STCTY-39035 TRACT- CC 0025     IN CLEVELAND OH ADJ AREA,1815,1814,1,1598,1,4022,35.02
G3900350CC0026,STCTY-39035 TRACT- CC 0026     IN CLEVELAND OH ADJ AREA,1141,1141,0,984,0,4087,0
G3900350CC0027,STCTY-39035 TRACT- CC 0027     IN CLEVELAND OH ADJ AREA,1900,1875,25,1718,25,5542,33.83
G3900350CC0028,STCTY-39035 TRACT- CC 0028     IN CLEVELAND OH ADJ AREA,1350,1326,24,1046,22,13864,37.78
G3900350CC0029,STCTY-39035 TRACT- CC 0029     IN CLEVELAND OH ADJ AREA,753,747,6,671,6,2333,0
G3900350CC0030,STCTY-39035 TRACT- CC 0030     IN CLEVELAND OH ADJ AREA,507,505,2,424,2,0,0
G3900350CC0031,STCTY-39035 TRACT- CC 0031     IN CLEVELAND OH ADJ AREA,2391,2379,12,2054,12,6064,48.5
G3900350CC0032,STCTY-39035 TRACT- CC 0032     IN CLEVELAND OH ADJ AREA,3352,3347,5,2828,5,6313,52.27
G3900350CC0033,STCTY-39035 TRACT- CC 0033     IN CLEVELAND OH ADJ AREA,2794,2790,4,2445,4,7250,55.69
G3900350CC0034,STCTY-39035 TRACT- CC 0034     IN CLEVELAND OH ADJ AREA,5981,5930,51,5230,51,10120,81.93
G3900350CC0035,STCTY-39035 TRACT- CC 0035     IN CLEVELAND OH ADJ AREA,372,364,8,330,8,0,0
G3900350CC0037,STCTY-39035 TRACT- CC 0037     IN CLEVELAND OH ADJ AREA,1175,1168,7,969,7,4161,29.34
G3900350CC0038,STCTY-39035 TRACT- CC 0038     IN CLEVELAND OH ADJ AREA,92,91,1,82,1,0,0
G3900350CC0039,STCTY-39035 TRACT- CC 0039     IN CLEVELAND OH ADJ AREA,2291,1907,384,1256,381,0,0
G3900350CC0040,STCTY-39035 TRACT- CC 0040     IN CLEVELAND OH ADJ AREA,1070,979,91,828,91,2591,0
G3900350CC0041,STCTY-39035 TRACT- CC 0041     IN CLEVELAND OH ADJ AREA,1036,946,90,801,90,2514,0
G3900350CC0042,STCTY-39035 TRACT- CC 0042     IN CLEVELAND OH ADJ AREA,356,356,0,301,0,0,0
G3900350CC0043,STCTY-39035 TRACT- CC 0043     IN CLEVELAND OH ADJ AREA,448,441,7,396,7,0,0
G3900350CC0044,STCTY-39035 TRACT- CC 0044     IN CLEVELAND OH ADJ AREA,2696,2677,19,2297,17,4597,39.12
G3900350CC0045,STCTY-39035 TRACT- CC 0045     IN CLEVELAND OH ADJ AREA,906,872,34,739,34,0,0
G3900350CC0046,STCTY-39035 TRACT- CC 0046     IN CLEVELAND OH ADJ AREA,423,419,4,386,4,0,0
G3900350CC0047,STCTY-39035 TRACT- CC 0047     IN CLEVELAND OH ADJ AREA,336,327,9,260,9,0,0
G3900350CC0048,STCTY-39035 TRACT- CC 0048     IN CLEVELAND OH ADJ AREA,277,250,27,193,27,0,0
G3900350CC0049,STCTY-39035 TRACT- CC 0049     IN CLEVELAND OH ADJ AREA,492,485,7,384,7,0,0
G3900350CC0050,STCTY-39035 TRACT- CC 0050     IN CLEVELAND OH ADJ AREA,1508,1495,13,1310,13,4457,0
G3900350CC0051,STCTY-39035 TRACT- CC 0051     IN CLEVELAND OH ADJ AREA,218,218,0,197,0,0,0
G3900350CC0052,STCTY-39035 TRACT- CC 0052     IN CLEVELAND OH ADJ AREA,561,557,4,496,4,0,0
G3900350CC0053,STCTY-39035 TRACT- CC 0053     IN CLEVELAND OH ADJ AREA,117,116,1,105,1,0,0
G3900350CC0054,STCTY-39035 TRACT- CC 0054     IN CLEVELAND OH ADJ AREA,24,24,0,19,0,0,0
G3900350CC0055,STCTY-39035 TRACT- CC 0055     IN CLEVELAND OH ADJ AREA,395,395,0,371,0,0,0
G3900350CC0056,STCTY-39035 TRACT- CC 0056     IN CLEVELAND OH ADJ AREA,2110,2108,2,1945,2,3934,39.5
G3900350CH0001,STCTY-39035 TRACT- CH 0001     IN CLEVELAND OH ADJ AREA,640,638,2,546,2,6090,0
G3900350CH0002,STCTY-39035 TRACT- CH 0002     IN CLEVELAND OH ADJ AREA,398,394,4,303,4,0,0
G3900350CH0003,STCTY-39035 TRACT- CH 0003     IN CLEVELAND OH ADJ AREA,5339,5331,8,4788,8,7142,62.33
G3900350CH0004,STCTY-39035 TRACT- CH 0004     IN CLEVELAND OH ADJ AREA,3306,3302,4,2957,4,8134,68.23
G3900350CH0005,STCTY-39035 TRACT- CH 0005     IN CLEVELAND OH ADJ AREA,2987,2986,1,2670,1,7351,69.3
G3900350CH0006,STCTY-39035 TRACT- CH 0006     IN CLEVELAND OH ADJ AREA,2051,2040,11,1717,9,8158,68.09
G3900350CH0007,STCTY-39035 TRACT- CH 0007     IN CLEVELAND OH ADJ AREA,6596,6580,16,5454,7,7394,61.09
G3900350CH0008,STCTY-39035 TRACT- CH 0008     IN CLEVELAND OH ADJ AREA,1579,1563,16,1287,15,8588,67
G3900350CH0009,STCTY-39035 TRACT- CH 0009     IN CLEVELAND OH ADJ AREA,2213,2204,9,1855,8,8727,0
G3900350CH0010,STCTY-39035 TRACT- CH 0010     IN CLEVELAND OH ADJ AREA,2191,2168,23,1519,23,4688,52.92
G3900350CH0011,STCTY-39035 TRACT- CH 0011     IN CLEVELAND OH ADJ AREA,6230,6140,90,4834,90,8580,57.31
G3900350CH0012,STCTY-39035 TRACT- CH 0012     IN CLEVELAND OH ADJ AREA,4920,4818,102,4173,102,11703,68.09
G3900350CH0013,STCTY-39035 TRACT- CH 0013     IN CLEVELAND OH ADJ AREA,2933,2858,75,2521,73,13964,68.67
G3900350CH0014,STCTY-39035 TRACT- CH 0014     IN CLEVELAND OH ADJ AREA,3902,3809,93,3454,93,12749,92.54
G3900350CH0015,STCTY-39035 TRACT- CH 0015     IN CLEVELAND OH ADJ AREA,2724,2688,36,2356,33,9309,58.13
G3900350CH0016,STCTY-39035 TRACT- CH 0016     IN CLEVELAND OH ADJ AREA,5037,5020,17,4397,17,7856,68.58
G3900350CH0017,STCTY-39035 TRACT- CH 0017     IN CLEVELAND OH ADJ AREA,1946,1919,27,1693,22,8186,71.37
G3900350D0001,STCTY-39035 TRACT-  D 0001     IN CLEVELAND OH,4931,4931,0,3684,0,2580,22.83
G3900350D0002,STCTY-39035 TRACT-  D 0002     IN CLEVELAND OH,3572,3569,3,2442,3,0,21.52
G3900350D0003,STCTY-39035 TRACT-  D 0003     IN CLEVELAND OH,3352,3347,5,2260,1,2230,17.05
G3900350D0004,STCTY-39035 TRACT-  D 0004     IN CLEVELAND OH,4024,4024,0,3007,0,3203,28.49
G3900350D0005,STCTY-39035 TRACT-  D 0005     IN CLEVELAND OH,3867,3865,2,2693,1,2446,20.39
G3900350D0006,STCTY-39035 TRACT-  D 0006     IN CLEVELAND OH,2625,2624,1,2097,0,3125,30.28
G3900350D0007,STCTY-39035 TRACT-  D 0007     IN CLEVELAND OH,3830,3829,1,2765,0,2181,22.83
G3900350D0008,STCTY-39035 TRACT-  D 0008     IN CLEVELAND OH,4630,4622,8,3514,8,3264,29.35
G3900350D0009,STCTY-39035 TRACT-  D 0009     IN CLEVELAND OH,5888,5888,0,4675,0,3137,31.34
G3900350E0001,STCTY-39035 TRACT-  E 0001     IN CLEVELAND OH,4415,4415,0,3325,0,2975,31.72
G3900350E0002,STCTY-39035 TRACT-  E 0002     IN CLEVELAND OH,2081,2081,0,1600,0,3488,33.04
G3900350E0003,STCTY-39035 TRACT-  E 0003     IN CLEVELAND OH,5150,5147,3,3978,3,3233,33.16
G3900350E0004,STCTY-39035 TRACT-  E 0004     IN CLEVELAND OH,6087,6082,5,5170,5,3813,37.26
G3900350E0005,STCTY-39035 TRACT-  E 0005     IN CLEVELAND OH,3346,3345,1,2941,1,4121,35.77
G3900350E0006,STCTY-39035 TRACT-  E 0006     IN CLEVELAND OH,8204,8025,179,6575,178,3137,32.23
G3900350E0007,STCTY-39035 TRACT-  E 0007     IN CLEVELAND OH,3146,3146,0,2563,0,4352,38.79
G3900350E0008,STCTY-39035 TRACT-  E 0008     IN CLEVELAND OH,6452,6425,27,5251,27,4143,35.02
G3900350E0009,STCTY-39035 TRACT-  E 0009     IN CLEVELAND OH,3142,3142,0,2546,0,4435,41.76
G3900350EC0001,STCTY-39035 TRACT- EC 0001     IN CLEVELAND OH ADJ AREA,6063,6062,1,5247,1,4645,43.13
G3900350EC0002,STCTY-39035 TRACT- EC 0002     IN CLEVELAND OH ADJ AREA,3774,3751,23,3327,16,5333,44.98
G3900350EC0003,STCTY-39035 TRACT- EC 0003     IN CLEVELAND OH ADJ AREA,4187,4187,0,3647,0,4451,42.23
G3900350EC0004,STCTY-39035 TRACT- EC 0004     IN CLEVELAND OH ADJ AREA,4635,4634,1,3975,0,4359,40.3
G3900350EC0005,STCTY-39035 TRACT- EC 0005     IN CLEVELAND OH ADJ AREA,3438,3429,9,3126,8,11250,44.3
G3900350EC0006,STCTY-39035 TRACT- EC 0006     IN CLEVELAND OH ADJ AREA,2710,2695,15,2467,15,7413,46.21
G3900350EC0007,STCTY-39035 TRACT- EC 0007     IN CLEVELAND OH ADJ AREA,5937,5924,13,4958,13,5623,40.69
G3900350EC0008,STCTY-39035 TRACT- EC 0008     IN CLEVELAND OH ADJ AREA,2392,2390,2,2088,2,0,40.8
G3900350EC0009,STCTY-39035 TRACT- EC 0009     IN CLEVELAND OH ADJ AREA,1980,1979,1,1789,1,5500,44.5
G3900350EC0010,STCTY-39035 TRACT- EC 0010     IN CLEVELAND OH ADJ AREA,4379,4359,20,3429,18,5534,47.9
G3900350EU0001,STCTY-39035 TRACT- EU 0001     IN CLEVELAND OH ADJ AREA,5412,5387,25,4704,25,7852,54.21
G3900350EU0002,STCTY-39035 TRACT- EU 0002     IN CLEVELAND OH ADJ AREA,1461,1453,8,1266,6,4779,45.69
G3900350EU0003,STCTY-39035 TRACT- EU 0003     IN CLEVELAND OH ADJ AREA,1639,1621,18,1428,18,6237,46.75
G3900350EU0004,STCTY-39035 TRACT- EU 0004     IN CLEVELAND OH ADJ AREA,2492,2469,23,1936,23,5085,46.75
G3900350EU0005,STCTY-39035 TRACT- EU 0005     IN CLEVELAND OH ADJ AREA,3996,3986,10,2889,9,3975,34.81
G3900350EU0006,STCTY-39035 TRACT- EU 0006     IN CLEVELAND OH ADJ AREA,1340,1339,1,1138,1,5353,40.02
G3900350EU0007,STCTY-39035 TRACT- EU 0007     IN CLEVELAND OH ADJ AREA,1526,1523,3,1317,1,6384,45.62
G3900350F0001,STCTY-39035 TRACT-  F 0001     IN CLEVELAND OH,1958,1958,0,1628,0,6103,48.76
G3900350F0002,STCTY-39035 TRACT-  F 0002     IN CLEVELAND OH,3514,3514,0,2819,0,4619,42.93
G3900350F0003,STCTY-39035 TRACT-  F 0003     IN CLEVELAND OH,3889,3889,0,3187,0,4136,38.49
G3900350F0004,STCTY-39035 TRACT-  F 0004     IN CLEVELAND OH,1718,1718,0,1367,0,4270,35.92
G3900350F0005,STCTY-39035 TRACT-  F 0005     IN CLEVELAND OH,2664,2664,0,2093,0,4367,41.6
G3900350F0006,STCTY-39035 TRACT-  F 0006     IN CLEVELAND OH,4550,4550,0,3510,0,3709,39.27
G3900350F0007,STCTY-39035 TRACT-  F 0007     IN CLEVELAND OH,2311,2311,0,2007,0,6774,50.48
G3900350G0001,STCTY-39035 TRACT-  G 0001     IN CLEVELAND OH,606,593,13,431,12,0,0
G3900350G0002,STCTY-39035 TRACT-  G 0002     IN CLEVELAND OH,1335,1218,117,746,115,0,17.28
G3900350G0003,STCTY-39035 TRACT-  G 0003     IN CLEVELAND OH,1357,1200,157,890,64,0,19.85
G3900350G0004,STCTY-39035 TRACT-  G 0004     IN CLEVELAND OH,305,250,55,152,55,0,0
G3900350G0005,STCTY-39035 TRACT-  G 0005     IN CLEVELAND OH,2315,2241,74,1508,55,0,18.74
G3900350G0006,STCTY-39035 TRACT-  G 0006     IN CLEVELAND OH,1118,1114,4,897,2,0,36.92
G3900350G0007,STCTY-39035 TRACT-  G 0007     IN CLEVELAND OH,821,808,13,505,1,0,0
G3900350G0008,STCTY-39035 TRACT-  G 0008     IN CLEVELAND OH,3040,2937,103,2314,65,0,20.56
G3900350G0009,STCTY-39035 TRACT-  G 0009     IN CLEVELAND OH,4316,4138,178,3375,167,0,21.15
G3900350GH0001,STCTY-39035 TRACT- GH 0001     IN CLEVELAND OH ADJ AREA,2517,2515,2,2093,2,4634,41.66
G3900350GH0002,STCTY-39035 TRACT- GH 0002     IN CLEVELAND OH ADJ AREA,1880,1880,0,1546,0,5145,42.32
G3900350GH0003,STCTY-39035 TRACT- GH 0003     IN CLEVELAND OH ADJ AREA,1661,1660,1,1449,1,4964,46.6
G3900350GH0004,STCTY-39035 TRACT- GH 0004     IN CLEVELAND OH ADJ AREA,2371,2371,0,1942,0,4181,41.96
G3900350GH0005,STCTY-39035 TRACT- GH 0005     IN CLEVELAND OH ADJ AREA,2634,2631,3,2217,3,5063,41.17
G3900350GH0006,STCTY-39035 TRACT- GH 0006     IN CLEVELAND OH ADJ AREA,3140,3140,0,2663,0,5214,41.79
G3900350GH0007,STCTY-39035 TRACT- GH 0007     IN CLEVELAND OH ADJ AREA,2786,2727,59,2337,59,4867,51.61
G3900350H0001,STCTY-39035 TRACT-  H 0001     IN CLEVELAND OH,333,326,7,234,7,0,0
G3900350H0002,STCTY-39035 TRACT-  H 0002     IN CLEVELAND OH,2541,2541,0,1676,0,1889,20.8
G3900350H0003,STCTY-39035 TRACT-  H 0003     IN CLEVELAND OH,3850,3837,13,2731,3,2407,23.39
G3900350H0004,STCTY-39035 TRACT-  H 0004     IN CLEVELAND OH,4089,4085,4,2940,3,2182,22.85
G3900350H0005,STCTY-39035 TRACT-  H 0005     IN CLEVELAND OH,878,876,2,661,2,0,25.31
G3900350H0006,STCTY-39035 TRACT-  H 0006     IN CLEVELAND OH,2680,2669,11,2064,10,0,22.61
G3900350H0007,STCTY-39035 TRACT-  H 0007     IN CLEVELAND OH,3838,1683,2155,1476,2151,0,23.1
G3900350H0008,STCTY-39035 TRACT-  H 0008     IN CLEVELAND OH,5307,1820,3487,1548,3479,0,20.01
G3900350H0009,STCTY-39035 TRACT-  H 0009     IN CLEVELAND OH,5149,363,4786,262,4785,0,26.02
G3900350I0001,STCTY-39035 TRACT-  I 0001     IN CLEVELAND OH,21,19,2,7,2,0,0
G3900350I0002,STCTY-39035 TRACT-  I 0002     IN CLEVELAND OH,1744,1205,539,822,539,0,18.49
G3900350I0003,STCTY-39035 TRACT-  I 0003     IN CLEVELAND OH,5441,1491,3950,1108,3949,2170,20.79
G3900350I0004,STCTY-39035 TRACT-  I 0004     IN CLEVELAND OH,966,790,176,452,176,0,13.16
G3900350I0005,STCTY-39035 TRACT-  I 0005     IN CLEVELAND OH,2394,1793,601,1175,601,0,19.63
G3900350I0006,STCTY-39035 TRACT-  I 0006     IN CLEVELAND OH,2596,1121,1475,824,1474,0,22.16
G3900350I0007,STCTY-39035 TRACT-  I 0007     IN CLEVELAND OH,3109,512,2597,343,2597,0,26.75
G3900350I0008,STCTY-39035 TRACT-  I 0008     IN CLEVELAND OH,2398,173,2225,108,2225,0,23.39
G3900350I0009,STCTY-39035 TRACT-  I 0009     IN CLEVELAND OH,4514,550,3964,368,3964,0,25.97
G3900350J0001,STCTY-39035 TRACT-  J 0001     IN CLEVELAND OH,3,3,0,2,0,0,0
G3900350J0002,STCTY-39035 TRACT-  J 0002     IN CLEVELAND OH,1018,546,472,346,472,0,19.43
G3900350J0003,STCTY-39035 TRACT-  J 0003     IN CLEVELAND OH,695,289,406,183,406,0,22.15
G3900350J0004,STCTY-39035 TRACT-  J 0004     IN CLEVELAND OH,3379,3336,43,2501,39,1763,20.01
G3900350J0005,STCTY-39035 TRACT-  J 0005     IN CLEVELAND OH,2924,2921,3,2188,0,2203,23.68
G3900350J0006,STCTY-39035 TRACT-  J 0006     IN CLEVELAND OH,2971,2971,0,2269,0,2868,22.48
G3900350J0007,STCTY-39035 TRACT-  J 0007     IN CLEVELAND OH,2541,2487,54,2015,54,2792,26.29
G3900350J0008,STCTY-39035 TRACT-  J 0008     IN CLEVELAND OH,3788,3788,0,2840,0,2168,25.62
G3900350J0009,STCTY-39035 TRACT-  J 0009     IN CLEVELAND OH,4701,4701,0,3590,0,2676,24.73
G3900350K0001,STCTY-39035 TRACT-  K 0001     IN CLEVELAND OH,2413,2412,1,1670,1,0,23.07
G3900350K0002,STCTY-39035 TRACT-  K 0002     IN CLEVELAND OH,3921,3917,4,2745,2,2278,23.83
G3900350K0003,STCTY-39035 TRACT-  K 0003     IN CLEVELAND OH,2990,2987,3,2058,2,2440,22.96
G3900350K0004,STCTY-39035 TRACT-  K 0004     IN CLEVELAND OH,6550,6542,8,5022,3,3210,34.29
G3900350K0005,STCTY-39035 TRACT-  K 0005     IN CLEVELAND OH,3916,3916,0,2635,0,2570,25.28
G3900350K0006,STCTY-39035 TRACT-  K 0006     IN CLEVELAND OH,4105,4105,0,2838,0,2703,30.02
G3900350K0007,STCTY-39035 TRACT-  K 0007     IN CLEVELAND OH,5574,5571,3,4042,3,2419,29.77
G3900350K0008,STCTY-39035 TRACT-  K 0008     IN CLEVELAND OH,4399,4385,14,3311,13,3170,31.88
G3900350K0009,STCTY-39035 TRACT-  K 0009     IN CLEVELAND OH,6790,6668,122,4888,122,3402,28.57
G3900350L0001,STCTY-39035 TRACT-  L 0001     IN CLEVELAND OH,5712,5707,5,4398,5,3253,29.67
G3900350L0002,STCTY-39035 TRACT-  L 0002     IN CLEVELAND OH,6073,6060,13,5088,3,3556,34.46
G3900350L0003,STCTY-39035 TRACT-  L 0003     IN CLEVELAND OH,5542,5532,10,4647,6,3110,27
G3900350L0004,STCTY-39035 TRACT-  L 0004     IN CLEVELAND OH,9359,9211,148,7886,140,3077,30.31
G3900350L0005,STCTY-39035 TRACT-  L 0005     IN CLEVELAND OH,6059,6012,47,5198,45,3806,32.21
G3900350L0006,STCTY-39035 TRACT-  L 0006     IN CLEVELAND OH,4153,3829,324,3293,320,3672,36.1
G3900350L0007,STCTY-39035 TRACT-  L 0007     IN CLEVELAND OH,3795,3768,27,3287,11,0,17.91
G3900350L0008,STCTY-39035 TRACT-  L 0008     IN CLEVELAND OH,8139,8116,23,7231,23,4730,28.4
G3900350L0009,STCTY-39035 TRACT-  L 0009     IN CLEVELAND OH,6344,1040,5304,893,5301,0,26.69
G3900350LW0001,STCTY-39035 TRACT- LW 0001     IN CLEVELAND OH ADJ AREA,2666,2638,28,2454,26,13430,56.69
G3900350LW0002,STCTY-39035 TRACT- LW 0002     IN CLEVELAND OH ADJ AREA,2955,2950,5,2717,5,5924,47.96
G3900350LW0003,STCTY-39035 TRACT- LW 0003     IN CLEVELAND OH ADJ AREA,2740,2738,2,2526,2,6513,50.78
G3900350LW0004,STCTY-39035 TRACT- LW 0004     IN CLEVELAND OH ADJ AREA,5052,5042,10,4667,6,6442,53.57
G3900350LW0005,STCTY-39035 TRACT- LW 0005     IN CLEVELAND OH ADJ AREA,4049,4027,22,3696,18,9413,57.29
G3900350LW0006,STCTY-39035 TRACT- LW 0006     IN CLEVELAND OH ADJ AREA,5653,5638,15,5185,14,5473,53.29
G3900350LW0007,STCTY-39035 TRACT- LW 0007     IN CLEVELAND OH ADJ AREA,1328,1327,1,1212,1,5275,47.02
G3900350LW0008,STCTY-39035 TRACT- LW 0008     IN CLEVELAND OH ADJ AREA,1553,1551,2,1394,1,5424,45.52
G3900350LW0009,STCTY-39035 TRACT- LW 0009     IN CLEVELAND OH ADJ AREA,5497,5492,5,5023,5,7153,53.91
G3900350LW0010,STCTY-39035 TRACT- LW 0010     IN CLEVELAND OH ADJ AREA,2806,2805,1,2574,0,5762,49.5
G3900350LW0011,STCTY-39035 TRACT- LW 0011     IN CLEVELAND OH ADJ AREA,5435,5432,3,5016,2,6379,50.17
G3900350LW0012,STCTY-39035 TRACT- LW 0012     IN CLEVELAND OH ADJ AREA,4487,4483,4,4101,2,6388,48.47
G3900350LW0013,STCTY-39035 TRACT- LW 0013     IN CLEVELAND OH ADJ AREA,4195,4192,3,3793,3,6742,51.92
G3900350LW0014,STCTY-39035 TRACT- LW 0014     IN CLEVELAND OH ADJ AREA,4818,4818,0,4296,0,5855,49.33
G3900350LW0015,STCTY-39035 TRACT- LW 0015     IN CLEVELAND OH ADJ AREA,6340,6339,1,5257,1,5508,45.13
G3900350LW0016,STCTY-39035 TRACT- LW 0016     IN CLEVELAND OH ADJ AREA,3148,3139,9,2626,4,5108,40.82
G3900350LW0017,STCTY-39035 TRACT- LW 0017     IN CLEVELAND OH ADJ AREA,3313,3306,7,2653,0,3487,37.39
G3900350LW0018,STCTY-39035 TRACT- LW 0018     IN CLEVELAND OH ADJ AREA,3125,3124,1,2208,1,2085,19.79
G3900350M0001,STCTY-39035 TRACT-  M 0001     IN CLEVELAND OH,4952,3769,1183,3338,1178,0,30.24
G3900350M0002,STCTY-39035 TRACT-  M 0002     IN CLEVELAND OH,2979,2164,815,1848,804,0,36.72
G3900350M0003,STCTY-39035 TRACT-  M 0003     IN CLEVELAND OH,5798,357,5441,252,5429,3014,28.7
G3900350M0004,STCTY-39035 TRACT-  M 0004     IN CLEVELAND OH,4336,391,3945,291,3942,3035,27.53
G3900350M0005,STCTY-39035 TRACT-  M 0005     IN CLEVELAND OH,6428,1038,5390,755,5390,3099,29.9
G3900350M0006,STCTY-39035 TRACT-  M 0006     IN CLEVELAND OH,5620,517,5103,340,5102,2679,30.74
G3900350M0007,STCTY-39035 TRACT-  M 0007     IN CLEVELAND OH,4037,154,3883,119,3880,0,25.37
G3900350M0008,STCTY-39035 TRACT-  M 0008     IN CLEVELAND OH,6386,484,5902,338,5901,0,26.12
G3900350M0009,STCTY-39035 TRACT-  M 0009     IN CLEVELAND OH,1057,475,582,365,582,0,25.93
G3900350MH0001,STCTY-39035 TRACT- MH 0001     IN CLEVELAND OH ADJ AREA,4361,4358,3,3743,3,5057,41.98
G3900350MH0002,STCTY-39035 TRACT- MH 0002     IN CLEVELAND OH ADJ AREA,2367,2221,146,1887,145,3409,33
G3900350N0001,STCTY-39035 TRACT-  N 0001     IN CLEVELAND OH,4286,2382,1904,1695,1904,2023,26.36
G3900350N0002,STCTY-39035 TRACT-  N 0002     IN CLEVELAND OH,5514,1424,4090,1043,4090,2261,26.96
G3900350N0003,STCTY-39035 TRACT-  N 0003     IN CLEVELAND OH,3275,2286,989,1697,987,1892,21.4
G3900350N0004,STCTY-39035 TRACT-  N 0004     IN CLEVELAND OH,2182,2161,21,1482,20,0,22.55
G3900350N0005,STCTY-39035 TRACT-  N 0005     IN CLEVELAND OH,3005,2996,9,1983,9,2195,21.93
G3900350N0006,STCTY-39035 TRACT-  N 0006     IN CLEVELAND OH,4460,4453,7,3376,7,2469,27.35
G3900350N0007,STCTY-39035 TRACT-  N 0007     IN CLEVELAND OH,3642,1675,1967,1241,1967,2379,24.79
G3900350N0008,STCTY-39035 TRACT-  N 0008     IN CLEVELAND OH,5762,4849,913,3399,912,2020,21.5
G3900350N0009,STCTY-39035 TRACT-  N 0009     IN CLEVELAND OH,6452,6449,3,4898,0,2391,24.09
G3900350O0001,STCTY-39035 TRACT-  O 0001     IN CLEVELAND OH,3945,3943,2,2966,2,2212,23.98
G3900350O0002,STCTY-39035 TRACT-  O 0002     IN CLEVELAND OH,3146,3146,0,2404,0,3193,23.02
G3900350O0003,STCTY-39035 TRACT-  O 0003     IN CLEVELAND OH,4362,4359,3,3147,3,2542,23.74
G3900350O0004,STCTY-39035 TRACT-  O 0004     IN CLEVELAND OH,5683,5682,1,4325,1,2642,27.11
G3900350O0005,STCTY-39035 TRACT-  O 0005     IN CLEVELAND OH,2343,2343,0,1791,0,3129,29.47
G3900350O0006,STCTY-39035 TRACT-  O 0006     IN CLEVELAND OH,5353,5340,13,4300,12,3535,33.39
G3900350O0007,STCTY-39035 TRACT-  O 0007     IN CLEVELAND OH,3923,3923,0,3075,0,2671,27.92
G3900350O0008,STCTY-39035 TRACT-  O 0008     IN CLEVELAND OH,8694,8693,1,6950,0,3545,30.34
G3900350O0009,STCTY-39035 TRACT-  O 0009     IN CLEVELAND OH,8105,7924,181,5825,180,4349,35.48
G3900350P0001,STCTY-39035 TRACT-  P 0001     IN CLEVELAND OH,3059,3050,9,2421,9,3583,34.31
G3900350P0002,STCTY-39035 TRACT-  P 0002     IN CLEVELAND OH,3142,3133,9,2480,9,5135,37.68
G3900350P0003,STCTY-39035 TRACT-  P 0003     IN CLEVELAND OH,4852,4851,1,3967,1,4601,39.41
G3900350P0004,STCTY-39035 TRACT-  P 0004     IN CLEVELAND OH,7822,7636,186,5189,176,4345,36.72
G3900350P0005,STCTY-39035 TRACT-  P 0005     IN CLEVELAND OH,9873,9513,360,6056,359,4200,38.26
G3900350P0006,STCTY-39035 TRACT-  P 0006     IN CLEVELAND OH,8443,8425,18,5818,18,3907,42.02
G3900350P0007,STCTY-39035 TRACT-  P 0007     IN CLEVELAND OH,4390,4388,2,3570,1,4130,37.01
G3900350P0008,STCTY-39035 TRACT-  P 0008     IN CLEVELAND OH,8731,8727,4,6848,3,3782,41.25
G3900350P0009,STCTY-39035 TRACT-  P 0009     IN CLEVELAND OH,6265,6255,10,5311,3,3869,37.47
G3900350PR0001,STCTY-39035 TRACT- PR 0001     IN CLEVELAND OH ADJ AREA,3606,3606,0,3086,0,4962,47.56
G3900350PR0002,STCTY-39035 TRACT- PR 0002     IN CLEVELAND OH ADJ AREA,3130,3130,0,2614,0,4637,42.05
G3900350PR0003,STCTY-39035 TRACT- PR 0003     IN CLEVELAND OH ADJ AREA,2734,2734,0,2251,0,4972,44.5
G3900350PR0004,STCTY-39035 TRACT- PR 0004     IN CLEVELAND OH ADJ AREA,4377,4377,0,3828,0,5692,49.9
G3900350PR0005,STCTY-39035 TRACT- PR 0005     IN CLEVELAND OH ADJ AREA,1587,1586,1,1343,0,3775,31.1
G3900350PR0006,STCTY-39035 TRACT- PR 0006     IN CLEVELAND OH ADJ AREA,931,929,2,789,2,4400,0
G3900350Q0001,STCTY-39035 TRACT-  Q 0001     IN CLEVELAND OH,9748,9419,329,7349,329,3801,36.45
G3900350Q0002,STCTY-39035 TRACT-  Q 0002     IN CLEVELAND OH,6845,6837,8,5121,8,3262,33.1
G3900350Q0003,STCTY-39035 TRACT-  Q 0003     IN CLEVELAND OH,7577,7470,107,6208,104,3606,35.24
G3900350Q0004,STCTY-39035 TRACT-  Q 0004     IN CLEVELAND OH,4049,4040,9,2907,9,2744,30.7
G3900350Q0005,STCTY-39035 TRACT-  Q 0005     IN CLEVELAND OH,7006,6871,135,4763,135,2894,32.45
G3900350Q0006,STCTY-39035 TRACT-  Q 0006     IN CLEVELAND OH,5327,5326,1,4065,1,3933,37.65
G3900350Q0007,STCTY-39035 TRACT-  Q 0007     IN CLEVELAND OH,5670,5658,12,4469,12,5531,45.17
G3900350Q0008,STCTY-39035 TRACT-  Q 0008     IN CLEVELAND OH,3541,3541,0,2792,0,3932,38.23
G3900350Q0009,STCTY-39035 TRACT-  Q 0009     IN CLEVELAND OH,5241,5241,0,4540,0,4958,45.33
G3900350R0001,STCTY-39035 TRACT-  R 0001     IN CLEVELAND OH,4485,4385,100,2876,100,3523,41.34
G3900350R0002,STCTY-39035 TRACT-  R 0002     IN CLEVELAND OH,6229,5962,267,4262,264,4305,37.46
G3900350R0003,STCTY-39035 TRACT-  R 0003     IN CLEVELAND OH,6042,6022,20,5001,19,4634,43.67
G3900350R0004,STCTY-39035 TRACT-  R 0004     IN CLEVELAND OH,4184,4179,5,3293,5,4796,41.36
G3900350R0005,STCTY-39035 TRACT-  R 0005     IN CLEVELAND OH,4251,4042,209,3248,202,3292,34.83
G3900350R0006,STCTY-39035 TRACT-  R 0006     IN CLEVELAND OH,6015,5980,35,4984,35,4271,42.3
G3900350R0007,STCTY-39035 TRACT-  R 0007     IN CLEVELAND OH,4080,4030,50,3347,44,12927,51.33
G3900350R0008,STCTY-39035 TRACT-  R 0008     IN CLEVELAND OH,5925,5906,19,4147,19,2440,27.8
G3900350R0009,STCTY-39035 TRACT-  R 0009     IN CLEVELAND OH,9953,9924,29,8707,24,5586,39.54
G3900350RR0001,STCTY-39035 TRACT- RR 0001     IN CLEVELAND OH ADJ AREA,4571,4547,24,4241,21,12180,47.64
G3900350RR0002,STCTY-39035 TRACT- RR 0002     IN CLEVELAND OH ADJ AREA,3720,3718,2,3324,2,7140,51.88
G3900350S0001,STCTY-39035 TRACT-  S 0001     IN CLEVELAND OH,3817,3398,419,2749,419,0,37.69
G3900350S0002,STCTY-39035 TRACT-  S 0002     IN CLEVELAND OH,3399,2689,710,1988,709,3213,34.15
G3900350S0003,STCTY-39035 TRACT-  S 0003     IN CLEVELAND OH,6731,6683,48,4654,48,2679,33.76
G3900350S0004,STCTY-39035 TRACT-  S 0004     IN CLEVELAND OH,7869,7833,36,5393,36,3868,36.43
G3900350S0005,STCTY-39035 TRACT-  S 0005     IN CLEVELAND OH,4320,4274,46,3501,43,4859,60.15
G3900350S0006,STCTY-39035 TRACT-  S 0006     IN CLEVELAND OH,6326,6325,1,4376,0,2993,36.76
G3900350S0007,STCTY-39035 TRACT-  S 0007     IN CLEVELAND OH,7348,7156,192,4862,192,3352,37.43
G3900350S0008,STCTY-39035 TRACT-  S 0008     IN CLEVELAND OH,9137,6759,2378,4441,2368,3781,37.69
G3900350S0009,STCTY-39035 TRACT-  S 0009     IN CLEVELAND OH,4462,4448,14,2987,14,3860,42.56
G3900350SH0001,STCTY-39035 TRACT- SH 0001     IN CLEVELAND OH ADJ AREA,2011,1931,80,1703,79,18333,72.89
G3900350SH0002,STCTY-39035 TRACT- SH 0002     IN CLEVELAND OH ADJ AREA,2744,2599,145,2368,145,20000,0
G3900350SH0003,STCTY-39035 TRACT- SH 0003     IN CLEVELAND OH ADJ AREA,1802,1716,86,1611,86,20000,0
G3900350SH0004,STCTY-39035 TRACT- SH 0004     IN CLEVELAND OH ADJ AREA,4036,3958,78,3574,78,13339,80.67
G3900350SH0005,STCTY-39035 TRACT- SH 0005     IN CLEVELAND OH ADJ AREA,4725,4572,153,4204,149,14113,82.42
G3900350SH0006,STCTY-39035 TRACT- SH 0006     IN CLEVELAND OH ADJ AREA,8075,8030,45,7137,45,8756,70.25
G3900350T0001,STCTY-39035 TRACT-  T 0001     IN CLEVELAND OH,2273,1925,348,1525,340,3430,28.06
G3900350T0002,STCTY-39035 TRACT-  T 0002     IN CLEVELAND OH,5935,5935,0,4449,0,3084,33.98
G3900350T0003,STCTY-39035 TRACT-  T 0003     IN CLEVELAND OH,2488,2484,4,1940,4,2821,24.63
G3900350T0004,STCTY-39035 TRACT-  T 0004     IN CLEVELAND OH,6231,6208,23,4912,22,3018,32.45
G3900350T0005,STCTY-39035 TRACT-  T 0005     IN CLEVELAND OH,5702,5693,9,4412,9,3981,37.13
G3900350T0006,STCTY-39035 TRACT-  T 0006     IN CLEVELAND OH,8242,8219,23,5771,23,3684,36.54
G3900350T0007,STCTY-39035 TRACT-  T 0007     IN CLEVELAND OH,8732,8607,125,5923,125,3901,37.32
G3900350T0008,STCTY-39035 TRACT-  T 0008     IN CLEVELAND OH,9986,9147,839,5959,839,3820,42.33
G3900350T0009,STCTY-39035 TRACT-  T 0009     IN CLEVELAND OH,4041,4041,0,3000,0,3823,35.73
G3900350U0001,STCTY-39035 TRACT-  U 0001     IN CLEVELAND OH,4341,4297,44,3220,44,4398,42.72
G3900350U0002,STCTY-39035 TRACT-  U 0002     IN CLEVELAND OH,3899,3871,28,2951,28,3273,37.48
G3900350U0003,STCTY-39035 TRACT-  U 0003     IN CLEVELAND OH,2914,2900,14,2549,14,4500,39.93
G3900350U0004,STCTY-39035 TRACT-  U 0004     IN CLEVELAND OH,7011,6979,32,5731,32,4663,40.58
G3900350U0005,STCTY-39035 TRACT-  U 0005     IN CLEVELAND OH,3351,3348,3,2538,3,4178,38.41
G3900350U0006,STCTY-39035 TRACT-  U 0006     IN CLEVELAND OH,621,621,0,527,0,0,0
G3900350U0007,STCTY-39035 TRACT-  U 0007     IN CLEVELAND OH,1004,1001,3,863,3,7356,0
G3900350U0008,STCTY-39035 TRACT-  U 0008     IN CLEVELAND OH,17,17,0,15,0,0,0
G3900350U0009,STCTY-39035 TRACT-  U 0009     IN CLEVELAND OH,648,648,0,524,0,4115,0
G3900350V0001,STCTY-39035 TRACT-  V 0001     IN CLEVELAND OH,176,173,3,145,3,0,0
G3900350V0002,STCTY-39035 TRACT-  V 0002     IN CLEVELAND OH,1245,543,702,426,702,1948,0
G3900350V0003,STCTY-39035 TRACT-  V 0003     IN CLEVELAND OH,594,589,5,466,5,2778,0
G3900350W0001,STCTY-39035 TRACT-  W 0001     IN CLEVELAND OH,1803,1801,2,1644,2,8463,59.5
G3900350W0002,STCTY-39035 TRACT-  W 0002     IN CLEVELAND OH,1183,1183,0,1006,0,6265,0
G3900350W0003,STCTY-39035 TRACT-  W 0003     IN CLEVELAND OH,1021,1021,0,798,0,3500,27.32
G3900350W0004,STCTY-39035 TRACT-  W 0004     IN CLEVELAND OH,4147,4146,1,3766,0,7662,51.05
G3900350W0005,STCTY-39035 TRACT-  W 0005     IN CLEVELAND OH,6138,6135,3,5082,3,5053,44.56
G3900350W0006,STCTY-39035 TRACT-  W 0006     IN CLEVELAND OH,6928,6928,0,6215,0,6521,49.47
G3900350W0007,STCTY-39035 TRACT-  W 0007     IN CLEVELAND OH,885,883,2,761,2,5186,0
G3900350W0008,STCTY-39035 TRACT-  W 0008     IN CLEVELAND OH,537,537,0,476,0,6574,0
G3900350W0009,STCTY-39035 TRACT-  W 0009     IN CLEVELAND OH,4318,4318,0,3481,0,5104,45.5
G3900350X0001,STCTY-39035 TRACT-  X 0001     IN CLEVELAND OH,5677,5677,0,4691,0,5339,47.11
G3900350X0002,STCTY-39035 TRACT-  X 0002     IN CLEVELAND OH,1301,1296,5,1070,5,4515,40.26
G3900350X0003,STCTY-39035 TRACT-  X 0003     IN CLEVELAND OH,1204,1204,0,996,0,4811,0
G3900350X0004,STCTY-39035 TRACT-  X 0004     IN CLEVELAND OH,1123,792,331,591,331,7543,0
G3900350X0005,STCTY-39035 TRACT-  X 0005     IN CLEVELAND OH,824,824,0,643,0,3720,0
G3900350X0006,STCTY-39035 TRACT-  X 0006     IN CLEVELAND OH,2279,2244,35,1746,34,3062,29.93
G3900350Z0001,STCTY-39035 TRACT-  Z 0001     IN CLEVELAND OH,134,134,0,110,0,0,0
G39004900001,STCTY-39049 TRACT-    0001     IN COLUMBUS OH,2618,2611,7,2547,7,7147,54.3
G39004900002,STCTY-39049 TRACT-    0002     IN COLUMBUS OH,6308,6304,4,6167,4,7442,64.46
G39004900003,STCTY-39049 TRACT-    0003     IN COLUMBUS OH,840,840,0,824,0,2750,0
G39004900004,STCTY-39049 TRACT-    0004     IN COLUMBUS OH,7162,7147,15,6943,6,6167,47.27
G39004900005,STCTY-39049 TRACT-    0005     IN COLUMBUS OH,3785,3777,8,3686,4,5703,45.92
G39004900006,STCTY-39049 TRACT-    0006     IN COLUMBUS OH,5287,5271,16,5158,12,4521,36.58
G39004900007,STCTY-39049 TRACT-    0007     IN COLUMBUS OH,5187,5180,7,5040,2,3534,34.01
G39004900008,STCTY-39049 TRACT-    0008     IN COLUMBUS OH,2884,2884,0,2808,0,3430,33.76
G39004900009,STCTY-39049 TRACT-    0009     IN COLUMBUS OH,5481,5481,0,5355,0,4022,35.57
G39004900010,STCTY-39049 TRACT-    0010     IN COLUMBUS OH,6372,6360,12,6220,11,4404,40.1
G39004900011,STCTY-39049 TRACT-    0011     IN COLUMBUS OH,3432,3377,55,3288,48,4164,37.14
G39004900012,STCTY-39049 TRACT-    0012     IN COLUMBUS OH,2795,2792,3,2735,2,7430,44.59
G39004900013,STCTY-39049 TRACT-    0013     IN COLUMBUS OH,3644,3637,7,3567,5,6500,43.83
G39004900014,STCTY-39049 TRACT-    0014     IN COLUMBUS OH,3845,3541,304,3337,304,3547,30.33
G39004900015,STCTY-39049 TRACT-    0015     IN COLUMBUS OH,2753,2413,340,2245,340,3058,32.56
G39004900016,STCTY-39049 TRACT-    0016     IN COLUMBUS OH,3557,2935,622,2874,621,3698,34.75
G39004900017,STCTY-39049 TRACT-    0017     IN COLUMBUS OH,4169,3966,203,3896,202,3293,29.11
G39004900018,STCTY-39049 TRACT-    0018     IN COLUMBUS OH,8746,8702,44,8485,14,5159,34.69
G39004900019,STCTY-39049 TRACT-    0019     IN COLUMBUS OH,3852,3678,174,3399,174,4217,47.39
G39004900020,STCTY-39049 TRACT-    0020     IN COLUMBUS OH,7158,7124,34,6889,32,3107,28.2
G39004900021,STCTY-39049 TRACT-    0021     IN COLUMBUS OH,3636,3614,22,3537,11,4280,27.76
G39004900022,STCTY-39049 TRACT-    0022     IN COLUMBUS OH,4233,3816,417,3686,413,2250,24.16
G39004900023,STCTY-39049 TRACT-    0023     IN COLUMBUS OH,4755,4208,547,3651,545,2537,27.07
G39004900024,STCTY-39049 TRACT-    0024     IN COLUMBUS OH,1161,452,709,433,709,0,21.94
G39004900025,STCTY-39049 TRACT-    0025     IN COLUMBUS OH,3979,3742,237,3649,237,5656,42.22
G39004900026,STCTY-39049 TRACT-    0026     IN COLUMBUS OH,2105,2061,44,1922,44,2674,26.66
G39004900027,STCTY-39049 TRACT-    0027     IN COLUMBUS OH,1634,1608,26,1554,26,6836,55.68
G39004900028,STCTY-39049 TRACT-    0028     IN COLUMBUS OH,5422,1179,4243,1079,4241,3237,32.77
G39004900029,STCTY-39049 TRACT-    0029     IN COLUMBUS OH,6704,981,5723,775,5722,2195,26.34
G39004900030,STCTY-39049 TRACT-    0030     IN COLUMBUS OH,4720,2677,2043,2567,2043,2881,25.67
G39004900031,STCTY-39049 TRACT-    0031     IN COLUMBUS OH,2568,2402,166,2286,164,0,22.46
G39004900032,STCTY-39049 TRACT-    0032     IN COLUMBUS OH,4626,2607,2019,2336,2019,2393,21.93
G39004900033,STCTY-39049 TRACT-    0033     IN COLUMBUS OH,3649,2592,1057,2395,1055,0,0
G39004900034,STCTY-39049 TRACT-    0034     IN COLUMBUS OH,1983,1505,478,1408,478,0,16.66
G39004900035,STCTY-39049 TRACT-    0035     IN COLUMBUS OH,6453,2285,4168,2158,4149,3260,25.33
G39004900036,STCTY-39049 TRACT-    0036     IN COLUMBUS OH,6156,775,5381,736,5379,3037,30.08
G39004900037,STCTY-39049 TRACT-    0037     IN COLUMBUS OH,7367,7290,77,6991,77,5757,40.57
G39004900038,STCTY-39049 TRACT-    0038     IN COLUMBUS OH,4657,4450,207,4253,207,4732,37.3
G39004900039,STCTY-39049 TRACT-    0039     IN COLUMBUS OH,8666,6320,2346,5969,2344,3283,20.92
G39004900040,STCTY-39049 TRACT-    0040     IN COLUMBUS OH,6811,6656,155,6481,138,0,19.62
G39004900041,STCTY-39049 TRACT-    0041     IN COLUMBUS OH,5180,5016,164,4908,164,2348,26
G39004900042,STCTY-39049 TRACT-    0042     IN COLUMBUS OH,4069,4004,65,3879,62,2220,23.66
G39004900043,STCTY-39049 TRACT-    0043     IN COLUMBUS OH,6275,6081,194,5907,194,2698,27.5
G39004900044,STCTY-39049 TRACT-    0044     IN COLUMBUS OH,5206,4873,333,4561,332,0,0
G39004900045,STCTY-39049 TRACT-    0045     IN COLUMBUS OH,5961,5958,3,5858,3,4594,39.29
G39004900046,STCTY-39049 TRACT-    0046     IN COLUMBUS OH,5131,5108,23,4999,23,5436,40.57
G39004900047,STCTY-39049 TRACT-    0047     IN COLUMBUS OH,7541,6459,1082,6324,1081,3788,34.14
G39004900048,STCTY-39049 TRACT-    0048     IN COLUMBUS OH,4952,4940,12,4801,12,4616,39.13
G39004900049,STCTY-39049 TRACT-    0049     IN COLUMBUS OH,4612,4582,30,4459,30,4425,37.07
G39004900050,STCTY-39049 TRACT-    0050     IN COLUMBUS OH,5523,5476,47,5367,47,2983,29.79
G39004900051,STCTY-39049 TRACT-    0051     IN COLUMBUS OH,2082,2082,0,2028,0,3029,29.96
G39004900052,STCTY-39049 TRACT-    0052     IN COLUMBUS OH,6105,5973,132,5550,131,2134,21.61
G39004900053,STCTY-39049 TRACT-    0053     IN COLUMBUS OH,9972,9254,718,8599,716,4035,30.6
G39004900054,STCTY-39049 TRACT-    0054     IN COLUMBUS OH,7510,7265,245,6943,245,5021,38.43
G39004900055,STCTY-39049 TRACT-    0055     IN COLUMBUS OH,6310,6308,2,5854,2,4971,40.68
G39004900056,STCTY-39049 TRACT-    0056     IN COLUMBUS OH,7789,7599,190,6978,190,3324,33.63
G39004900057,STCTY-39049 TRACT-    0057     IN COLUMBUS OH,7024,6994,30,6493,30,3033,26.13
G39004900058,STCTY-39049 TRACT-    0058     IN COLUMBUS OH,9734,9712,22,9212,22,3836,32.76
G39004900059,STCTY-39049 TRACT-    0059     IN COLUMBUS OH,3369,3368,1,3152,1,5125,43.05
G39004900060,STCTY-39049 TRACT-    0060     IN COLUMBUS OH,2602,2602,0,2464,0,3777,31.1
G39004900061,STCTY-39049 TRACT-    0061     IN COLUMBUS OH,7980,7289,691,6591,691,2892,24.85
G39006100001,STCTY-39061 TRACT-    0001     IN CINCINNATI OH,6485,1775,4710,1686,4710,0,15.39
G39006100002,STCTY-39061 TRACT-    0002     IN CINCINNATI OH,8002,3890,4112,3701,4102,2656,16.77
G39006100003,STCTY-39061 TRACT-    0003     IN CINCINNATI OH,8136,3093,5043,2915,5042,0,18.8
G39006100004,STCTY-39061 TRACT-    0004     IN CINCINNATI OH,8279,755,7524,684,7524,0,19.44
G39006100005,STCTY-39061 TRACT-    0005     IN CINCINNATI OH,12064,787,11277,720,11268,0,14.02
G39006100006,STCTY-39061 TRACT-    0006     IN CINCINNATI OH,4927,4710,217,4441,205,0,16.01
G39006100007,STCTY-39061 TRACT-    0007     IN CINCINNATI OH,6540,5913,627,5498,584,0,12.32
G39006100008,STCTY-39061 TRACT-    0008     IN CINCINNATI OH,4476,1630,2846,1530,2845,0,14.49
G39006100009,STCTY-39061 TRACT-    0009     IN CINCINNATI OH,6563,6480,83,6027,75,0,15.82
G39006100010,STCTY-39061 TRACT-    0010     IN CINCINNATI OH,5310,5305,5,5022,2,0,15.38
G39006100011,STCTY-39061 TRACT-    0011     IN CINCINNATI OH,5076,5039,37,4803,37,0,14.1
G39006100012,STCTY-39061 TRACT-    0012     IN CINCINNATI OH,3693,3006,687,2922,687,2046,15.61
G39006100013,STCTY-39061 TRACT-    0013     IN CINCINNATI OH,3614,3468,146,3365,146,2443,20.47
G39006100014,STCTY-39061 TRACT-    0014     IN CINCINNATI OH,6201,5975,226,5774,225,2696,14.41
G39006100015,STCTY-39061 TRACT-    0015     IN CINCINNATI OH,8720,7066,1654,6592,1653,2293,15.78
G39006100016,STCTY-39061 TRACT-    0016     IN CINCINNATI OH,7108,7024,84,6310,84,0,14.43
G39006100017,STCTY-39061 TRACT-    0017     IN CINCINNATI OH,5266,5165,101,4807,98,2278,16.8
G39006100018,STCTY-39061 TRACT-    0018     IN CINCINNATI OH,4593,4567,26,4208,24,3206,23.41
G39006100019,STCTY-39061 TRACT-    0019     IN CINCINNATI OH,3737,3727,10,3532,8,4660,25.83
G39006100020,STCTY-39061 TRACT-    0020     IN CINCINNATI OH,2483,2454,29,2301,20,7250,41.19
G39006100021,STCTY-39061 TRACT-    0021     IN CINCINNATI OH,4859,4377,482,3850,481,2731,22.3
G39006100022,STCTY-39061 TRACT-    0022     IN CINCINNATI OH,3387,3383,4,3136,4,5972,37.21
G39006100023,STCTY-39061 TRACT-    0023     IN CINCINNATI OH,3595,3586,9,3370,9,3483,26.43
G39006100024,STCTY-39061 TRACT-    0024     IN CINCINNATI OH,2689,2386,303,2254,303,2443,18.49
G39006100025,STCTY-39061 TRACT-    0025     IN CINCINNATI OH,4101,4101,0,3743,0,3672,25.93
G39006100026,STCTY-39061 TRACT-    0026     IN CINCINNATI OH,6715,6711,4,6090,2,3205,23.75
G39006100027,STCTY-39061 TRACT-    0027     IN CINCINNATI OH,4541,4541,0,4206,0,2859,20.56
G39006100028,STCTY-39061 TRACT-    0028     IN CINCINNATI OH,8805,8614,191,8247,191,2610,19.44
G39006100029,STCTY-39061 TRACT-    0029     IN CINCINNATI OH,4108,4098,10,3710,8,4887,36.91
G39006100030,STCTY-39061 TRACT-    0030     IN CINCINNATI OH,3230,3229,1,2948,0,4043,28.84
G39006100031,STCTY-39061 TRACT-    0031     IN CINCINNATI OH,3580,3579,1,3263,0,4327,25.58
G39006100032,STCTY-39061 TRACT-    0032     IN CINCINNATI OH,4356,4336,20,3900,19,5191,30.76
G39006100033,STCTY-39061 TRACT-    0033     IN CINCINNATI OH,2941,2913,28,2677,28,5444,32.69
G39006100034,STCTY-39061 TRACT-    0034     IN CINCINNATI OH,4659,3704,955,3231,945,4456,33.2
G39006100035,STCTY-39061 TRACT-    0035     IN CINCINNATI OH,3423,3149,274,2918,272,5923,32.5
G39006100036,STCTY-39061 TRACT-    0036     IN CINCINNATI OH,5185,100,5085,89,5085,3929,23.53
G39006100037,STCTY-39061 TRACT-    0037     IN CINCINNATI OH,5620,3022,2598,2861,2596,5058,29.47
G39006100038,STCTY-39061 TRACT-    0038     IN CINCINNATI OH,4835,4813,22,4579,22,4765,36.34
G39006100039,STCTY-39061 TRACT-    0039     IN CINCINNATI OH,3815,3753,62,3534,61,5322,34.05
G39006100040,STCTY-39061 TRACT-    0040     IN CINCINNATI OH,3025,3018,7,2884,7,6183,37.4
G39006100041,STCTY-39061 TRACT-    0041     IN CINCINNATI OH,4115,3790,325,3514,325,5671,31.46
G39006100042,STCTY-39061 TRACT-    0042     IN CINCINNATI OH,3060,3033,27,2814,27,5925,35.18
G39006100043,STCTY-39061 TRACT-    0043     IN CINCINNATI OH,1826,1805,21,1776,21,2172,19.24
G39006100044,STCTY-39061 TRACT-    0044     IN CINCINNATI OH,5783,4924,859,4832,859,2373,20.44
G39006100045,STCTY-39061 TRACT-    0045     IN CINCINNATI OH,1023,1018,5,1006,5,2855,22.67
G39006100046,STCTY-39061 TRACT-    0046     IN CINCINNATI OH,2625,2617,8,2540,8,5690,40.55
G39006100047,STCTY-39061 TRACT-    0047     IN CINCINNATI OH,4883,4836,47,4704,47,4656,27.25
G39006100048,STCTY-39061 TRACT-    0048     IN CINCINNATI OH,4780,4726,54,4605,54,9839,38.31
G39006100049,STCTY-39061 TRACT-    0049     IN CINCINNATI OH,5946,5827,119,5539,117,8024,48.22
G39006100050,STCTY-39061 TRACT-    0050     IN CINCINNATI OH,5821,5770,51,5541,49,7600,51.17
G39006100051,STCTY-39061 TRACT-    0051     IN CINCINNATI OH,3240,3197,43,3089,43,8525,62.33
G39006100052,STCTY-39061 TRACT-    0052     IN CINCINNATI OH,5759,5748,11,5517,10,5455,37.9
G39006100053,STCTY-39061 TRACT-    0053     IN CINCINNATI OH,6826,6811,15,6399,14,5506,36.86
G39006100054,STCTY-39061 TRACT-    0054     IN CINCINNATI OH,1209,1100,109,1021,109,5257,31.58
G39006100055,STCTY-39061 TRACT-    0055     IN CINCINNATI OH,5668,4644,1024,4460,1024,4253,30.51
G39006100056,STCTY-39061 TRACT-    0056     IN CINCINNATI OH,5626,5436,190,5282,188,5075,33.81
G39006100057,STCTY-39061 TRACT-    0057     IN CINCINNATI OH,6523,6466,57,6194,57,6986,49.41
G39006100058,STCTY-39061 TRACT-    0058     IN CINCINNATI OH,3513,3400,113,3273,113,7187,51.74
G39006100059,STCTY-39061 TRACT-    0059     IN CINCINNATI OH,991,988,3,956,3,9321,42.09
G39006100060,STCTY-39061 TRACT-    0060     IN CINCINNATI OH,4315,4098,217,3960,217,5054,30.83
G39006100061,STCTY-39061 TRACT-    0061     IN CINCINNATI OH,4728,4722,6,4576,6,4497,28.08
G39006100062,STCTY-39061 TRACT-    0062     IN CINCINNATI OH,4728,4355,373,3993,372,10197,0
G39006100063,STCTY-39061 TRACT-    0063     IN CINCINNATI OH,3803,3798,5,3606,5,7771,54.21
G39006100064,STCTY-39061 TRACT-    0064     IN CINCINNATI OH,4096,4090,6,3896,6,6995,46.4
G39006100065,STCTY-39061 TRACT-    0065     IN CINCINNATI OH,5154,5012,142,4484,142,12089,73.12
G39006100066,STCTY-39061 TRACT-    0066     IN CINCINNATI OH,3082,2855,227,2162,226,6844,46.99
G39006100067,STCTY-39061 TRACT-    0067     IN CINCINNATI OH,6085,5897,188,4030,186,5050,39.75
G39006100068,STCTY-39061 TRACT-    0068     IN CINCINNATI OH,4820,4731,89,3585,87,8632,53.66
G39006100069,STCTY-39061 TRACT-    0069     IN CINCINNATI OH,4969,4506,463,3582,463,5298,38.46
G39006100070,STCTY-39061 TRACT-    0070     IN CINCINNATI OH,3005,2979,26,2816,20,7309,38.93
G39006100071,STCTY-39061 TRACT-    0071     IN CINCINNATI OH,3523,3462,61,3274,60,10731,47.59
G39006100072,STCTY-39061 TRACT-    0072     IN CINCINNATI OH,1812,1803,9,1703,9,8800,51.52
G39006100073,STCTY-39061 TRACT-    0073     IN CINCINNATI OH,3122,3121,1,2987,1,5121,31.17
G39006100074,STCTY-39061 TRACT-    0074     IN CINCINNATI OH,4363,4344,19,4192,19,3283,26.74
G39006100075,STCTY-39061 TRACT-    0075     IN CINCINNATI OH,2009,2008,1,1918,1,5221,34.06
G39006100076,STCTY-39061 TRACT-    0076     IN CINCINNATI OH,4277,4205,72,4045,72,3214,22.53
G39006100077,STCTY-39061 TRACT-    0077     IN CINCINNATI OH,2364,1986,378,1896,378,3508,22.28
G39006100078,STCTY-39061 TRACT-    0078     IN CINCINNATI OH,4976,4971,5,4776,5,4242,29.82
G39006100079,STCTY-39061 TRACT-    0079     IN CINCINNATI OH,2734,2542,192,2413,192,4480,31.51
G39006100080,STCTY-39061 TRACT-    0080     IN CINCINNATI OH,593,538,55,485,55,0,0
G39006100081,STCTY-39061 TRACT-    0081     IN CINCINNATI OH,884,869,15,817,15,6250,0
G39006100082,STCTY-39061 TRACT-    0082     IN CINCINNATI OH,6154,5960,194,5680,193,6717,41
G39006100083,STCTY-39061 TRACT-    0083     IN CINCINNATI OH,653,652,1,631,1,7768,0
G39006100084,STCTY-39061 TRACT-    0084     IN CINCINNATI OH,996,971,25,933,17,7261,0
G39006100085,STCTY-39061 TRACT-    0085     IN CINCINNATI OH,1137,1117,20,1061,20,4694,25.93
G39006100086,STCTY-39061 TRACT-    0086     IN CINCINNATI OH,4829,4774,55,4494,55,3153,22.98
G39006100087,STCTY-39061 TRACT-    0087     IN CINCINNATI OH,3720,3701,19,3533,16,2522,22.17
G39006100088,STCTY-39061 TRACT-    0088     IN CINCINNATI OH,1977,1975,2,1776,2,4727,30.27
G39006100089,STCTY-39061 TRACT-    0089     IN CINCINNATI OH,4094,4055,39,3693,39,4151,24.07
G39006100090,STCTY-39061 TRACT-    0090     IN CINCINNATI OH,1775,1773,2,1698,2,2355,19.95
G39006100091,STCTY-39061 TRACT-    0091     IN CINCINNATI OH,5274,5273,1,5144,1,2402,15.65
G39006100092,STCTY-39061 TRACT-    0092     IN CINCINNATI OH,1798,1793,5,1708,5,4262,30.9
G39006100093,STCTY-39061 TRACT-    0093     IN CINCINNATI OH,5113,5069,44,4833,44,4117,27.47
G39006100094,STCTY-39061 TRACT-    0094     IN CINCINNATI OH,3155,3155,0,3008,0,4942,29.88
G39006100095,STCTY-39061 TRACT-    0095     IN CINCINNATI OH,4118,4116,2,3917,2,4703,33.31
G39006100096,STCTY-39061 TRACT-    0096     IN CINCINNATI OH,6593,6550,43,6264,42,4334,31.11
G39006100097,STCTY-39061 TRACT-    0097     IN CINCINNATI OH,6712,6702,10,6304,8,5470,35.32
G39006100098,STCTY-39061 TRACT-    0098     IN CINCINNATI OH,2144,2131,13,2027,13,4141,31.77
G39006100099,STCTY-39061 TRACT-    0099     IN CINCINNATI OH,6188,6185,3,5893,3,7188,44.38
G39006100100,STCTY-39061 TRACT-    0100     IN CINCINNATI OH,3189,3187,2,3043,2,6784,40.99
G39006100101,STCTY-39061 TRACT-    0101     IN CINCINNATI OH,3075,3074,1,2923,1,7052,39.35
G39006100102,STCTY-39061 TRACT-    0102     IN CINCINNATI OH,4712,4712,0,4538,0,7097,44.86
G39006100103,STCTY-39061 TRACT-    0103     IN CINCINNATI OH,4234,4232,2,4108,2,3122,22.77
G39006100104,STCTY-39061 TRACT-    0104     IN CINCINNATI OH,1588,1588,0,1552,0,3061,19.94
G39006100105,STCTY-39061 TRACT-    0105     IN CINCINNATI OH,1518,1381,137,1362,137,3932,26.57
G39006100106,STCTY-39061 TRACT-    0106     IN CINCINNATI OH,1109,1103,6,1087,6,5392,0
G39006100107,STCTY-39061 TRACT-    0107     IN CINCINNATI OH,2354,2354,0,2267,0,7187,45.83
G3900610C0001,STCTY-39061 TRACT-  C 0001     IN CINCINNATI OH ADJ AREA,2215,2200,15,2171,15,3198,22.31
G3900610C0002,STCTY-39061 TRACT-  C 0002     IN CINCINNATI OH ADJ AREA,4477,4466,11,4359,11,5368,29.55
G3900610C0003,STCTY-39061 TRACT-  C 0003     IN CINCINNATI OH ADJ AREA,4627,4621,6,4472,6,4934,23.93
G3900610C0004A,STCTY-39061 TRACT-  C 0004-A   IN CINCINNATI OH ADJ AREA,992,937,55,885,55,0,0
G3900610C0004B,STCTY-39061 TRACT-  C 0004-B   IN CINCINNATI OH ADJ AREA,618,524,94,489,93,0,0
G3900610C0005,STCTY-39061 TRACT-  C 0005     IN CINCINNATI OH ADJ AREA,1730,1704,26,1670,26,6898,25.33
G3900610C0006A,STCTY-39061 TRACT-  C 0006-A   IN CINCINNATI OH ADJ AREA,1583,1573,10,1544,8,5652,49.13
G3900610C0006B,STCTY-39061 TRACT-  C 0006-B   IN CINCINNATI OH ADJ AREA,4063,4063,0,3860,0,4792,35.57
G3900610C0007A,STCTY-39061 TRACT-  C 0007-A   IN CINCINNATI OH ADJ AREA,2941,2668,273,2567,271,5141,32.6
G3900610C0007B,STCTY-39061 TRACT-  C 0007-B   IN CINCINNATI OH ADJ AREA,659,658,1,632,1,5404,0
G3900610C0008,STCTY-39061 TRACT-  C 0008     IN CINCINNATI OH ADJ AREA,577,561,16,539,16,4129,0
G3900610C0009,STCTY-39061 TRACT-  C 0009     IN CINCINNATI OH ADJ AREA,5059,5055,4,4894,4,4862,32.63
G3900610C0010,STCTY-39061 TRACT-  C 0010     IN CINCINNATI OH ADJ AREA,7337,7337,0,7038,0,5217,33.58
G3900610C0011,STCTY-39061 TRACT-  C 0011     IN CINCINNATI OH ADJ AREA,9183,9180,3,8852,3,5190,35.63
G3900610C0012,STCTY-39061 TRACT-  C 0012     IN CINCINNATI OH ADJ AREA,7201,7186,15,6852,15,3806,32.02
G3900610C0013,STCTY-39061 TRACT-  C 0013     IN CINCINNATI OH ADJ AREA,5230,5192,38,4987,38,5000,35.33
G3900610C0014A,STCTY-39061 TRACT-  C 0014-A   IN CINCINNATI OH ADJ AREA,2939,2939,0,2818,0,6811,45.3
G3900610C0014B,STCTY-39061 TRACT-  C 0014-B   IN CINCINNATI OH ADJ AREA,5539,5529,10,5316,10,5167,36.81
G3900610C0014C,STCTY-39061 TRACT-  C 0014-C   IN CINCINNATI OH ADJ AREA,636,636,0,605,0,4778,0
G3900610C0015,STCTY-39061 TRACT-  C 0015     IN CINCINNATI OH ADJ AREA,942,942,0,935,0,0,0
G3900610C0016,STCTY-39061 TRACT-  C 0016     IN CINCINNATI OH ADJ AREA,4175,4140,35,4017,35,5458,30.21
G3900610C0017,STCTY-39061 TRACT-  C 0017     IN CINCINNATI OH ADJ AREA,4882,4789,93,4561,93,5511,31.75
G3900610C0018,STCTY-39061 TRACT-  C 0018     IN CINCINNATI OH ADJ AREA,5413,5413,0,5117,0,5291,36.21
G3900610C0019,STCTY-39061 TRACT-  C 0019     IN CINCINNATI OH ADJ AREA,4950,4949,1,4701,0,5679,34.86
G3900610C0020,STCTY-39061 TRACT-  C 0020     IN CINCINNATI OH ADJ AREA,3218,3186,32,3086,32,6961,35.39
G3900610C0021,STCTY-39061 TRACT-  C 0021     IN CINCINNATI OH ADJ AREA,2435,2428,7,2409,7,3540,21.41
G3900610C0022,STCTY-39061 TRACT-  C 0022     IN CINCINNATI OH ADJ AREA,5757,5297,460,5251,460,2383,18.47
G3900610C0023,STCTY-39061 TRACT-  C 0023     IN CINCINNATI OH ADJ AREA,4248,4145,103,4037,103,3396,24.31
G3900610C0024,STCTY-39061 TRACT-  C 0024     IN CINCINNATI OH ADJ AREA,7387,7386,1,7078,1,4686,30.99
G3900610C0025A,STCTY-39061 TRACT-  C 0025-A   IN CINCINNATI OH ADJ AREA,3241,2655,586,2589,586,4966,29.37
G3900610C0025B,STCTY-39061 TRACT-  C 0025-B   IN CINCINNATI OH ADJ AREA,449,449,0,443,0,0,0
G3900610C0026,STCTY-39061 TRACT-  C 0026     IN CINCINNATI OH ADJ AREA,3675,3665,10,3578,10,4431,35.34
G3900610C0027,STCTY-39061 TRACT-  C 0027     IN CINCINNATI OH ADJ AREA,4626,4604,22,4467,22,4260,29.43
G3900610C0028,STCTY-39061 TRACT-  C 0028     IN CINCINNATI OH ADJ AREA,6579,5628,951,5278,951,4252,31.15
G3900610C0029,STCTY-39061 TRACT-  C 0029     IN CINCINNATI OH ADJ AREA,7969,6734,1235,6348,1234,6819,36.03
G3900610C0030A,STCTY-39061 TRACT-  C 0030-A   IN CINCINNATI OH ADJ AREA,2672,560,2112,543,2112,1351,15.82
G3900610C0030B,STCTY-39061 TRACT-  C 0030-B   IN CINCINNATI OH ADJ AREA,789,76,713,73,713,0,9.45
G3900610C0030C,STCTY-39061 TRACT-  C 0030-C   IN CINCINNATI OH ADJ AREA,5601,4504,1097,4425,1097,4349,23.74
G3900610C0031A,STCTY-39061 TRACT-  C 0031-A   IN CINCINNATI OH ADJ AREA,528,528,0,515,0,0,0
G3900610C0031B,STCTY-39061 TRACT-  C 0031-B   IN CINCINNATI OH ADJ AREA,7212,7212,0,7024,0,4177,27.42
G3900610C0032,STCTY-39061 TRACT-  C 0032     IN CINCINNATI OH ADJ AREA,3499,3225,274,3160,274,3313,25.48
G3900610C0033,STCTY-39061 TRACT-  C 0033     IN CINCINNATI OH ADJ AREA,4489,4341,148,4249,148,3608,25.83
G3900610C0034,STCTY-39061 TRACT-  C 0034     IN CINCINNATI OH ADJ AREA,2071,1883,188,1829,188,3204,20.41
G3900610C0035,STCTY-39061 TRACT-  C 0035     IN CINCINNATI OH ADJ AREA,1964,1951,13,1934,13,2784,19.21
G3900850LC0001,STCTY-39085 TRACT- LC 0001     IN CLEVELAND OH ADJ AREA,915,915,0,838,0,4479,0
G3900850LC0002,STCTY-39085 TRACT- LC 0002     IN CLEVELAND OH ADJ AREA,3155,3100,55,2595,54,3705,28.16
G3900850LC0003,STCTY-39085 TRACT- LC 0003     IN CLEVELAND OH ADJ AREA,77,77,0,67,0,0,0
G3900850LC0004,STCTY-39085 TRACT- LC 0004     IN CLEVELAND OH ADJ AREA,6182,6168,14,5564,11,3212,31.31
G3900850LC0005,STCTY-39085 TRACT- LC 0005     IN CLEVELAND OH ADJ AREA,4364,4317,47,3898,47,4931,37.14
G3900850LC0006,STCTY-39085 TRACT- LC 0006     IN CLEVELAND OH ADJ AREA,289,284,5,234,5,0,0
G39009500001,STCTY-39095 TRACT-    0001     IN TOLEDO OH,4852,4850,2,4638,2,6197,60.83
G39009500002,STCTY-39095 TRACT-    0002     IN TOLEDO OH,4375,4374,1,4135,1,5699,52.95
G39009500003,STCTY-39095 TRACT-    0003     IN TOLEDO OH,3775,3770,5,3604,5,5647,53.54
G39009500004,STCTY-39095 TRACT-    0004     IN TOLEDO OH,3964,3964,0,3747,0,4482,41.84
G39009500005,STCTY-39095 TRACT-    0005     IN TOLEDO OH,1090,1090,0,987,0,2786,30.23
G39009500006,STCTY-39095 TRACT-    0006     IN TOLEDO OH,5587,5585,2,5284,1,4937,46.75
G39009500007,STCTY-39095 TRACT-    0007     IN TOLEDO OH,5947,5947,0,5628,0,3839,42.17
G39009500008,STCTY-39095 TRACT-    0008     IN TOLEDO OH,4300,4295,5,4086,2,4281,38.36
G39009500009,STCTY-39095 TRACT-    0009     IN TOLEDO OH,4722,4722,0,3910,0,3235,34.5
G39009500010,STCTY-39095 TRACT-    0010     IN TOLEDO OH,6132,6124,8,4692,8,3169,24.5
G39009500011,STCTY-39095 TRACT-    0011     IN TOLEDO OH,3502,3309,193,3085,182,3355,33.13
G39009500012,STCTY-39095 TRACT-    0012     IN TOLEDO OH,3851,3479,372,3244,372,2392,24.9
G39009500013,STCTY-39095 TRACT-    0013     IN TOLEDO OH,5342,5335,7,5042,7,7968,56.24
G39009500014,STCTY-39095 TRACT-    0014     IN TOLEDO OH,4501,4491,10,4221,1,3621,35.09
G39009500015,STCTY-39095 TRACT-    0015     IN TOLEDO OH,5122,5120,2,4848,1,3368,32.08
G39009500016,STCTY-39095 TRACT-    0016     IN TOLEDO OH,6862,6852,10,6303,10,5711,48.31
G39009500017,STCTY-39095 TRACT-    0017     IN TOLEDO OH,5642,5642,0,4955,0,2503,27.76
G39009500018,STCTY-39095 TRACT-    0018     IN TOLEDO OH,6432,6421,11,5387,11,2527,26.77
G39009500019,STCTY-39095 TRACT-    0019     IN TOLEDO OH,3593,3271,322,2830,322,2229,31.61
G39009500020,STCTY-39095 TRACT-    0020     IN TOLEDO OH,4859,4850,9,4514,9,2682,29.27
G39009500021,STCTY-39095 TRACT-    0021     IN TOLEDO OH,6612,6595,17,6214,17,5917,46.92
G39009500022,STCTY-39095 TRACT-    0022     IN TOLEDO OH,6063,6049,14,5166,12,3943,37.77
G39009500023,STCTY-39095 TRACT-    0023     IN TOLEDO OH,5611,5105,506,4483,505,2857,26.65
G39009500024,STCTY-39095 TRACT-    0024     IN TOLEDO OH,6554,6524,30,6128,21,5208,45.18
G39009500025,STCTY-39095 TRACT-    0025     IN TOLEDO OH,6937,6931,6,6444,6,3017,31.92
G39009500026,STCTY-39095 TRACT-    0026     IN TOLEDO OH,6804,6219,585,5818,577,3334,33.95
G39009500027,STCTY-39095 TRACT-    0027     IN TOLEDO OH,4323,4306,17,4045,12,3545,26.5
G39009500028,STCTY-39095 TRACT-    0028     IN TOLEDO OH,4709,4329,380,3861,325,0,21.37
G39009500029,STCTY-39095 TRACT-    0029     IN TOLEDO OH,5197,5172,25,4433,17,2648,20.72
G39009500030,STCTY-39095 TRACT-    0030     IN TOLEDO OH,6970,6950,20,6202,10,2452,27.1
G39009500031,STCTY-39095 TRACT-    0031     IN TOLEDO OH,2769,2769,0,2510,0,3102,30.3
G39009500032,STCTY-39095 TRACT-    0032     IN TOLEDO OH,5193,5184,9,4468,9,2517,24.94
G39009500033,STCTY-39095 TRACT-    0033     IN TOLEDO OH,6521,3066,3455,2700,3454,2487,30.5
G39009500034,STCTY-39095 TRACT-    0034     IN TOLEDO OH,6557,3002,3555,2744,3545,2840,19.92
G39009500035,STCTY-39095 TRACT-    0035     IN TOLEDO OH,4902,4902,0,3944,0,2376,22.2
G39009500036,STCTY-39095 TRACT-    0036     IN TOLEDO OH,6124,5284,840,4561,840,2407,27.38
G39009500037,STCTY-39095 TRACT-    0037     IN TOLEDO OH,3957,996,2961,836,2951,2129,23.21
G39009500038,STCTY-39095 TRACT-    0038     IN TOLEDO OH,2602,2593,9,2459,8,2195,25.57
G39009500039,STCTY-39095 TRACT-    0039     IN TOLEDO OH,5946,5943,3,5619,0,3806,34.36
G39009500040,STCTY-39095 TRACT-    0040     IN TOLEDO OH,4099,3798,301,3514,301,2799,29.83
G39009500041,STCTY-39095 TRACT-    0041     IN TOLEDO OH,4076,4075,1,3866,1,2412,26.86
G39009500042,STCTY-39095 TRACT-    0042     IN TOLEDO OH,4240,4196,44,3929,44,3053,33.42
G39009500043,STCTY-39095 TRACT-    0043     IN TOLEDO OH,6435,6299,136,5601,134,4763,41.63
G39009500044,STCTY-39095 TRACT-    0044     IN TOLEDO OH,4744,4743,1,4546,1,4118,40.82
G39009500045,STCTY-39095 TRACT-    0045     IN TOLEDO OH,5128,5118,10,4935,8,6228,47.08
G39009500046,STCTY-39095 TRACT-    0046     IN TOLEDO OH,6127,5928,199,4474,199,2292,24.76
G39009500047,STCTY-39095 TRACT-    0047     IN TOLEDO OH,8246,8223,23,7219,19,3168,32.38
G39009500048,STCTY-39095 TRACT-    0048     IN TOLEDO OH,6305,6295,10,5765,10,3229,31.27
G39009500049,STCTY-39095 TRACT-    0049     IN TOLEDO OH,5176,5176,0,4806,0,2908,30.65
G39009500050,STCTY-39095 TRACT-    0050     IN TOLEDO OH,2504,2498,6,2344,5,2942,34.16
G39009500051,STCTY-39095 TRACT-    0051     IN TOLEDO OH,7332,7144,188,6750,184,2942,27.28
G39009500052,STCTY-39095 TRACT-    0052     IN TOLEDO OH,4472,4448,24,4042,24,3003,29.53
G39009500053,STCTY-39095 TRACT-    0053     IN TOLEDO OH,3431,3008,423,2630,421,2797,29.53
G39009500054,STCTY-39095 TRACT-    0054     IN TOLEDO OH,6426,6425,1,6053,1,2683,32.25
G39009500055,STCTY-39095 TRACT-    0055     IN TOLEDO OH,4807,4805,2,4593,2,3742,32.83
G390113000011,STCTY-39113 TRACT-    0001-1   IN DAYTON OH,4387,4340,47,4202,36,0,27.92
G390113000012,STCTY-39113 TRACT-    0001-2   IN DAYTON OH,3123,2645,478,2494,478,0,20.88
G390113000013,STCTY-39113 TRACT-    0001-3   IN DAYTON OH,2330,2304,26,2191,23,0,25.8
G390113000014,STCTY-39113 TRACT-    0001-4   IN DAYTON OH,2108,1536,572,1490,566,0,22.63
G390113000021,STCTY-39113 TRACT-    0002-1   IN DAYTON OH,3742,3740,2,3364,2,2735,27.2
G390113000022,STCTY-39113 TRACT-    0002-2   IN DAYTON OH,8991,8883,108,7743,108,3254,29.07
G390113000031,STCTY-39113 TRACT-    0003-1   IN DAYTON OH,3185,3182,3,3054,3,3767,34.33
G390113000032,STCTY-39113 TRACT-    0003-2   IN DAYTON OH,2650,2643,7,2572,7,3643,39.32
G390113000033,STCTY-39113 TRACT-    0003-3   IN DAYTON OH,3443,3434,9,3346,9,3841,37.13
G390113000041,STCTY-39113 TRACT-    0004-1   IN DAYTON OH,4439,4439,0,4320,0,5464,47.82
G390113000042,STCTY-39113 TRACT-    0004-2   IN DAYTON OH,4386,4335,51,4188,51,5232,46.4
G390113000043,STCTY-39113 TRACT-    0004-3   IN DAYTON OH,6871,6867,4,6715,4,6282,52.38
G390113000051,STCTY-39113 TRACT-    0005-1   IN DAYTON OH,7929,7892,37,7608,33,7096,52.38
G390113000052,STCTY-39113 TRACT-    0005-2   IN DAYTON OH,6186,6155,31,5732,31,8721,55.81
G390113000061,STCTY-39113 TRACT-    0006-1   IN DAYTON OH,3240,2936,304,2827,304,4123,32.49
G390113000062,STCTY-39113 TRACT-    0006-2   IN DAYTON OH,999,777,222,703,222,0,20.25
G390113000063,STCTY-39113 TRACT-    0006-3   IN DAYTON OH,3903,3893,10,3548,10,6150,46.76
G390113000064,STCTY-39113 TRACT-    0006-4   IN DAYTON OH,1383,1382,1,1259,1,5167,50.71
G390113000071,STCTY-39113 TRACT-    0007-1   IN DAYTON OH,2604,2572,32,2475,32,3058,31.7
G390113000072,STCTY-39113 TRACT-    0007-2   IN DAYTON OH,9800,9788,12,9436,12,3660,38.2
G390113000073,STCTY-39113 TRACT-    0007-3   IN DAYTON OH,1053,1053,0,1015,0,4535,0
G390113000081,STCTY-39113 TRACT-    0008-1   IN DAYTON OH,13409,4126,9283,3900,9283,2363,24.45
G390113000082,STCTY-39113 TRACT-    0008-2   IN DAYTON OH,5912,2391,3521,2343,3521,2739,26.99
G390113000083,STCTY-39113 TRACT-    0008-3   IN DAYTON OH,6044,2294,3750,2230,3750,2369,25.47
G390113000084,STCTY-39113 TRACT-    0008-4   IN DAYTON OH,1970,1879,91,1835,90,3104,32.83
G390113000085,STCTY-39113 TRACT-    0008-5   IN DAYTON OH,1121,1082,39,1037,39,2500,28.09
G390113000086,STCTY-39113 TRACT-    0008-6   IN DAYTON OH,3013,2690,323,2105,323,2496,24.93
G390113000091,STCTY-39113 TRACT-    0009-1   IN DAYTON OH,3632,3401,231,3257,231,2908,28.44
G390113000092,STCTY-39113 TRACT-    0009-2   IN DAYTON OH,920,767,153,741,153,3438,31.89
G390113000093,STCTY-39113 TRACT-    0009-3   IN DAYTON OH,1901,1901,0,1872,0,3472,31.89
G390113000101,STCTY-39113 TRACT-    0010-1   IN DAYTON OH,10311,10151,160,9748,159,3017,23.78
G3901130001010,STCTY-39113 TRACT-    0010-10  IN DAYTON OH,5078,5076,2,4880,2,3648,33.65
G390113000102,STCTY-39113 TRACT-    0010-2   IN DAYTON OH,4028,4021,7,3860,7,3874,38.1
G390113000103,STCTY-39113 TRACT-    0010-3   IN DAYTON OH,4224,4220,4,4038,3,3051,31.27
G390113000104,STCTY-39113 TRACT-    0010-4   IN DAYTON OH,2401,2395,6,2271,3,3745,32.73
G390113000105,STCTY-39113 TRACT-    0010-5   IN DAYTON OH,7137,7124,13,6760,12,2886,27.18
G390113000106,STCTY-39113 TRACT-    0010-6   IN DAYTON OH,2493,2492,1,2402,1,2690,24.52
G390113000107,STCTY-39113 TRACT-    0010-7   IN DAYTON OH,3336,3252,84,2972,84,2481,25.59
G390113000108,STCTY-39113 TRACT-    0010-8   IN DAYTON OH,5950,5875,75,5687,75,3179,30.93
G390113000109,STCTY-39113 TRACT-    0010-9   IN DAYTON OH,4644,4644,0,4440,0,2907,32.04
G390113000111,STCTY-39113 TRACT-    0011-1   IN DAYTON OH,1056,675,381,629,381,0,19.84
G390113000112,STCTY-39113 TRACT-    0011-2   IN DAYTON OH,7231,7179,52,6876,52,3195,35.08
G390113000113,STCTY-39113 TRACT-    0011-3   IN DAYTON OH,971,944,27,870,27,3711,36.64
G390113000114,STCTY-39113 TRACT-    0011-4   IN DAYTON OH,2110,2110,0,2015,0,4616,42.44
G390113000115,STCTY-39113 TRACT-    0011-5   IN DAYTON OH,1396,1396,0,1332,0,3340,34.97
G390113000116,STCTY-39113 TRACT-    0011-6   IN DAYTON OH,1201,1196,5,1151,5,4756,38.6
G390113000121,STCTY-39113 TRACT-    0012-1   IN DAYTON OH,2936,2935,1,2818,1,4900,43.5
G390113000122,STCTY-39113 TRACT-    0012-2   IN DAYTON OH,4679,4679,0,4537,0,4876,43.13
G390113000123,STCTY-39113 TRACT-    0012-3   IN DAYTON OH,3739,3739,0,3596,0,4520,43.54
G390113000124,STCTY-39113 TRACT-    0012-4   IN DAYTON OH,2319,2183,136,2019,136,0,0
G390113000125,STCTY-39113 TRACT-    0012-5   IN DAYTON OH,2762,2762,0,2678,0,4051,42
G390113000126,STCTY-39113 TRACT-    0012-6   IN DAYTON OH,3617,3616,1,3515,1,3480,35.83
G390113000127,STCTY-39113 TRACT-    0012-7   IN DAYTON OH,2425,2423,2,2389,2,4887,40.78
G3901130C0001,STCTY-39113 TRACT-  C 0001     IN DAYTON OH ADJ AREA,7652,7553,99,7254,99,8946,66.19
G3901530A0001,STCTY-39153 TRACT-  A 0001     IN AKRON OH,4669,2302,2367,1747,2365,2569,20.87
G3901530A0002,STCTY-39153 TRACT-  A 0002     IN AKRON OH,4046,4031,15,3826,13,2927,29.93
G3901530A0003,STCTY-39153 TRACT-  A 0003     IN AKRON OH,3555,2995,560,2735,558,3159,23.57
G3901530A0004,STCTY-39153 TRACT-  A 0004     IN AKRON OH,4796,4776,20,4459,20,3311,29.84
G3901530A0005,STCTY-39153 TRACT-  A 0005     IN AKRON OH,4559,4241,318,3607,318,2693,26.2
G3901530A0006,STCTY-39153 TRACT-  A 0006     IN AKRON OH,4466,3459,1007,2564,1006,2296,22.56
G3901530A0007,STCTY-39153 TRACT-  A 0007     IN AKRON OH,3817,3717,100,3285,100,2564,27.51
G3901530A0008,STCTY-39153 TRACT-  A 0008     IN AKRON OH,6000,4848,1152,3937,1152,2639,27.54
G3901530A0009,STCTY-39153 TRACT-  A 0009     IN AKRON OH,6076,6006,70,5507,69,2956,25.88
G3901530B0001,STCTY-39153 TRACT-  B 0001     IN AKRON OH,4957,4954,3,4568,3,3584,35.19
G3901530B0002,STCTY-39153 TRACT-  B 0002     IN AKRON OH,7729,7686,43,6604,42,3463,33.64
G3901530B0003,STCTY-39153 TRACT-  B 0003     IN AKRON OH,4909,4407,502,3927,502,3043,32.13
G3901530B0004,STCTY-39153 TRACT-  B 0004     IN AKRON OH,3605,3559,46,3289,46,2785,30.42
G3901530B0005,STCTY-39153 TRACT-  B 0005     IN AKRON OH,4867,4772,95,4299,91,3022,27.89
G3901530B0006,STCTY-39153 TRACT-  B 0006     IN AKRON OH,5082,5070,12,4849,12,3948,31.6
G3901530B0007,STCTY-39153 TRACT-  B 0007     IN AKRON OH,3563,3563,0,3422,0,3690,37.62
G3901530B0008,STCTY-39153 TRACT-  B 0008     IN AKRON OH,3255,3255,0,3109,0,3398,34.5
G3901530BC0001,STCTY-39153 TRACT- BC 0001     IN AKRON OH ADJ AREA,7802,7264,538,6226,535,3554,27.39
G3901530BC0002,STCTY-39153 TRACT- BC 0002     IN AKRON OH ADJ AREA,4553,4553,0,4191,0,3486,31.67
G3901530BC0003,STCTY-39153 TRACT- BC 0003     IN AKRON OH ADJ AREA,3845,3471,374,2884,374,2657,25.75
G3901530BC0004,STCTY-39153 TRACT- BC 0004     IN AKRON OH ADJ AREA,1890,1878,12,1737,12,3179,28.39
G3901530BC0005,STCTY-39153 TRACT- BC 0005     IN AKRON OH ADJ AREA,5938,5929,9,4866,9,3055,26.33
G3901530C0001,STCTY-39153 TRACT-  C 0001     IN AKRON OH,4457,4433,24,4027,24,2271,29.17
G3901530C0002,STCTY-39153 TRACT-  C 0002     IN AKRON OH,4754,4671,83,4163,83,3376,29.07
G3901530C0003,STCTY-39153 TRACT-  C 0003     IN AKRON OH,2966,2964,2,2667,2,3285,32.34
G3901530C0004,STCTY-39153 TRACT-  C 0004     IN AKRON OH,5935,5358,577,4578,577,2395,24.16
G3901530C0005,STCTY-39153 TRACT-  C 0005     IN AKRON OH,4485,4194,291,3851,285,2794,26.78
G3901530C0006,STCTY-39153 TRACT-  C 0006     IN AKRON OH,3669,3665,4,3368,2,3163,26.47
G3901530C0007,STCTY-39153 TRACT-  C 0007     IN AKRON OH,4904,4877,27,4671,26,3446,32.59
G3901530C0008,STCTY-39153 TRACT-  C 0008     IN AKRON OH,1031,1030,1,981,1,2944,0
G3901530CFC0001,STCTY-39153 TRACT-CFC 0001     IN AKRON OH ADJ AREA,4224,4220,4,3970,4,2931,30.66
G3901530CFC0002,STCTY-39153 TRACT-CFC 0002     IN AKRON OH ADJ AREA,6784,6784,0,6452,0,5310,43.76
G3901530CFC0003,STCTY-39153 TRACT-CFC 0003     IN AKRON OH ADJ AREA,1850,1849,1,1749,1,5292,46.5
G3901530CFC0004,STCTY-39153 TRACT-CFC 0004     IN AKRON OH ADJ AREA,2481,2481,0,2381,0,4253,33.75
G3901530CFC0005,STCTY-39153 TRACT-CFC 0005     IN AKRON OH ADJ AREA,2603,2603,0,2489,0,3760,43.21
G3901530CFC0006,STCTY-39153 TRACT-CFC 0006     IN AKRON OH ADJ AREA,2604,2604,0,2502,0,3736,37.71
G3901530D0001,STCTY-39153 TRACT-  D 0001     IN AKRON OH,4084,3966,118,3656,118,3334,29.14
G3901530D0002,STCTY-39153 TRACT-  D 0002     IN AKRON OH,4603,4581,22,3695,22,2676,31.66
G3901530D0003,STCTY-39153 TRACT-  D 0003     IN AKRON OH,3660,2640,1020,1944,1018,2424,22.06
G3901530D0004,STCTY-39153 TRACT-  D 0004     IN AKRON OH,3670,3539,131,2940,127,2827,24.93
G3901530D0005,STCTY-39153 TRACT-  D 0005     IN AKRON OH,3614,3594,20,2930,20,3300,32.72
G3901530D0006,STCTY-39153 TRACT-  D 0006     IN AKRON OH,5348,5041,307,4164,307,3336,31.55
G3901530D0007,STCTY-39153 TRACT-  D 0007     IN AKRON OH,5473,5473,0,5018,0,4765,39.31
G3901530D0008,STCTY-39153 TRACT-  D 0008     IN AKRON OH,2362,2362,0,2175,0,4759,35.83
G3901530E0001,STCTY-39153 TRACT-  E 0001     IN AKRON OH,2419,2419,0,2253,0,2802,28.52
G3901530E0002,STCTY-39153 TRACT-  E 0002     IN AKRON OH,4082,4019,63,3547,63,3687,31.74
G3901530E0003,STCTY-39153 TRACT-  E 0003     IN AKRON OH,4082,4041,41,3803,41,2944,28.37
G3901530E0004,STCTY-39153 TRACT-  E 0004     IN AKRON OH,5271,5271,0,4867,0,3288,32.75
G3901530E0005,STCTY-39153 TRACT-  E 0005     IN AKRON OH,2903,2902,1,2651,1,3718,31.04
G3901530E0006,STCTY-39153 TRACT-  E 0006     IN AKRON OH,4490,4175,315,3606,314,2788,25.66
G3901530E0007,STCTY-39153 TRACT-  E 0007     IN AKRON OH,5685,5685,0,5192,0,3055,29.82
G3901530E0008,STCTY-39153 TRACT-  E 0008     IN AKRON OH,3284,3284,0,3040,0,2595,29.62
G3901530E0009,STCTY-39153 TRACT-  E 0009     IN AKRON OH,2519,2506,13,2247,13,3419,27.25
G3901530F0001,STCTY-39153 TRACT-  F 0001     IN AKRON OH,2189,2171,18,2039,18,10903,71.71
G3901530F0002,STCTY-39153 TRACT-  F 0002     IN AKRON OH,3097,3092,5,2869,5,8021,65.8
G3901530F0003,STCTY-39153 TRACT-  F 0003     IN AKRON OH,6974,6791,183,5758,183,4729,43.48
G3901530F0004,STCTY-39153 TRACT-  F 0004     IN AKRON OH,4482,4471,11,4122,11,5747,49.87
G3901530F0005,STCTY-39153 TRACT-  F 0005     IN AKRON OH,5107,5101,6,4518,6,5349,47.34
G3901530F0006,STCTY-39153 TRACT-  F 0006     IN AKRON OH,4020,4016,4,3690,4,4661,40.59
G3901530F0007,STCTY-39153 TRACT-  F 0007     IN AKRON OH,3988,3357,631,2579,631,3315,32.61
G3901530F0008,STCTY-39153 TRACT-  F 0008     IN AKRON OH,4724,4164,560,3357,552,2892,29.64
G3901530F0009,STCTY-39153 TRACT-  F 0009     IN AKRON OH,4527,4512,15,4121,5,3358,30.94
G3901530G0001,STCTY-39153 TRACT-  G 0001     IN AKRON OH,1118,1085,33,1034,33,13235,0
G3901530G0002,STCTY-39153 TRACT-  G 0002     IN AKRON OH,3602,3573,29,3320,27,9649,61.09
G3901530G0003,STCTY-39153 TRACT-  G 0003     IN AKRON OH,4141,4118,23,3867,23,6263,47.47
G3901530G0004,STCTY-39153 TRACT-  G 0004     IN AKRON OH,4371,3114,1257,2549,1257,2228,26.75
G3901530G0005,STCTY-39153 TRACT-  G 0005     IN AKRON OH,7382,7259,123,6551,123,3997,34.59
G3901530G0006,STCTY-39153 TRACT-  G 0006     IN AKRON OH,5368,5327,41,4920,41,3754,36.79
G40010900001,STCTY-40109 TRACT-    0001     IN OKLAHOMA CITY OK,3532,3517,15,3477,13,2921,29.47
G40010900002,STCTY-40109 TRACT-    0002     IN OKLAHOMA CITY OK,4009,3964,45,3907,43,3749,25.26
G40010900003,STCTY-40109 TRACT-    0003     IN OKLAHOMA CITY OK,3538,3321,217,3260,210,6768,33.05
G40010900004,STCTY-40109 TRACT-    0004     IN OKLAHOMA CITY OK,1262,1248,14,1230,0,2583,22.89
G40010900005,STCTY-40109 TRACT-    0005     IN OKLAHOMA CITY OK,1343,1333,10,1316,10,3814,32.48
G40010900006,STCTY-40109 TRACT-    0006     IN OKLAHOMA CITY OK,1589,1549,40,1520,39,8116,34.82
G40010900007,STCTY-40109 TRACT-    0007     IN OKLAHOMA CITY OK,2663,2644,19,2594,18,4596,36.56
G40010900008,STCTY-40109 TRACT-    0008     IN OKLAHOMA CITY OK,2978,2920,58,2859,46,4091,34.39
G40010900009,STCTY-40109 TRACT-    0009     IN OKLAHOMA CITY OK,2072,2046,26,2030,14,6443,0
G40010900010,STCTY-40109 TRACT-    0010     IN OKLAHOMA CITY OK,4041,4023,18,3943,17,3471,33.1
G40010900011,STCTY-40109 TRACT-    0011     IN OKLAHOMA CITY OK,2043,2033,10,1992,10,3635,35.35
G40010900012,STCTY-40109 TRACT-    0012     IN OKLAHOMA CITY OK,2495,2453,42,2410,42,3313,37.92
G40010900013,STCTY-40109 TRACT-    0013     IN OKLAHOMA CITY OK,2049,1976,73,1954,73,3632,31.92
G40010900014,STCTY-40109 TRACT-    0014     IN OKLAHOMA CITY OK,3443,3425,18,3392,18,3613,33.84
G40010900015,STCTY-40109 TRACT-    0015     IN OKLAHOMA CITY OK,3801,3607,194,3552,185,7317,37.93
G40010900016,STCTY-40109 TRACT-    0016     IN OKLAHOMA CITY OK,2075,2032,43,2000,43,0,30.99
G40010900017,STCTY-40109 TRACT-    0017     IN OKLAHOMA CITY OK,2494,2204,290,2149,288,8953,25.75
G40010900018,STCTY-40109 TRACT-    0018     IN OKLAHOMA CITY OK,3252,3086,166,3020,164,5557,35.88
G40010900019,STCTY-40109 TRACT-    0019     IN OKLAHOMA CITY OK,4911,4749,162,4673,159,5140,38.15
G40010900020,STCTY-40109 TRACT-    0020     IN OKLAHOMA CITY OK,4819,4767,52,4688,46,5047,39.32
G40010900021,STCTY-40109 TRACT-    0021     IN OKLAHOMA CITY OK,3712,3671,41,3623,33,4369,30.13
G40010900022,STCTY-40109 TRACT-    0022     IN OKLAHOMA CITY OK,2808,2803,5,2772,3,3479,29.55
G40010900023,STCTY-40109 TRACT-    0023     IN OKLAHOMA CITY OK,4967,4939,28,4844,18,3887,34.92
G40010900024,STCTY-40109 TRACT-    0024     IN OKLAHOMA CITY OK,5906,5870,36,5743,34,3472,31.01
G40010900025,STCTY-40109 TRACT-    0025     IN OKLAHOMA CITY OK,4386,4285,101,4186,94,4405,23.07
G40010900026,STCTY-40109 TRACT-    0026     IN OKLAHOMA CITY OK,4458,4317,141,4262,134,4143,22.81
G40010900027,STCTY-40109 TRACT-    0027     IN OKLAHOMA CITY OK,3539,2969,570,2933,566,3482,25.31
G40010900028,STCTY-40109 TRACT-    0028     IN OKLAHOMA CITY OK,4291,4111,180,4067,170,2488,25.7
G40010900029,STCTY-40109 TRACT-    0029     IN OKLAHOMA CITY OK,3782,127,3655,123,3655,917,15.41
G40010900030,STCTY-40109 TRACT-    0030     IN OKLAHOMA CITY OK,8157,4096,4061,4046,4012,2329,19.01
G40010900031,STCTY-40109 TRACT-    0031     IN OKLAHOMA CITY OK,2627,2581,46,2511,27,0,18.92
G40010900032,STCTY-40109 TRACT-    0032     IN OKLAHOMA CITY OK,7952,7910,42,7756,18,2766,19.45
G40010900033,STCTY-40109 TRACT-    0033     IN OKLAHOMA CITY OK,4711,4705,6,4601,2,2603,23.56
G40010900034,STCTY-40109 TRACT-    0034     IN OKLAHOMA CITY OK,2216,2202,14,2164,14,1781,22.17
G40010900035,STCTY-40109 TRACT-    0035     IN OKLAHOMA CITY OK,4478,3509,969,3468,955,1890,13.17
G40010900036,STCTY-40109 TRACT-    0036     IN OKLAHOMA CITY OK,3780,3541,239,3461,228,0,13.37
G40010900037,STCTY-40109 TRACT-    0037     IN OKLAHOMA CITY OK,7505,7249,256,7061,205,1571,13
G40010900038,STCTY-40109 TRACT-    0038     IN OKLAHOMA CITY OK,8950,2173,6777,2108,6767,722,13.76
G40010900039,STCTY-40109 TRACT-    0039     IN OKLAHOMA CITY OK,6639,6636,3,6609,0,1035,14.46
G40010900040,STCTY-40109 TRACT-    0040     IN OKLAHOMA CITY OK,2595,2131,464,2009,463,1131,12.26
G40010900041,STCTY-40109 TRACT-    0041     IN OKLAHOMA CITY OK,4074,4070,4,3990,0,2144,15.32
G40010900042,STCTY-40109 TRACT-    0042     IN OKLAHOMA CITY OK,1890,1890,0,1879,0,1155,15.72
G40010900043,STCTY-40109 TRACT-    0043     IN OKLAHOMA CITY OK,3979,3979,0,3935,0,1541,18.2
G40010900044,STCTY-40109 TRACT-    0044     IN OKLAHOMA CITY OK,3917,3917,0,3905,0,2871,17.37
G40010900045,STCTY-40109 TRACT-    0045     IN OKLAHOMA CITY OK,2662,2660,2,2629,0,2871,26.09
G40010900046,STCTY-40109 TRACT-    0046     IN OKLAHOMA CITY OK,1830,1829,1,1803,0,2048,20.98
G40010900047,STCTY-40109 TRACT-    0047     IN OKLAHOMA CITY OK,3057,3057,0,3031,0,2550,21.93
G40010900048,STCTY-40109 TRACT-    0048     IN OKLAHOMA CITY OK,3079,3077,2,3066,0,1915,17.39
G40010900049,STCTY-40109 TRACT-    0049     IN OKLAHOMA CITY OK,5063,5062,1,5014,1,2347,23.65
G40010900050,STCTY-40109 TRACT-    0050     IN OKLAHOMA CITY OK,2358,2358,0,2342,0,2443,22.15
G40010900051,STCTY-40109 TRACT-    0051     IN OKLAHOMA CITY OK,1151,1139,12,1131,12,1328,15.15
G40010900052,STCTY-40109 TRACT-    0052     IN OKLAHOMA CITY OK,666,659,7,652,6,0,0
G40010900053,STCTY-40109 TRACT-    0053     IN OKLAHOMA CITY OK,3764,3735,29,3726,19,255,14.63
G40010900054,STCTY-40109 TRACT-    0054     IN OKLAHOMA CITY OK,1237,1222,15,1219,0,1229,15.65
G40010900055,STCTY-40109 TRACT-    0055     IN OKLAHOMA CITY OK,557,557,0,554,0,0,0
G40010900056,STCTY-40109 TRACT-    0056     IN OKLAHOMA CITY OK,1532,1532,0,1528,0,458,10.52
G40010900057,STCTY-40109 TRACT-    0057     IN OKLAHOMA CITY OK,936,516,420,514,420,0,10.21
G40010900058,STCTY-40109 TRACT-    0058     IN OKLAHOMA CITY OK,2015,1968,47,1956,37,277,11.6
G40010900059,STCTY-40109 TRACT-    0059     IN OKLAHOMA CITY OK,3158,3140,18,3095,11,2419,17.83
G40010900060,STCTY-40109 TRACT-    0060     IN OKLAHOMA CITY OK,1631,1626,5,1615,2,4285,18.25
G4001090OC0001,STCTY-40109 TRACT- OC 0001     IN OKLAHOMA CITY OK ADJ AREA,650,464,186,456,179,0,0
G4001090OC0002,STCTY-40109 TRACT- OC 0002     IN OKLAHOMA CITY OK ADJ AREA,1004,944,60,928,58,0,0
G4001090OC0003,STCTY-40109 TRACT- OC 0003     IN OKLAHOMA CITY OK ADJ AREA,2239,2237,2,2223,1,1880,21.26
G4001090OC0004,STCTY-40109 TRACT- OC 0004     IN OKLAHOMA CITY OK ADJ AREA,942,803,139,790,136,15100,0
G4001090OC0005,STCTY-40109 TRACT- OC 0005     IN OKLAHOMA CITY OK ADJ AREA,670,657,13,644,7,0,0
G4001090OC0006,STCTY-40109 TRACT- OC 0006     IN OKLAHOMA CITY OK ADJ AREA,508,504,4,499,2,0,0
G4001090OC0007,STCTY-40109 TRACT- OC 0007     IN OKLAHOMA CITY OK ADJ AREA,794,790,4,774,3,0,0
G4001090OC0008,STCTY-40109 TRACT- OC 0008     IN OKLAHOMA CITY OK ADJ AREA,2590,2590,0,2582,0,2570,19.85
G4001090OC0009,STCTY-40109 TRACT- OC 0009     IN OKLAHOMA CITY OK ADJ AREA,1942,1915,27,1886,27,3149,0
G4001090OC0010,STCTY-40109 TRACT- OC 0010     IN OKLAHOMA CITY OK ADJ AREA,683,683,0,674,0,414,0
G4001090OC0011,STCTY-40109 TRACT- OC 0011     IN OKLAHOMA CITY OK ADJ AREA,213,208,5,204,5,0,0
G4001090OC0012,STCTY-40109 TRACT- OC 0012     IN OKLAHOMA CITY OK ADJ AREA,885,883,2,870,1,0,0
G4001090OC0013,STCTY-40109 TRACT- OC 0013     IN OKLAHOMA CITY OK ADJ AREA,2200,2190,10,2182,2,266,12.1
G41005100001,STCTY-41051 TRACT-    0001     IN PORTLAND OR,5900,5887,13,5191,13,2506,22.92
G41005100002,STCTY-41051 TRACT-    0002     IN PORTLAND OR,4482,4475,7,3896,7,3190,30.3
G41005100003,STCTY-41051 TRACT-    0003     IN PORTLAND OR,5971,5942,29,5327,16,5321,36.67
G41005100004,STCTY-41051 TRACT-    0004     IN PORTLAND OR,4211,4178,33,3629,27,2418,22.74
G41005100005,STCTY-41051 TRACT-    0005     IN PORTLAND OR,5318,5305,13,4746,7,1945,21.44
G41005100006,STCTY-41051 TRACT-    0006     IN PORTLAND OR,5258,5227,31,4707,17,1703,19.03
G41005100007,STCTY-41051 TRACT-    0007     IN PORTLAND OR,4671,4626,45,4139,10,2514,22.98
G41005100008,STCTY-41051 TRACT-    0008     IN PORTLAND OR,5978,5942,36,5298,23,2915,26.89
G41005100009,STCTY-41051 TRACT-    0009     IN PORTLAND OR,5437,5356,81,4556,51,3035,27.62
G41005100010,STCTY-41051 TRACT-    0010     IN PORTLAND OR,6545,6484,61,5226,17,2448,22.07
G41005100011,STCTY-41051 TRACT-    0011     IN PORTLAND OR,6560,6389,171,5557,18,3026,19.64
G41005100012,STCTY-41051 TRACT-    0012     IN PORTLAND OR,8160,8028,132,7059,2,3804,28.87
G41005100013,STCTY-41051 TRACT-    0013     IN PORTLAND OR,6176,6045,131,5379,18,2759,25.44
G41005100014,STCTY-41051 TRACT-    0014     IN PORTLAND OR,6600,6548,52,5724,25,2912,28.38
G41005100015,STCTY-41051 TRACT-    0015     IN PORTLAND OR,3428,3411,17,3045,2,4071,34.58
G41005100016,STCTY-41051 TRACT-    0016     IN PORTLAND OR,3897,3857,40,3438,5,3030,25.18
G41005100017,STCTY-41051 TRACT-    0017     IN PORTLAND OR,5910,5845,65,5256,40,2513,23.46
G41005100018,STCTY-41051 TRACT-    0018     IN PORTLAND OR,4752,4719,33,4236,20,3252,27.72
G41005100019,STCTY-41051 TRACT-    0019     IN PORTLAND OR,5514,5500,14,4970,2,5364,49.68
G41005100020,STCTY-41051 TRACT-    0020     IN PORTLAND OR,6394,6321,73,5612,28,3007,31.31
G41005100021,STCTY-41051 TRACT-    0021     IN PORTLAND OR,4856,4719,137,4160,10,2391,18.63
G41005100022,STCTY-41051 TRACT-    0022     IN PORTLAND OR,6951,6159,792,5193,653,1570,18.4
G41005100023,STCTY-41051 TRACT-    0023     IN PORTLAND OR,6543,6136,407,5101,300,2102,21.82
G41005100024,STCTY-41051 TRACT-    0024     IN PORTLAND OR,6627,6605,22,5672,7,4502,41.06
G41005100025,STCTY-41051 TRACT-    0025     IN PORTLAND OR,9361,9324,37,8472,7,5434,44.55
G41005100026,STCTY-41051 TRACT-    0026     IN PORTLAND OR,3464,3460,4,3130,1,4686,47.53
G41005100027,STCTY-41051 TRACT-    0027     IN PORTLAND OR,6731,6725,6,6116,4,4270,40
G41005100028,STCTY-41051 TRACT-    0028     IN PORTLAND OR,6170,6134,36,5546,7,3987,36.93
G41005100029,STCTY-41051 TRACT-    0029     IN PORTLAND OR,6888,6858,30,6127,16,3382,32.14
G41005100030,STCTY-41051 TRACT-    0030     IN PORTLAND OR,3694,3688,6,3281,5,3782,35.9
G41005100031,STCTY-41051 TRACT-    0031     IN PORTLAND OR,4744,4709,35,4158,32,3784,30.32
G41005100032,STCTY-41051 TRACT-    0032     IN PORTLAND OR,4289,4269,20,3677,12,3468,29.66
G41005100033,STCTY-41051 TRACT-    0033     IN PORTLAND OR,6396,6241,155,4904,144,2432,22.93
G41005100034,STCTY-41051 TRACT-    0034     IN PORTLAND OR,6548,6463,85,5345,64,2601,24
G41005100035,STCTY-41051 TRACT-    0035     IN PORTLAND OR,6090,6061,29,5017,9,2896,25.57
G41005100036,STCTY-41051 TRACT-    0036     IN PORTLAND OR,8170,8092,78,7147,21,3016,26.29
G41005100037,STCTY-41051 TRACT-    0037     IN PORTLAND OR,5720,5705,15,5095,2,3662,32.05
G41005100038,STCTY-41051 TRACT-    0038     IN PORTLAND OR,9613,9596,17,8595,8,2986,27.21
G41005100039,STCTY-41051 TRACT-    0039     IN PORTLAND OR,5487,5471,16,4872,1,2777,25.09
G41005100040,STCTY-41051 TRACT-    0040     IN PORTLAND OR,4851,4833,18,4243,5,2299,21.13
G41005100041,STCTY-41051 TRACT-    0041     IN PORTLAND OR,5473,5473,0,4889,0,1926,21.07
G41005100042,STCTY-41051 TRACT-    0042     IN PORTLAND OR,2392,2372,20,2118,0,1964,18.5
G41005100043,STCTY-41051 TRACT-    0043     IN PORTLAND OR,1568,1512,56,1246,0,2140,16.3
G41005100044,STCTY-41051 TRACT-    0044     IN PORTLAND OR,113,113,0,93,0,0,0
G41005100045,STCTY-41051 TRACT-    0045     IN PORTLAND OR,3152,3119,33,2580,20,2792,20.7
G41005100046,STCTY-41051 TRACT-    0046     IN PORTLAND OR,4506,4450,56,4061,16,10357,40.69
G41005100047,STCTY-41051 TRACT-    0047     IN PORTLAND OR,4680,4653,27,4109,3,4542,29.45
G41005100048,STCTY-41051 TRACT-    0048     IN PORTLAND OR,4465,4430,35,3972,3,0,28.76
G41005100049,STCTY-41051 TRACT-    0049     IN PORTLAND OR,4507,4477,30,3966,0,3250,27.46
G41005100050,STCTY-41051 TRACT-    0050     IN PORTLAND OR,2382,2151,231,1811,44,0,17.88
G41005100051,STCTY-41051 TRACT-    0051     IN PORTLAND OR,2708,1882,826,1264,85,0,13.59
G41005100052,STCTY-41051 TRACT-    0052     IN PORTLAND OR,4922,4839,83,4271,2,0,21.13
G41005100053,STCTY-41051 TRACT-    0053     IN PORTLAND OR,4134,4044,90,3470,10,0,16.69
G41005100054,STCTY-41051 TRACT-    0054     IN PORTLAND OR,3260,2514,746,1822,25,0,7.43
G41005100055,STCTY-41051 TRACT-    0055     IN PORTLAND OR,2911,2890,21,2526,1,3000,18.27
G41005100056,STCTY-41051 TRACT-    0056     IN PORTLAND OR,6311,6253,58,5439,0,3632,22.55
G41005100057,STCTY-41051 TRACT-    0057     IN PORTLAND OR,5359,5070,289,3815,33,2093,12.88
G41005100058,STCTY-41051 TRACT-    0058     IN PORTLAND OR,3101,3087,14,2573,3,5527,30.95
G41005100059,STCTY-41051 TRACT-    0059     IN PORTLAND OR,2987,2949,38,2391,30,2648,20.61
G41005100060,STCTY-41051 TRACT-    0060     IN PORTLAND OR,2108,2096,12,1841,0,3065,19.76
G42000300001,STCTY-42003 TRACT-    0001     IN PITTSBURGH PA ADJ AREA,504,487,17,445,17,0,0
G42000300001A,STCTY-42003 TRACT-    0001-A   IN PITTSBURGH PA,877,860,17,726,5,0,0
G42000300001B,STCTY-42003 TRACT-    0001-B   IN PITTSBURGH PA,8488,8346,142,6501,129,4179,26.75
G42000300002,STCTY-42003 TRACT-    0002     IN PITTSBURGH PA ADJ AREA,4716,4674,42,4365,42,5437,43.58
G42000300002A,STCTY-42003 TRACT-    0002-A   IN PITTSBURGH PA,718,717,1,540,0,0,0
G42000300002B,STCTY-42003 TRACT-    0002-B   IN PITTSBURGH PA,1398,1212,186,864,186,0,26.74
G42000300002C,STCTY-42003 TRACT-    0002-C   IN PITTSBURGH PA,627,627,0,448,0,0,22.46
G42000300002D,STCTY-42003 TRACT-    0002-D   IN PITTSBURGH PA,1187,1080,107,792,107,0,21.66
G42000300002E,STCTY-42003 TRACT-    0002-E   IN PITTSBURGH PA,561,211,350,174,350,0,15.65
G42000300003,STCTY-42003 TRACT-    0003     IN PITTSBURGH PA ADJ AREA,2196,2192,4,2048,4,3891,38.86
G42000300003A,STCTY-42003 TRACT-    0003-A   IN PITTSBURGH PA,2061,1097,964,797,964,0,23.74
G42000300003B,STCTY-42003 TRACT-    0003-B   IN PITTSBURGH PA,4223,2995,1228,2018,1215,4227,23.04
G42000300003C,STCTY-42003 TRACT-    0003-C   IN PITTSBURGH PA,5622,1643,3979,1037,3975,0,22.61
G42000300003D,STCTY-42003 TRACT-    0003-D   IN PITTSBURGH PA,5168,1563,3605,1004,3604,0,25.9
G42000300003E,STCTY-42003 TRACT-    0003-E   IN PITTSBURGH PA,4554,3252,1302,2096,1302,3090,26.09
G42000300004,STCTY-42003 TRACT-    0004     IN PITTSBURGH PA ADJ AREA,1705,1705,0,1601,0,5286,50.65
G42000300004A,STCTY-42003 TRACT-    0004-A   IN PITTSBURGH PA,2410,2234,176,1783,176,4029,23.77
G42000300004B,STCTY-42003 TRACT-    0004-B   IN PITTSBURGH PA,1608,1237,371,940,371,0,20.51
G42000300004C,STCTY-42003 TRACT-    0004-C   IN PITTSBURGH PA,2428,2422,6,2035,4,4952,40.33
G42000300004D,STCTY-42003 TRACT-    0004-D   IN PITTSBURGH PA,3578,3524,54,3267,53,20000,75.4
G42000300004E,STCTY-42003 TRACT-    0004-E   IN PITTSBURGH PA,1353,1314,39,1138,39,0,64.92
G42000300004F,STCTY-42003 TRACT-    0004-F   IN PITTSBURGH PA,7852,7819,33,6079,29,4857,38.59
G42000300004G,STCTY-42003 TRACT-    0004-G   IN PITTSBURGH PA,1354,1354,0,1054,0,0,41.85
G42000300004H,STCTY-42003 TRACT-    0004-H   IN PITTSBURGH PA,3939,3698,241,2864,241,3139,24.5
G42000300004I,STCTY-42003 TRACT-    0004-I   IN PITTSBURGH PA,3169,3144,25,2372,25,4139,36.56
G42000300005,STCTY-42003 TRACT-    0005     IN PITTSBURGH PA ADJ AREA,827,810,17,739,17,3278,37
G42000300005A,STCTY-42003 TRACT-    0005-A   IN PITTSBURGH PA,1345,134,1211,88,1211,0,30.72
G42000300005B,STCTY-42003 TRACT-    0005-B   IN PITTSBURGH PA,1112,377,735,325,735,0,30.71
G42000300005C,STCTY-42003 TRACT-    0005-C   IN PITTSBURGH PA,8379,1560,6819,931,6812,2923,26.64
G42000300005D,STCTY-42003 TRACT-    0005-D   IN PITTSBURGH PA,5603,250,5353,163,5352,3250,28.58
G42000300005E,STCTY-42003 TRACT-    0005-E   IN PITTSBURGH PA,2943,347,2596,231,2595,2625,32.35
G42000300005F,STCTY-42003 TRACT-    0005-F   IN PITTSBURGH PA,77,71,6,42,6,0,0
G42000300005G,STCTY-42003 TRACT-    0005-G   IN PITTSBURGH PA,1040,433,607,296,607,0,33.92
G42000300005H,STCTY-42003 TRACT-    0005-H   IN PITTSBURGH PA,811,331,480,243,480,0,33.53
G42000300005I,STCTY-42003 TRACT-    0005-I   IN PITTSBURGH PA,6071,3852,2219,3084,2216,4130,35.17
G42000300005J,STCTY-42003 TRACT-    0005-J   IN PITTSBURGH PA,1196,1170,26,1080,26,0,68.25
G42000300006,STCTY-42003 TRACT-    0006     IN PITTSBURGH PA ADJ AREA,1427,1381,46,1301,46,4274,38.96
G42000300006A,STCTY-42003 TRACT-    0006-A   IN PITTSBURGH PA,1730,842,888,637,887,0,20.32
G42000300006B,STCTY-42003 TRACT-    0006-B   IN PITTSBURGH PA,4012,3871,141,3163,141,1583,15.31
G42000300006C,STCTY-42003 TRACT-    0006-C   IN PITTSBURGH PA,5132,4703,429,3845,427,3621,22.05
G42000300006D,STCTY-42003 TRACT-    0006-D   IN PITTSBURGH PA,3429,3218,211,2807,211,3369,26.65
G42000300006E,STCTY-42003 TRACT-    0006-E   IN PITTSBURGH PA,2766,2409,357,2016,357,2913,19.06
G42000300007,STCTY-42003 TRACT-    0007     IN PITTSBURGH PA ADJ AREA,3898,3898,0,3543,0,3882,28.16
G42000300007A,STCTY-42003 TRACT-    0007-A   IN PITTSBURGH PA,1680,1650,30,1506,30,20000,75.41
G42000300007B,STCTY-42003 TRACT-    0007-B   IN PITTSBURGH PA,2243,2226,17,2116,17,0,63.67
G42000300007C,STCTY-42003 TRACT-    0007-C   IN PITTSBURGH PA,3587,3443,144,3164,141,8007,45.31
G42000300007D,STCTY-42003 TRACT-    0007-D   IN PITTSBURGH PA,1916,1743,173,1577,170,0,37.94
G42000300007E,STCTY-42003 TRACT-    0007-E   IN PITTSBURGH PA,2565,2535,30,2337,30,5881,51.85
G42000300007F,STCTY-42003 TRACT-    0007-F   IN PITTSBURGH PA,1920,1884,36,1746,36,9948,63.75
G42000300007G,STCTY-42003 TRACT-    0007-G   IN PITTSBURGH PA,2358,1903,455,1689,453,0,29.4
G42000300007H,STCTY-42003 TRACT-    0007-H   IN PITTSBURGH PA,1411,1373,38,1253,38,0,36.28
G42000300008,STCTY-42003 TRACT-    0008     IN PITTSBURGH PA ADJ AREA,2890,2745,145,2367,145,6479,16.49
G42000300008A,STCTY-42003 TRACT-    0008-A   IN PITTSBURGH PA,2956,2943,13,2568,13,5896,41.56
G42000300008B,STCTY-42003 TRACT-    0008-B   IN PITTSBURGH PA,5050,4810,240,3958,236,2910,24.22
G42000300008C,STCTY-42003 TRACT-    0008-C   IN PITTSBURGH PA,1447,1436,11,1294,11,0,52.02
G42000300008D,STCTY-42003 TRACT-    0008-D   IN PITTSBURGH PA,2181,2149,32,1981,31,3894,33.62
G42000300008E,STCTY-42003 TRACT-    0008-E   IN PITTSBURGH PA,1670,1653,17,1491,14,0,39.9
G42000300008F,STCTY-42003 TRACT-    0008-F   IN PITTSBURGH PA,3273,3261,12,2991,12,7287,43.89
G42000300008G,STCTY-42003 TRACT-    0008-G   IN PITTSBURGH PA,2357,2348,9,2177,6,9089,34.67
G42000300008H,STCTY-42003 TRACT-    0008-H   IN PITTSBURGH PA,2339,2008,331,1851,324,0,34.42
G42000300009,STCTY-42003 TRACT-    0009     IN PITTSBURGH PA ADJ AREA,950,949,1,865,1,5333,0
G42000300009A,STCTY-42003 TRACT-    0009-A   IN PITTSBURGH PA,6922,6738,184,5364,183,3127,23.23
G42000300009B,STCTY-42003 TRACT-    0009-B   IN PITTSBURGH PA,7226,7179,47,6211,45,3786,29.96
G42000300009C,STCTY-42003 TRACT-    0009-C   IN PITTSBURGH PA,4551,4398,153,3858,153,3331,30.2
G42000300010,STCTY-42003 TRACT-    0010     IN PITTSBURGH PA ADJ AREA,4242,4150,92,3927,92,6495,53.29
G42000300010A,STCTY-42003 TRACT-    0010-A   IN PITTSBURGH PA,8780,8739,41,7372,40,2655,23.97
G42000300010B,STCTY-42003 TRACT-    0010-B   IN PITTSBURGH PA,1350,1298,52,1099,52,2854,23.78
G42000300010C,STCTY-42003 TRACT-    0010-C   IN PITTSBURGH PA,933,933,0,829,0,5988,0
G42000300010D,STCTY-42003 TRACT-    0010-D   IN PITTSBURGH PA,5460,5332,128,4632,128,6087,50.38
G42000300010E,STCTY-42003 TRACT-    0010-E   IN PITTSBURGH PA,231,197,34,170,34,0,0
G42000300010F,STCTY-42003 TRACT-    0010-F   IN PITTSBURGH PA,8242,6692,1550,5847,1550,3194,31.61
G42000300011,STCTY-42003 TRACT-    0011     IN PITTSBURGH PA ADJ AREA,1947,1830,117,1717,111,4550,43.22
G42000300011A,STCTY-42003 TRACT-    0011-A   IN PITTSBURGH PA,28,27,1,26,1,0,0
G42000300011B,STCTY-42003 TRACT-    0011-B   IN PITTSBURGH PA,2067,2043,24,1579,24,9906,56.17
G42000300011C,STCTY-42003 TRACT-    0011-C   IN PITTSBURGH PA,3877,3828,49,3171,49,7161,55.29
G42000300011D,STCTY-42003 TRACT-    0011-D   IN PITTSBURGH PA,3254,3215,39,2859,39,10877,67.91
G42000300011E,STCTY-42003 TRACT-    0011-E   IN PITTSBURGH PA,271,242,29,224,29,0,0
G42000300011F,STCTY-42003 TRACT-    0011-F   IN PITTSBURGH PA,1672,1529,143,1281,143,3912,36.52
G42000300011G,STCTY-42003 TRACT-    0011-G   IN PITTSBURGH PA,2260,2257,3,1846,3,6577,44.61
G42000300011H,STCTY-42003 TRACT-    0011-H   IN PITTSBURGH PA,4366,4338,28,3547,28,5319,41.81
G42000300011I,STCTY-42003 TRACT-    0011-I   IN PITTSBURGH PA,3394,2818,576,2463,572,4257,39.76
G42000300011J,STCTY-42003 TRACT-    0011-J   IN PITTSBURGH PA,2672,2035,637,1716,636,0,33.68
G42000300012,STCTY-42003 TRACT-    0012     IN PITTSBURGH PA ADJ AREA,2225,2225,0,2115,0,5731,50.2
G42000300012A,STCTY-42003 TRACT-    0012-A   IN PITTSBURGH PA,1341,1272,69,1162,69,4600,36.09
G42000300012B,STCTY-42003 TRACT-    0012-B   IN PITTSBURGH PA,3308,3044,264,2609,264,4037,36.56
G42000300012C,STCTY-42003 TRACT-    0012-C   IN PITTSBURGH PA,4942,4351,591,3645,591,3836,34.11
G42000300012D,STCTY-42003 TRACT-    0012-D   IN PITTSBURGH PA,7263,5017,2246,3822,2246,3553,28.15
G42000300012E,STCTY-42003 TRACT-    0012-E   IN PITTSBURGH PA,4525,3118,1407,2335,1406,3623,27.1
G42000300012F,STCTY-42003 TRACT-    0012-F   IN PITTSBURGH PA,1657,1145,512,985,510,0,33.43
G42000300012G,STCTY-42003 TRACT-    0012-G   IN PITTSBURGH PA,2498,2351,147,2079,146,3550,35.28
G42000300012H,STCTY-42003 TRACT-    0012-H   IN PITTSBURGH PA,1960,1851,109,1689,109,4227,36.76
G42000300013,STCTY-42003 TRACT-    0013     IN PITTSBURGH PA ADJ AREA,2074,2064,10,1974,10,6356,51.3
G42000300013A,STCTY-42003 TRACT-    0013-A   IN PITTSBURGH PA,4720,3946,774,3455,766,3558,35.66
G42000300013B,STCTY-42003 TRACT-    0013-B   IN PITTSBURGH PA,5668,4875,793,4205,793,4538,34
G42000300013C,STCTY-42003 TRACT-    0013-C   IN PITTSBURGH PA,7017,5808,1209,5257,1207,4338,34.74
G42000300013D,STCTY-42003 TRACT-    0013-D   IN PITTSBURGH PA,5966,5326,640,4803,639,4122,36.69
G42000300013E,STCTY-42003 TRACT-    0013-E   IN PITTSBURGH PA,3399,2677,722,2217,721,3269,30.2
G42000300013F,STCTY-42003 TRACT-    0013-F   IN PITTSBURGH PA,3648,2668,980,2265,973,3821,33.48
G42000300013Z,STCTY-42003 TRACT-    0013-Z   IN PITTSBURGH PA,227,227,0,199,0,0,0
G42000300014,STCTY-42003 TRACT-    0014     IN PITTSBURGH PA ADJ AREA,2516,2371,145,2275,145,8177,47.45
G42000300014A,STCTY-42003 TRACT-    0014-A   IN PITTSBURGH PA,3789,3656,133,3242,131,20000,85.58
G42000300014B,STCTY-42003 TRACT-    0014-B   IN PITTSBURGH PA,1532,1437,95,1305,95,18819,0
G42000300014C,STCTY-42003 TRACT-    0014-C   IN PITTSBURGH PA,4880,4821,59,4321,59,13628,77.76
G42000300014D,STCTY-42003 TRACT-    0014-D   IN PITTSBURGH PA,3071,3003,68,2710,68,12727,65.99
G42000300014E,STCTY-42003 TRACT-    0014-E   IN PITTSBURGH PA,3518,3384,134,3175,128,9722,63.36
G42000300014F,STCTY-42003 TRACT-    0014-F   IN PITTSBURGH PA,4610,4573,37,4290,36,10884,58.43
G42000300014G,STCTY-42003 TRACT-    0014-G   IN PITTSBURGH PA,7804,7710,94,5924,93,9724,69.02
G42000300014H,STCTY-42003 TRACT-    0014-H   IN PITTSBURGH PA,6811,6752,59,4980,59,9245,66.56
G42000300014I,STCTY-42003 TRACT-    0014-I   IN PITTSBURGH PA,4999,4988,11,4154,11,9284,67.09
G42000300014J,STCTY-42003 TRACT-    0014-J   IN PITTSBURGH PA,1494,1494,0,1417,0,8054,62
G42000300014K,STCTY-42003 TRACT-    0014-K   IN PITTSBURGH PA,1338,1338,0,1155,0,4202,38.41
G42000300015,STCTY-42003 TRACT-    0015     IN PITTSBURGH PA ADJ AREA,393,388,5,379,5,0,0
G42000300015A,STCTY-42003 TRACT-    0015-A   IN PITTSBURGH PA,6726,6608,118,5394,118,5937,51.17
G42000300015B,STCTY-42003 TRACT-    0015-B   IN PITTSBURGH PA,6250,6249,1,5320,1,4130,35.59
G42000300015C,STCTY-42003 TRACT-    0015-C   IN PITTSBURGH PA,2950,2604,346,2228,346,2951,27.03
G42000300015D,STCTY-42003 TRACT-    0015-D   IN PITTSBURGH PA,4706,4436,270,3614,270,3082,24.16
G42000300015E,STCTY-42003 TRACT-    0015-E   IN PITTSBURGH PA,9787,9406,381,7853,380,3913,29.13
G42000300016,STCTY-42003 TRACT-    0016     IN PITTSBURGH PA ADJ AREA,5966,5677,289,4876,289,5936,21.14
G42000300016A,STCTY-42003 TRACT-    0016-A   IN PITTSBURGH PA,8495,8244,251,6699,251,2806,22.26
G42000300016B,STCTY-42003 TRACT-    0016-B   IN PITTSBURGH PA,7681,7680,1,6639,0,2161,20.75
G42000300016C,STCTY-42003 TRACT-    0016-C   IN PITTSBURGH PA,9650,9645,5,8368,5,2688,22.31
G42000300017,STCTY-42003 TRACT-    0017     IN PITTSBURGH PA ADJ AREA,2162,2162,0,1854,0,3540,27.04
G42000300017A,STCTY-42003 TRACT-    0017-A   IN PITTSBURGH PA,1820,1725,95,1336,95,0,18.6
G42000300017B,STCTY-42003 TRACT-    0017-B   IN PITTSBURGH PA,12638,12550,88,10099,85,2697,20.83
G42000300017C,STCTY-42003 TRACT-    0017-C   IN PITTSBURGH PA,6711,6624,87,5818,87,2145,19.91
G42000300018,STCTY-42003 TRACT-    0018     IN PITTSBURGH PA ADJ AREA,3081,2832,249,2384,249,2466,22.49
G42000300018A,STCTY-42003 TRACT-    0018-A   IN PITTSBURGH PA,4765,4557,208,4165,208,4978,37.13
G42000300018B,STCTY-42003 TRACT-    0018-B   IN PITTSBURGH PA,3340,3329,11,2961,11,2457,25.61
G42000300018C,STCTY-42003 TRACT-    0018-C   IN PITTSBURGH PA,4617,4611,6,4242,5,3279,30.13
G42000300018D,STCTY-42003 TRACT-    0018-D   IN PITTSBURGH PA,8579,7276,1303,6455,1301,3257,30.99
G42000300018E,STCTY-42003 TRACT-    0018-E   IN PITTSBURGH PA,728,726,2,608,2,0,0
G42000300019,STCTY-42003 TRACT-    0019     IN PITTSBURGH PA ADJ AREA,3319,3297,22,3049,22,2972,29.6
G42000300019A,STCTY-42003 TRACT-    0019-A   IN PITTSBURGH PA,4910,4744,166,4306,165,3465,30.5
G42000300019B,STCTY-42003 TRACT-    0019-B   IN PITTSBURGH PA,2593,2592,1,2408,1,4650,36.3
G42000300019C,STCTY-42003 TRACT-    0019-C   IN PITTSBURGH PA,2029,2027,2,1877,2,4167,54.5
G42000300019D,STCTY-42003 TRACT-    0019-D   IN PITTSBURGH PA,6927,6724,203,5895,202,3150,31.31
G42000300019E,STCTY-42003 TRACT-    0019-E   IN PITTSBURGH PA,4094,4094,0,3677,0,3862,35.96
G42000300019F,STCTY-42003 TRACT-    0019-F   IN PITTSBURGH PA,5755,5688,67,4959,65,4615,41.55
G42000300019G,STCTY-42003 TRACT-    0019-G   IN PITTSBURGH PA,4420,4418,2,3992,2,5116,45.63
G42000300019H,STCTY-42003 TRACT-    0019-H   IN PITTSBURGH PA,10415,10408,7,9600,4,6102,51.55
G42000300019I,STCTY-42003 TRACT-    0019-I   IN PITTSBURGH PA,2256,2248,8,2031,8,4828,43.98
G42000300020,STCTY-42003 TRACT-    0020     IN PITTSBURGH PA ADJ AREA,1601,1530,71,1181,68,0,22.58
G42000300020A,STCTY-42003 TRACT-    0020-A   IN PITTSBURGH PA,1599,1599,0,1314,0,3179,25.61
G42000300020B,STCTY-42003 TRACT-    0020-B   IN PITTSBURGH PA,1785,1785,0,1676,0,4878,41.66
G42000300020C,STCTY-42003 TRACT-    0020-C   IN PITTSBURGH PA,2232,2177,55,2030,55,4717,39.29
G42000300020D,STCTY-42003 TRACT-    0020-D   IN PITTSBURGH PA,2193,2184,9,2009,9,4740,43.22
G42000300020E,STCTY-42003 TRACT-    0020-E   IN PITTSBURGH PA,3626,3600,26,3272,26,3342,29.24
G42000300020F,STCTY-42003 TRACT-    0020-F   IN PITTSBURGH PA,755,732,23,683,23,0,30.99
G42000300020G,STCTY-42003 TRACT-    0020-G   IN PITTSBURGH PA,3645,3516,129,3188,129,3335,28.94
G42000300020H,STCTY-42003 TRACT-    0020-H   IN PITTSBURGH PA,3154,3135,19,2839,19,3785,31.51
G42000300020I,STCTY-42003 TRACT-    0020-I   IN PITTSBURGH PA,1384,1275,109,1110,109,0,20.98
G42000300020J,STCTY-42003 TRACT-    0020-J   IN PITTSBURGH PA,1932,1746,186,1519,186,2409,22.56
G42000300020K,STCTY-42003 TRACT-    0020-K   IN PITTSBURGH PA,450,407,43,375,43,0,0
G42000300020L,STCTY-42003 TRACT-    0020-L   IN PITTSBURGH PA,1840,1812,28,1641,28,3870,26.14
G42000300021,STCTY-42003 TRACT-    0021     IN PITTSBURGH PA ADJ AREA,4678,3403,1275,2537,1274,0,16.48
G42000300021A,STCTY-42003 TRACT-    0021-A   IN PITTSBURGH PA,3043,2710,333,2271,324,3645,23.21
G42000300021B,STCTY-42003 TRACT-    0021-B   IN PITTSBURGH PA,4796,4258,538,3637,538,3259,25.69
G42000300021C,STCTY-42003 TRACT-    0021-C   IN PITTSBURGH PA,2254,2220,34,1949,34,3104,26.05
G42000300021D,STCTY-42003 TRACT-    0021-D   IN PITTSBURGH PA,5613,4788,825,4264,824,4400,25.08
G42000300021E,STCTY-42003 TRACT-    0021-E   IN PITTSBURGH PA,1176,1155,21,1060,21,0,28.55
G42000300021F,STCTY-42003 TRACT-    0021-F   IN PITTSBURGH PA,5444,4855,589,4066,589,3143,25.62
G42000300022,STCTY-42003 TRACT-    0022     IN PITTSBURGH PA ADJ AREA,1455,1271,184,1076,183,0,30.17
G42000300022A,STCTY-42003 TRACT-    0022-A   IN PITTSBURGH PA,3309,3218,91,2951,89,0,21.21
G42000300022B,STCTY-42003 TRACT-    0022-B   IN PITTSBURGH PA,5301,5129,172,4652,171,4320,21.61
G42000300022C,STCTY-42003 TRACT-    0022-C   IN PITTSBURGH PA,1988,1927,61,1750,57,0,24.03
G42000300022D,STCTY-42003 TRACT-    0022-D   IN PITTSBURGH PA,1155,1147,8,1021,6,0,18.39
G42000300022E,STCTY-42003 TRACT-    0022-E   IN PITTSBURGH PA,3238,3214,24,2912,5,0,17.02
G42000300022F,STCTY-42003 TRACT-    0022-F   IN PITTSBURGH PA,1018,842,176,726,176,0,27.07
G42000300022G,STCTY-42003 TRACT-    0022-G   IN PITTSBURGH PA,1421,1412,9,1182,6,0,19.74
G42000300023,STCTY-42003 TRACT-    0023     IN PITTSBURGH PA ADJ AREA,2583,2493,90,1960,90,2917,22.27
G42000300023A,STCTY-42003 TRACT-    0023-A   IN PITTSBURGH PA,6583,6562,21,5675,19,2695,20.71
G42000300023B,STCTY-42003 TRACT-    0023-B   IN PITTSBURGH PA,6677,6601,76,5709,73,3611,21.61
G42000300023C,STCTY-42003 TRACT-    0023-C   IN PITTSBURGH PA,3263,3263,0,2651,0,0,17.31
G42000300024,STCTY-42003 TRACT-    0024     IN PITTSBURGH PA ADJ AREA,2105,1949,156,1634,153,4552,32.94
G42000300024A,STCTY-42003 TRACT-    0024-A   IN PITTSBURGH PA,6911,6879,32,5962,32,2768,22.13
G42000300024B,STCTY-42003 TRACT-    0024-B   IN PITTSBURGH PA,4735,4735,0,4046,0,2452,22.57
G42000300024C,STCTY-42003 TRACT-    0024-C   IN PITTSBURGH PA,3683,3683,0,3203,0,2924,24.3
G42000300025,STCTY-42003 TRACT-    0025     IN PITTSBURGH PA ADJ AREA,2025,1844,181,1496,181,3438,27.28
G42000300025A,STCTY-42003 TRACT-    0025-A   IN PITTSBURGH PA,4230,4001,229,3648,229,3281,29.84
G42000300025B,STCTY-42003 TRACT-    0025-B   IN PITTSBURGH PA,8550,7336,1214,6461,1212,3254,25.72
G42000300025C,STCTY-42003 TRACT-    0025-C   IN PITTSBURGH PA,1654,1628,26,1502,25,3345,30.93
G42000300025D,STCTY-42003 TRACT-    0025-D   IN PITTSBURGH PA,2306,1931,375,1728,375,2483,23.18
G42000300026,STCTY-42003 TRACT-    0026     IN PITTSBURGH PA ADJ AREA,3879,3595,284,3129,284,3723,30.42
G42000300026A,STCTY-42003 TRACT-    0026-A   IN PITTSBURGH PA,2341,2129,212,1936,212,4883,35.35
G42000300026B,STCTY-42003 TRACT-    0026-B   IN PITTSBURGH PA,2172,2167,5,2019,5,6282,46.55
G42000300026C,STCTY-42003 TRACT-    0026-C   IN PITTSBURGH PA,1287,1286,1,1149,1,4672,30.98
G42000300026D,STCTY-42003 TRACT-    0026-D   IN PITTSBURGH PA,1029,1029,0,979,0,6136,42.17
G42000300026E,STCTY-42003 TRACT-    0026-E   IN PITTSBURGH PA,1294,1294,0,1161,0,3556,34.35
G42000300026F,STCTY-42003 TRACT-    0026-F   IN PITTSBURGH PA,1650,1649,1,1538,1,8553,52.25
G42000300026G,STCTY-42003 TRACT-    0026-G   IN PITTSBURGH PA,1166,965,201,866,201,4222,25.79
G42000300026H,STCTY-42003 TRACT-    0026-H   IN PITTSBURGH PA,4133,3783,350,3471,350,4568,32.59
G42000300026I,STCTY-42003 TRACT-    0026-I   IN PITTSBURGH PA,2946,2918,28,2659,28,4430,37.74
G42000300026J,STCTY-42003 TRACT-    0026-J   IN PITTSBURGH PA,1904,1819,85,1649,85,3267,28.88
G42000300026K,STCTY-42003 TRACT-    0026-K   IN PITTSBURGH PA,4200,4200,0,3691,0,2733,23.49
G42000300026Y,STCTY-42003 TRACT-    0026-Y   IN PITTSBURGH PA,59,59,0,49,0,0,0
G42000300026Z,STCTY-42003 TRACT-    0026-Z   IN PITTSBURGH PA,801,801,0,744,0,5239,0
G42000300027,STCTY-42003 TRACT-    0027     IN PITTSBURGH PA ADJ AREA,1847,1497,350,1239,350,2611,21
G42000300027A,STCTY-42003 TRACT-    0027-A   IN PITTSBURGH PA,4092,4029,63,3752,63,6865,49.59
G42000300027B,STCTY-42003 TRACT-    0027-B   IN PITTSBURGH PA,3722,3702,20,3316,20,6448,47.3
G42000300027C,STCTY-42003 TRACT-    0027-C   IN PITTSBURGH PA,3681,3678,3,3315,3,5169,35.53
G42000300027D,STCTY-42003 TRACT-    0027-D   IN PITTSBURGH PA,3916,3471,445,2696,443,3316,20.26
G42000300027E,STCTY-42003 TRACT-    0027-E   IN PITTSBURGH PA,6804,6804,0,5692,0,3379,26.13
G42000300027F,STCTY-42003 TRACT-    0027-F   IN PITTSBURGH PA,2147,2147,0,1772,0,2939,23.24
G42000300027G,STCTY-42003 TRACT-    0027-G   IN PITTSBURGH PA,3038,3010,28,2502,28,4681,28.73
G42000300028,STCTY-42003 TRACT-    0028     IN PITTSBURGH PA ADJ AREA,374,374,0,356,0,0,0
G42000300028A,STCTY-42003 TRACT-    0028-A   IN PITTSBURGH PA,1558,1435,123,1298,123,5239,32.1
G42000300028B,STCTY-42003 TRACT-    0028-B   IN PITTSBURGH PA,1676,1670,6,1506,6,5167,42.31
G42000300028C,STCTY-42003 TRACT-    0028-C   IN PITTSBURGH PA,1358,1358,0,1283,0,4481,45.35
G42000300028D,STCTY-42003 TRACT-    0028-D   IN PITTSBURGH PA,1536,1511,25,1407,24,5783,41.84
G42000300028E,STCTY-42003 TRACT-    0028-E   IN PITTSBURGH PA,1827,1776,51,1586,51,3771,26.86
G42000300028F,STCTY-42003 TRACT-    0028-F   IN PITTSBURGH PA,1166,1132,34,1024,34,4560,39.78
G42000300029,STCTY-42003 TRACT-    0029     IN PITTSBURGH PA ADJ AREA,7552,7551,1,6958,1,6332,52.01
G42000300029A,STCTY-42003 TRACT-    0029-A   IN PITTSBURGH PA,4080,4076,4,3728,3,4378,33.64
G42000300029B,STCTY-42003 TRACT-    0029-B   IN PITTSBURGH PA,6691,6690,1,6149,1,4938,40.3
G42000300029C,STCTY-42003 TRACT-    0029-C   IN PITTSBURGH PA,5929,5929,0,5466,0,5253,40.18
G42000300030,STCTY-42003 TRACT-    0030     IN PITTSBURGH PA ADJ AREA,1692,1685,7,1400,7,4017,30.36
G42000300030A,STCTY-42003 TRACT-    0030-A   IN PITTSBURGH PA,7898,7891,7,7238,6,4956,38.64
G42000300031,STCTY-42003 TRACT-    0031     IN PITTSBURGH PA ADJ AREA,2767,2692,75,2209,75,4051,27.35
G42000300031A,STCTY-42003 TRACT-    0031-A   IN PITTSBURGH PA,2238,2225,13,1948,13,2845,25.47
G42000300031B,STCTY-42003 TRACT-    0031-B   IN PITTSBURGH PA,3249,3245,4,3022,0,3793,33.52
G42000300031C,STCTY-42003 TRACT-    0031-C   IN PITTSBURGH PA,689,479,210,376,210,0,0
G42000300032,STCTY-42003 TRACT-    0032     IN PITTSBURGH PA ADJ AREA,2366,2358,8,2016,8,3309,30.7
G42000300032A,STCTY-42003 TRACT-    0032-A   IN PITTSBURGH PA,1452,1452,0,1325,0,5044,37.06
G42000300032B,STCTY-42003 TRACT-    0032-B   IN PITTSBURGH PA,2343,2343,0,2139,0,4680,47.7
G42000300032C,STCTY-42003 TRACT-    0032-C   IN PITTSBURGH PA,2173,2143,30,1999,30,5398,44.23
G42000300032Z,STCTY-42003 TRACT-    0032-Z   IN PITTSBURGH PA,314,314,0,281,0,0,0
G42000300033,STCTY-42003 TRACT-    0033     IN PITTSBURGH PA ADJ AREA,2656,2501,155,2130,155,3375,30.13
G42000300034,STCTY-42003 TRACT-    0034     IN PITTSBURGH PA ADJ AREA,1943,1932,11,1590,10,3635,27.16
G42000300035,STCTY-42003 TRACT-    0035     IN PITTSBURGH PA ADJ AREA,1836,1590,246,1291,238,4342,22.61
G42000300036,STCTY-42003 TRACT-    0036     IN PITTSBURGH PA ADJ AREA,1366,1362,4,1243,4,4567,35.93
G42000300037,STCTY-42003 TRACT-    0037     IN PITTSBURGH PA ADJ AREA,2496,2496,0,2225,0,4491,35.04
G42000300038,STCTY-42003 TRACT-    0038     IN PITTSBURGH PA ADJ AREA,2059,2059,0,1789,0,4238,19.27
G42000300039,STCTY-42003 TRACT-    0039     IN PITTSBURGH PA ADJ AREA,882,882,0,789,0,5263,0
G42000300040,STCTY-42003 TRACT-    0040     IN PITTSBURGH PA ADJ AREA,1029,1018,11,906,11,0,34.61
G42000300041,STCTY-42003 TRACT-    0041     IN PITTSBURGH PA ADJ AREA,1372,1372,0,1023,0,2656,22.87
G42000300042,STCTY-42003 TRACT-    0042     IN PITTSBURGH PA ADJ AREA,1241,1241,0,1119,0,4853,35.75
G42000300043,STCTY-42003 TRACT-    0043     IN PITTSBURGH PA ADJ AREA,1808,1581,227,1487,227,3295,35.38
G42000300044,STCTY-42003 TRACT-    0044     IN PITTSBURGH PA ADJ AREA,2807,2807,0,2320,0,3582,29.38
G42000300045,STCTY-42003 TRACT-    0045     IN PITTSBURGH PA ADJ AREA,3395,2209,1186,1556,1186,2798,25.63
G42000300046,STCTY-42003 TRACT-    0046     IN PITTSBURGH PA ADJ AREA,3302,2840,462,2287,462,4042,26.59
G42000300047,STCTY-42003 TRACT-    0047     IN PITTSBURGH PA ADJ AREA,499,499,0,436,0,0,0
G42000300048,STCTY-42003 TRACT-    0048     IN PITTSBURGH PA ADJ AREA,2909,2488,421,2051,421,3177,25.47
G42000300049,STCTY-42003 TRACT-    0049     IN PITTSBURGH PA ADJ AREA,1661,1633,28,1458,28,4234,0
G42000300050,STCTY-42003 TRACT-    0050     IN PITTSBURGH PA ADJ AREA,7685,7396,289,5521,289,2539,20.87
G42000300051,STCTY-42003 TRACT-    0051     IN PITTSBURGH PA ADJ AREA,1301,871,430,707,430,0,23.25
G42000300052,STCTY-42003 TRACT-    0052     IN PITTSBURGH PA ADJ AREA,2653,2473,180,2113,180,3795,34.72
G42000300053,STCTY-42003 TRACT-    0053     IN PITTSBURGH PA ADJ AREA,2277,2115,162,1782,160,3636,30.26
G42000300054,STCTY-42003 TRACT-    0054     IN PITTSBURGH PA ADJ AREA,2417,2414,3,2205,3,5186,39.96
G42000300055,STCTY-42003 TRACT-    0055     IN PITTSBURGH PA ADJ AREA,2438,2321,117,1996,117,4326,40.91
G42000300056,STCTY-42003 TRACT-    0056     IN PITTSBURGH PA ADJ AREA,1971,1968,3,1876,2,6341,47.17
G42000300057,STCTY-42003 TRACT-    0057     IN PITTSBURGH PA ADJ AREA,1704,1691,13,1625,12,7034,56.58
G42000300058,STCTY-42003 TRACT-    0058     IN PITTSBURGH PA ADJ AREA,833,828,5,783,5,7066,0
G42000300059,STCTY-42003 TRACT-    0059     IN PITTSBURGH PA ADJ AREA,1562,1556,6,1500,6,6445,48.34
G42000300060,STCTY-42003 TRACT-    0060     IN PITTSBURGH PA ADJ AREA,1093,1056,37,997,37,5700,46.69
G42000300061,STCTY-42003 TRACT-    0061     IN PITTSBURGH PA ADJ AREA,1482,1466,16,1377,16,2898,22.19
G42000300062,STCTY-42003 TRACT-    0062     IN PITTSBURGH PA ADJ AREA,3559,3555,4,3322,4,6965,57.88
G42000300063,STCTY-42003 TRACT-    0063     IN PITTSBURGH PA ADJ AREA,3404,3404,0,3190,0,7533,61.89
G42000300064,STCTY-42003 TRACT-    0064     IN PITTSBURGH PA ADJ AREA,3150,3139,11,2915,1,5782,53.16
G42000300065,STCTY-42003 TRACT-    0065     IN PITTSBURGH PA ADJ AREA,2861,2856,5,2664,1,5493,65.56
G42000300066,STCTY-42003 TRACT-    0066     IN PITTSBURGH PA ADJ AREA,2277,2270,7,2163,7,3633,32.19
G42000300067,STCTY-42003 TRACT-    0067     IN PITTSBURGH PA ADJ AREA,1121,1121,0,884,0,5083,27.74
G42000300068,STCTY-42003 TRACT-    0068     IN PITTSBURGH PA ADJ AREA,4290,4186,104,3358,102,3613,27.67
G42000300069,STCTY-42003 TRACT-    0069     IN PITTSBURGH PA ADJ AREA,2902,1819,1083,1179,1083,0,20.06
G42000300070,STCTY-42003 TRACT-    0070     IN PITTSBURGH PA ADJ AREA,2384,2384,0,2074,0,4039,31.89
G42000300071,STCTY-42003 TRACT-    0071     IN PITTSBURGH PA ADJ AREA,2087,2073,14,1715,14,3823,30.39
G42000300072,STCTY-42003 TRACT-    0072     IN PITTSBURGH PA ADJ AREA,1518,1473,45,1151,45,4717,27.3
G42000300073,STCTY-42003 TRACT-    0073     IN PITTSBURGH PA ADJ AREA,2665,2615,50,2031,50,4081,26.49
G42000300074,STCTY-42003 TRACT-    0074     IN PITTSBURGH PA ADJ AREA,3726,3317,409,2465,409,2393,18.83
G42000300075,STCTY-42003 TRACT-    0075     IN PITTSBURGH PA ADJ AREA,3516,3384,132,2575,132,2023,19.71
G42000300076,STCTY-42003 TRACT-    0076     IN PITTSBURGH PA ADJ AREA,1272,1272,0,1129,0,3500,31.44
G42000300077,STCTY-42003 TRACT-    0077     IN PITTSBURGH PA ADJ AREA,1754,1747,7,1593,7,4690,29.92
G42000300078,STCTY-42003 TRACT-    0078     IN PITTSBURGH PA ADJ AREA,1102,1021,81,827,81,0,23.07
G42000300079,STCTY-42003 TRACT-    0079     IN PITTSBURGH PA ADJ AREA,3141,3141,0,2670,0,4330,29.29
G42000300080,STCTY-42003 TRACT-    0080     IN PITTSBURGH PA ADJ AREA,1836,1826,10,1384,4,0,27.67
G42000300081,STCTY-42003 TRACT-    0081     IN PITTSBURGH PA ADJ AREA,2402,2400,2,2252,2,7957,58.07
G42000300082,STCTY-42003 TRACT-    0082     IN PITTSBURGH PA ADJ AREA,2295,2267,28,2112,28,8246,52.9
G42000300083,STCTY-42003 TRACT-    0083     IN PITTSBURGH PA ADJ AREA,1696,1601,95,1377,94,10000,50.86
G42000300084,STCTY-42003 TRACT-    0084     IN PITTSBURGH PA ADJ AREA,2976,2788,188,2639,187,3833,29.19
G42000300085,STCTY-42003 TRACT-    0085     IN PITTSBURGH PA ADJ AREA,7831,7338,493,6543,493,1578,16.06
G42000300086,STCTY-42003 TRACT-    0086     IN PITTSBURGH PA ADJ AREA,2765,2762,3,2601,1,4635,40.85
G42000300087,STCTY-42003 TRACT-    0087     IN PITTSBURGH PA ADJ AREA,970,969,1,857,1,2869,22.43
G42000300088,STCTY-42003 TRACT-    0088     IN PITTSBURGH PA ADJ AREA,1424,1424,0,1214,0,3208,28.28
G42000300089,STCTY-42003 TRACT-    0089     IN PITTSBURGH PA ADJ AREA,1733,1733,0,1400,0,2688,22.5
G42000300090,STCTY-42003 TRACT-    0090     IN PITTSBURGH PA ADJ AREA,1713,1713,0,1585,0,3733,33.57
G42000300091,STCTY-42003 TRACT-    0091     IN PITTSBURGH PA ADJ AREA,1383,1382,1,1254,1,3606,26.55
G42000300092,STCTY-42003 TRACT-    0092     IN PITTSBURGH PA ADJ AREA,1506,1506,0,1414,0,1750,19.83
G42000300093,STCTY-42003 TRACT-    0093     IN PITTSBURGH PA ADJ AREA,3252,3190,62,2910,62,1728,17.43
G42000300094,STCTY-42003 TRACT-    0094     IN PITTSBURGH PA ADJ AREA,5248,5240,8,4681,6,6646,47.85
G42000300095,STCTY-42003 TRACT-    0095     IN PITTSBURGH PA ADJ AREA,3991,3832,159,3385,159,1525,15.57
G42000300096,STCTY-42003 TRACT-    0096     IN PITTSBURGH PA ADJ AREA,1525,1521,4,1473,4,2525,0
G42000300097,STCTY-42003 TRACT-    0097     IN PITTSBURGH PA ADJ AREA,1521,1502,19,1300,19,2450,18.6
G42000300098,STCTY-42003 TRACT-    0098     IN PITTSBURGH PA ADJ AREA,1001,973,28,873,28,4854,36.1
G42000300099,STCTY-42003 TRACT-    0099     IN PITTSBURGH PA ADJ AREA,2333,2332,1,1958,1,3331,27.04
G42000300100,STCTY-42003 TRACT-    0100     IN PITTSBURGH PA ADJ AREA,202,202,0,176,0,0,0
G42000300101,STCTY-42003 TRACT-    0101     IN PITTSBURGH PA ADJ AREA,5212,5201,11,4339,11,2926,24.11
G42000300102,STCTY-42003 TRACT-    0102     IN PITTSBURGH PA ADJ AREA,911,901,10,827,10,2276,28.02
G42000300103,STCTY-42003 TRACT-    0103     IN PITTSBURGH PA ADJ AREA,1880,1871,9,1734,9,6168,34.17
G42000300104,STCTY-42003 TRACT-    0104     IN PITTSBURGH PA ADJ AREA,3364,3362,2,3139,2,3429,27.8
G42000300105,STCTY-42003 TRACT-    0105     IN PITTSBURGH PA ADJ AREA,3157,3150,7,2552,7,1579,24.07
G42000300106,STCTY-42003 TRACT-    0106     IN PITTSBURGH PA ADJ AREA,13161,13031,130,11343,128,2766,23.01
G42000300107,STCTY-42003 TRACT-    0107     IN PITTSBURGH PA ADJ AREA,169,169,0,157,0,0,0
G42000300108,STCTY-42003 TRACT-    0108     IN PITTSBURGH PA ADJ AREA,2239,2085,154,1757,152,3493,20.56
G42000300109,STCTY-42003 TRACT-    0109     IN PITTSBURGH PA ADJ AREA,1674,1644,30,1329,30,0,24.04
G42000300110,STCTY-42003 TRACT-    0110     IN PITTSBURGH PA ADJ AREA,2017,1887,130,1436,130,3317,24.73
G42000300111,STCTY-42003 TRACT-    0111     IN PITTSBURGH PA ADJ AREA,3145,1870,1275,1328,1275,0,19.89
G42000300112,STCTY-42003 TRACT-    0112     IN PITTSBURGH PA ADJ AREA,1812,1028,784,801,784,0,23.7
G42000300113,STCTY-42003 TRACT-    0113     IN PITTSBURGH PA ADJ AREA,2131,1925,206,1517,206,3069,33.9
G42000300114,STCTY-42003 TRACT-    0114     IN PITTSBURGH PA ADJ AREA,3182,2954,228,2390,228,3140,33.1
G42000300115,STCTY-42003 TRACT-    0115     IN PITTSBURGH PA ADJ AREA,1195,736,459,613,457,0,31.29
G42000300116,STCTY-42003 TRACT-    0116     IN PITTSBURGH PA ADJ AREA,1218,1172,46,992,46,0,36.76
G42000300117,STCTY-42003 TRACT-    0117     IN PITTSBURGH PA ADJ AREA,852,831,21,736,20,0,31.04
G42000300118,STCTY-42003 TRACT-    0118     IN PITTSBURGH PA ADJ AREA,1815,1606,209,1356,209,0,30.17
G42000300119,STCTY-42003 TRACT-    0119     IN PITTSBURGH PA ADJ AREA,3723,3582,141,3091,140,3406,16.94
G42000300120,STCTY-42003 TRACT-    0120     IN PITTSBURGH PA ADJ AREA,2151,2140,11,2056,10,5560,52.37
G42000300121,STCTY-42003 TRACT-    0121     IN PITTSBURGH PA ADJ AREA,1753,1744,9,1624,9,4738,42.57
G42000300122,STCTY-42003 TRACT-    0122     IN PITTSBURGH PA ADJ AREA,3864,3696,168,3376,168,2690,16.37
G42000300123,STCTY-42003 TRACT-    0123     IN PITTSBURGH PA ADJ AREA,1721,1699,22,1577,22,3714,22.13
G42000300124,STCTY-42003 TRACT-    0124     IN PITTSBURGH PA ADJ AREA,1778,1776,2,1571,2,2711,27.5
G42000300125,STCTY-42003 TRACT-    0125     IN PITTSBURGH PA ADJ AREA,1772,1728,44,1296,44,0,0
G42000300126,STCTY-42003 TRACT-    0126     IN PITTSBURGH PA ADJ AREA,1326,1320,6,1123,6,3319,31.02
G42000300127,STCTY-42003 TRACT-    0127     IN PITTSBURGH PA ADJ AREA,2332,2223,109,1802,108,3372,29.05
G42000300128,STCTY-42003 TRACT-    0128     IN PITTSBURGH PA ADJ AREA,1084,1073,11,927,11,3191,0
G42000300129,STCTY-42003 TRACT-    0129     IN PITTSBURGH PA ADJ AREA,1015,997,18,922,18,0,0
G42000300130,STCTY-42003 TRACT-    0130     IN PITTSBURGH PA ADJ AREA,3494,3476,18,3254,18,5625,41.1
G42000300131,STCTY-42003 TRACT-    0131     IN PITTSBURGH PA ADJ AREA,889,853,36,703,36,0,16.74
G42000300132,STCTY-42003 TRACT-    0132     IN PITTSBURGH PA ADJ AREA,1974,1965,9,1653,9,3264,27.22
G42000300133,STCTY-42003 TRACT-    0133     IN PITTSBURGH PA ADJ AREA,1621,1260,361,984,358,0,23.13
G42000300134,STCTY-42003 TRACT-    0134     IN PITTSBURGH PA ADJ AREA,3100,3097,3,2410,2,3148,25.15
G42000300135,STCTY-42003 TRACT-    0135     IN PITTSBURGH PA ADJ AREA,4846,4844,2,3421,0,3077,17.22
G42000300136,STCTY-42003 TRACT-    0136     IN PITTSBURGH PA ADJ AREA,885,885,0,770,0,0,30.33
G42000300137,STCTY-42003 TRACT-    0137     IN PITTSBURGH PA ADJ AREA,2664,2664,0,2403,0,4720,35.38
G42000300138,STCTY-42003 TRACT-    0138     IN PITTSBURGH PA ADJ AREA,1931,1931,0,1707,0,4058,33.5
G42000300139,STCTY-42003 TRACT-    0139     IN PITTSBURGH PA ADJ AREA,2936,2476,460,1760,453,0,22.31
G42000300140,STCTY-42003 TRACT-    0140     IN PITTSBURGH PA ADJ AREA,1130,1102,28,823,28,0,28.28
G42000300141,STCTY-42003 TRACT-    0141     IN PITTSBURGH PA ADJ AREA,761,735,26,635,26,0,33.96
G42000300142,STCTY-42003 TRACT-    0142     IN PITTSBURGH PA ADJ AREA,1943,1868,75,1567,75,4111,28.15
G42000300143,STCTY-42003 TRACT-    0143     IN PITTSBURGH PA ADJ AREA,1959,1531,428,1182,422,2500,27.51
G42000300144,STCTY-42003 TRACT-    0144     IN PITTSBURGH PA ADJ AREA,3608,2941,667,2203,667,2580,29.31
G42000300145,STCTY-42003 TRACT-    0145     IN PITTSBURGH PA ADJ AREA,1626,1617,9,1435,6,0,26.21
G42000300146,STCTY-42003 TRACT-    0146     IN PITTSBURGH PA ADJ AREA,1870,1845,25,1552,25,0,31.45
G42000300147,STCTY-42003 TRACT-    0147     IN PITTSBURGH PA ADJ AREA,1403,1401,2,1133,2,4250,30.89
G42000300148,STCTY-42003 TRACT-    0148     IN PITTSBURGH PA ADJ AREA,752,717,35,595,35,0,24.36
G42000300149,STCTY-42003 TRACT-    0149     IN PITTSBURGH PA ADJ AREA,5397,5348,49,4249,49,3057,26.38
G42000300150,STCTY-42003 TRACT-    0150     IN PITTSBURGH PA ADJ AREA,877,877,0,780,0,8922,0
G42000300151,STCTY-42003 TRACT-    0151     IN PITTSBURGH PA ADJ AREA,4054,3918,136,3475,136,3883,36.83
G42000300152,STCTY-42003 TRACT-    0152     IN PITTSBURGH PA ADJ AREA,5539,5534,5,4832,5,4225,36.19
G42000300153,STCTY-42003 TRACT-    0153     IN PITTSBURGH PA ADJ AREA,2212,2212,0,1900,0,4326,37.83
G42000300154,STCTY-42003 TRACT-    0154     IN PITTSBURGH PA ADJ AREA,2556,2552,4,2138,4,2153,25.65
G42000300155,STCTY-42003 TRACT-    0155     IN PITTSBURGH PA ADJ AREA,2054,2054,0,1758,0,5000,28.3
G42000300156,STCTY-42003 TRACT-    0156     IN PITTSBURGH PA ADJ AREA,2032,2032,0,1865,0,3761,29.75
G42000300157,STCTY-42003 TRACT-    0157     IN PITTSBURGH PA ADJ AREA,2047,2046,1,1836,1,3753,35.35
G42000300158,STCTY-42003 TRACT-    0158     IN PITTSBURGH PA ADJ AREA,2115,2115,0,1916,0,3747,37.69
G42000300159,STCTY-42003 TRACT-    0159     IN PITTSBURGH PA ADJ AREA,2534,2534,0,2126,0,3018,31.56
G42000300160,STCTY-42003 TRACT-    0160     IN PITTSBURGH PA ADJ AREA,1747,1744,3,1398,3,3222,29.22
G42000300161,STCTY-42003 TRACT-    0161     IN PITTSBURGH PA ADJ AREA,2282,2055,227,1637,227,3882,26.22
G42000300162,STCTY-42003 TRACT-    0162     IN PITTSBURGH PA ADJ AREA,1921,1901,20,1632,20,3604,30.4
G42000300163,STCTY-42003 TRACT-    0163     IN PITTSBURGH PA ADJ AREA,1697,1548,149,1473,149,2345,21.64
G42000300165,STCTY-42003 TRACT-    0165     IN PITTSBURGH PA ADJ AREA,5777,5777,0,5068,0,4715,37.17
G42000300166,STCTY-42003 TRACT-    0166     IN PITTSBURGH PA ADJ AREA,4187,4032,155,3412,155,2590,26.96
G42000300167,STCTY-42003 TRACT-    0167     IN PITTSBURGH PA ADJ AREA,2565,2557,8,2235,8,4049,23.39
G42000300168,STCTY-42003 TRACT-    0168     IN PITTSBURGH PA ADJ AREA,781,781,0,730,0,4000,0
G42000300169,STCTY-42003 TRACT-    0169     IN PITTSBURGH PA ADJ AREA,1161,1161,0,1082,0,0,15.97
G42000300170,STCTY-42003 TRACT-    0170     IN PITTSBURGH PA ADJ AREA,1294,1294,0,1176,0,0,33.08
G42000300171,STCTY-42003 TRACT-    0171     IN PITTSBURGH PA ADJ AREA,1074,1074,0,948,0,0,21.76
G42000300172,STCTY-42003 TRACT-    0172     IN PITTSBURGH PA ADJ AREA,1537,1537,0,1386,0,2167,26.78
G42000300173,STCTY-42003 TRACT-    0173     IN PITTSBURGH PA ADJ AREA,1297,1297,0,1204,0,3842,29.56
G42000300174,STCTY-42003 TRACT-    0174     IN PITTSBURGH PA ADJ AREA,2609,2609,0,2390,0,3518,29.08
G42000300175,STCTY-42003 TRACT-    0175     IN PITTSBURGH PA ADJ AREA,3733,3715,18,3328,18,3170,25.09
G42000300176,STCTY-42003 TRACT-    0176     IN PITTSBURGH PA ADJ AREA,4792,4782,10,4573,10,10463,76.63
G42000300177,STCTY-42003 TRACT-    0177     IN PITTSBURGH PA ADJ AREA,3654,3641,13,3416,13,9141,70.54
G42000300178,STCTY-42003 TRACT-    0178     IN PITTSBURGH PA ADJ AREA,7562,7509,53,7140,53,10137,72.7
G42000300179,STCTY-42003 TRACT-    0179     IN PITTSBURGH PA ADJ AREA,3563,3549,14,3404,13,12603,100
G42000300180,STCTY-42003 TRACT-    0180     IN PITTSBURGH PA ADJ AREA,2037,2037,0,1893,0,3727,35.25
G42000300181,STCTY-42003 TRACT-    0181     IN PITTSBURGH PA ADJ AREA,3022,3022,0,2771,0,3743,34.47
G42000300182,STCTY-42003 TRACT-    0182     IN PITTSBURGH PA ADJ AREA,1922,1922,0,1755,0,4319,45.57
G42000300183,STCTY-42003 TRACT-    0183     IN PITTSBURGH PA ADJ AREA,4545,4539,6,3649,3,3450,33.48
G42000300184,STCTY-42003 TRACT-    0184     IN PITTSBURGH PA ADJ AREA,1239,1214,25,977,25,4468,37.58
G42000300185,STCTY-42003 TRACT-    0185     IN PITTSBURGH PA ADJ AREA,2339,2297,42,1721,42,2756,20.56
G42000300186,STCTY-42003 TRACT-    0186     IN PITTSBURGH PA ADJ AREA,1469,1466,3,1333,3,0,30.35
G42000300187,STCTY-42003 TRACT-    0187     IN PITTSBURGH PA ADJ AREA,2020,2012,8,1526,8,2464,24.13
G42000300188,STCTY-42003 TRACT-    0188     IN PITTSBURGH PA ADJ AREA,2599,2586,13,2090,13,2831,24.09
G42000300189,STCTY-42003 TRACT-    0189     IN PITTSBURGH PA ADJ AREA,437,435,2,349,2,0,0
G42000300190,STCTY-42003 TRACT-    0190     IN PITTSBURGH PA ADJ AREA,1103,1065,38,841,38,0,22.91
G42000300191,STCTY-42003 TRACT-    0191     IN PITTSBURGH PA ADJ AREA,1596,1443,153,1175,153,2371,27.64
G42000300192,STCTY-42003 TRACT-    0192     IN PITTSBURGH PA ADJ AREA,3225,3199,26,2636,26,3759,31.78
G42000300193,STCTY-42003 TRACT-    0193     IN PITTSBURGH PA ADJ AREA,2134,1936,198,1660,198,2750,30.84
G42000300194,STCTY-42003 TRACT-    0194     IN PITTSBURGH PA ADJ AREA,2565,2524,41,2204,41,4272,28.83
G42000300195,STCTY-42003 TRACT-    0195     IN PITTSBURGH PA ADJ AREA,4216,4120,96,3470,92,1361,14.69
G42000300196,STCTY-42003 TRACT-    0196     IN PITTSBURGH PA ADJ AREA,766,751,15,641,15,2786,0
G42000300197,STCTY-42003 TRACT-    0197     IN PITTSBURGH PA ADJ AREA,5575,5261,314,4477,313,2187,22.08
G42000300198,STCTY-42003 TRACT-    0198     IN PITTSBURGH PA ADJ AREA,1766,1711,55,1620,55,2789,26.33
G42000300199,STCTY-42003 TRACT-    0199     IN PITTSBURGH PA ADJ AREA,2163,2083,80,1809,80,3841,32.85
G42000300200,STCTY-42003 TRACT-    0200     IN PITTSBURGH PA ADJ AREA,2348,2282,66,2101,66,5179,39.92
G42000300201,STCTY-42003 TRACT-    0201     IN PITTSBURGH PA ADJ AREA,1749,1718,31,1545,31,5630,45.93
G42000300202,STCTY-42003 TRACT-    0202     IN PITTSBURGH PA ADJ AREA,1080,1060,20,967,20,20000,0
G42000300203,STCTY-42003 TRACT-    0203     IN PITTSBURGH PA ADJ AREA,4553,4301,252,3975,251,4310,25.04
G42000300204,STCTY-42003 TRACT-    0204     IN PITTSBURGH PA ADJ AREA,611,610,1,573,1,0,0
G42000300205,STCTY-42003 TRACT-    0205     IN PITTSBURGH PA ADJ AREA,529,517,12,493,12,0,0
G42000300206,STCTY-42003 TRACT-    0206     IN PITTSBURGH PA ADJ AREA,430,429,1,402,1,0,0
G42000300207,STCTY-42003 TRACT-    0207     IN PITTSBURGH PA ADJ AREA,748,715,33,588,33,0,0
G42000300209,STCTY-42003 TRACT-    0209     IN PITTSBURGH PA ADJ AREA,1742,1742,0,1605,0,2597,24.5
G42000300210,STCTY-42003 TRACT-    0210     IN PITTSBURGH PA ADJ AREA,2947,2765,182,2479,182,2586,24.28
G42000300211,STCTY-42003 TRACT-    0211     IN PITTSBURGH PA ADJ AREA,4245,2963,1282,2724,1280,3909,28.11
G42000300212,STCTY-42003 TRACT-    0212     IN PITTSBURGH PA ADJ AREA,5506,5475,31,4977,31,4144,27.82
G42000300213,STCTY-42003 TRACT-    0213     IN PITTSBURGH PA ADJ AREA,5827,5739,88,5144,82,5824,25.41
G42000300214,STCTY-42003 TRACT-    0214     IN PITTSBURGH PA ADJ AREA,1191,1165,26,1114,25,0,0
G42000300215,STCTY-42003 TRACT-    0215     IN PITTSBURGH PA ADJ AREA,1308,1308,0,1227,0,2734,28.5
G42000300216,STCTY-42003 TRACT-    0216     IN PITTSBURGH PA ADJ AREA,1961,1961,0,1743,0,2348,24.58
G42000300217,STCTY-42003 TRACT-    0217     IN PITTSBURGH PA ADJ AREA,3041,3041,0,2919,0,3464,32.75
G42000300218,STCTY-42003 TRACT-    0218     IN PITTSBURGH PA ADJ AREA,7046,6881,165,5953,165,2007,17.96
G42000300219,STCTY-42003 TRACT-    0219     IN PITTSBURGH PA ADJ AREA,2415,2412,3,1939,3,3377,21.91
G42000300220,STCTY-42003 TRACT-    0220     IN PITTSBURGH PA ADJ AREA,1186,1186,0,973,0,3117,0
G42000300221,STCTY-42003 TRACT-    0221     IN PITTSBURGH PA ADJ AREA,2829,1883,946,1386,946,3207,22.28
G42000300222,STCTY-42003 TRACT-    0222     IN PITTSBURGH PA ADJ AREA,2636,1996,640,1490,637,4293,23.01
G42000300223,STCTY-42003 TRACT-    0223     IN PITTSBURGH PA ADJ AREA,2005,1966,39,1464,39,3581,26.5
G42000300224,STCTY-42003 TRACT-    0224     IN PITTSBURGH PA ADJ AREA,1121,1119,2,1019,2,0,0
G42000300225,STCTY-42003 TRACT-    0225     IN PITTSBURGH PA ADJ AREA,1973,1973,0,1734,0,3641,26.13
G42000300226,STCTY-42003 TRACT-    0226     IN PITTSBURGH PA ADJ AREA,2355,2352,3,2204,3,3009,23.88
G42000300227,STCTY-42003 TRACT-    0227     IN PITTSBURGH PA ADJ AREA,3775,3732,43,3129,43,2375,17.35
G42000300228,STCTY-42003 TRACT-    0228     IN PITTSBURGH PA ADJ AREA,4177,4170,7,3891,6,5822,35.18
G42000300229,STCTY-42003 TRACT-    0229     IN PITTSBURGH PA ADJ AREA,2711,2471,240,2251,240,4739,41.06
G42000300230,STCTY-42003 TRACT-    0230     IN PITTSBURGH PA ADJ AREA,1935,1822,113,1652,113,3695,29.43
G42000300231,STCTY-42003 TRACT-    0231     IN PITTSBURGH PA ADJ AREA,2004,2001,3,1826,3,5986,32.88
G42000300232,STCTY-42003 TRACT-    0232     IN PITTSBURGH PA ADJ AREA,432,432,0,413,0,0,0
G42000300233,STCTY-42003 TRACT-    0233     IN PITTSBURGH PA ADJ AREA,6297,6247,50,5357,50,2473,0
G42000300234,STCTY-42003 TRACT-    0234     IN PITTSBURGH PA ADJ AREA,2290,1944,346,1684,346,5083,40.82
G42000300235,STCTY-42003 TRACT-    0235     IN PITTSBURGH PA ADJ AREA,1744,1410,334,1238,334,7500,40.42
G42000300236,STCTY-42003 TRACT-    0236     IN PITTSBURGH PA ADJ AREA,1580,1481,99,1337,96,6171,43.63
G42000300237,STCTY-42003 TRACT-    0237     IN PITTSBURGH PA ADJ AREA,575,572,3,528,3,0,0
G42000300238,STCTY-42003 TRACT-    0238     IN PITTSBURGH PA ADJ AREA,351,347,4,326,4,0,0
G42000300239,STCTY-42003 TRACT-    0239     IN PITTSBURGH PA ADJ AREA,7276,7265,11,6848,10,5639,34.11
G42000300240,STCTY-42003 TRACT-    0240     IN PITTSBURGH PA ADJ AREA,652,649,3,586,3,0,0
G42000300241,STCTY-42003 TRACT-    0241     IN PITTSBURGH PA ADJ AREA,3257,3257,0,2924,0,3667,28.61
G42000300242,STCTY-42003 TRACT-    0242     IN PITTSBURGH PA ADJ AREA,2519,2436,83,1876,83,2938,23.57
G42000300243,STCTY-42003 TRACT-    0243     IN PITTSBURGH PA ADJ AREA,2323,2256,67,1898,66,2410,21.93
G42000300244,STCTY-42003 TRACT-    0244     IN PITTSBURGH PA ADJ AREA,3360,3349,11,3009,10,3048,28.04
G42000300245,STCTY-42003 TRACT-    0245     IN PITTSBURGH PA ADJ AREA,4399,3885,514,3041,514,2163,16.94
G42000300246,STCTY-42003 TRACT-    0246     IN PITTSBURGH PA ADJ AREA,9780,9081,699,6742,691,1438,15.31
G42000300247,STCTY-42003 TRACT-    0247     IN PITTSBURGH PA ADJ AREA,337,337,0,319,0,0,0
G42000300248,STCTY-42003 TRACT-    0248     IN PITTSBURGH PA ADJ AREA,2569,2569,0,2275,0,4000,36.89
G42000300249,STCTY-42003 TRACT-    0249     IN PITTSBURGH PA ADJ AREA,2420,2418,2,1936,2,2361,24.68
G42000300250,STCTY-42003 TRACT-    0250     IN PITTSBURGH PA ADJ AREA,1698,1692,6,1431,6,0,23.73
G42000300251,STCTY-42003 TRACT-    0251     IN PITTSBURGH PA ADJ AREA,4525,4482,43,3314,43,2494,19.66
G42000300252,STCTY-42003 TRACT-    0252     IN PITTSBURGH PA ADJ AREA,2309,2301,8,1759,8,2514,29.25
G42000300253,STCTY-42003 TRACT-    0253     IN PITTSBURGH PA ADJ AREA,1355,1354,1,1197,0,4306,37.79
G42000300254,STCTY-42003 TRACT-    0254     IN PITTSBURGH PA ADJ AREA,1942,1941,1,1515,1,3268,28.14
G42000300255,STCTY-42003 TRACT-    0255     IN PITTSBURGH PA ADJ AREA,2446,2443,3,2009,0,3821,34.18
G42000300256,STCTY-42003 TRACT-    0256     IN PITTSBURGH PA ADJ AREA,1242,1241,1,1142,1,8226,56.55
G42000300257,STCTY-42003 TRACT-    0257     IN PITTSBURGH PA ADJ AREA,2704,2704,0,2408,0,5422,49.43
G42000300258,STCTY-42003 TRACT-    0258     IN PITTSBURGH PA ADJ AREA,3944,3557,387,3000,387,3962,32.07
G42000300259,STCTY-42003 TRACT-    0259     IN PITTSBURGH PA ADJ AREA,5096,4976,120,4289,119,4825,35.33
G42000300260,STCTY-42003 TRACT-    0260     IN PITTSBURGH PA ADJ AREA,2933,2895,38,2574,38,5706,39.22
G42000300261,STCTY-42003 TRACT-    0261     IN PITTSBURGH PA ADJ AREA,3627,3624,3,3406,0,3943,30.45
G42000300262,STCTY-42003 TRACT-    0262     IN PITTSBURGH PA ADJ AREA,2315,2314,1,2159,0,2783,27.45
G42000300263,STCTY-42003 TRACT-    0263     IN PITTSBURGH PA ADJ AREA,3904,3727,177,2916,176,2549,23.12
G42000300264,STCTY-42003 TRACT-    0264     IN PITTSBURGH PA ADJ AREA,284,278,6,252,6,0,0
G42000300265,STCTY-42003 TRACT-    0265     IN PITTSBURGH PA ADJ AREA,165,165,0,151,0,0,0
G42000300266,STCTY-42003 TRACT-    0266     IN PITTSBURGH PA ADJ AREA,3341,3334,7,3003,7,4090,35.53
G42000300267,STCTY-42003 TRACT-    0267     IN PITTSBURGH PA ADJ AREA,2282,2267,15,2033,15,4445,28.94
G42000300268,STCTY-42003 TRACT-    0268     IN PITTSBURGH PA ADJ AREA,2132,2132,0,1832,0,3026,32.06
G42000300269,STCTY-42003 TRACT-    0269     IN PITTSBURGH PA ADJ AREA,700,700,0,608,0,0,31.38
G42000300270,STCTY-42003 TRACT-    0270     IN PITTSBURGH PA ADJ AREA,1350,1350,0,1169,0,3512,26.29
G42000300271,STCTY-42003 TRACT-    0271     IN PITTSBURGH PA ADJ AREA,2486,2375,111,2038,111,4050,20.13
G42000300272,STCTY-42003 TRACT-    0272     IN PITTSBURGH PA ADJ AREA,2125,2033,92,1869,92,3633,33.61
G42000300273,STCTY-42003 TRACT-    0273     IN PITTSBURGH PA ADJ AREA,2231,2153,78,1707,78,2829,26.72
G42000300274,STCTY-42003 TRACT-    0274     IN PITTSBURGH PA ADJ AREA,2401,2322,79,1941,79,2542,28.88
G42000300275,STCTY-42003 TRACT-    0275     IN PITTSBURGH PA ADJ AREA,5227,5170,57,4672,57,3464,30.22
G42000300276,STCTY-42003 TRACT-    0276     IN PITTSBURGH PA ADJ AREA,1278,1231,47,988,47,1941,22.05
G42000300277,STCTY-42003 TRACT-    0277     IN PITTSBURGH PA ADJ AREA,820,792,28,569,28,0,0
G42000300278,STCTY-42003 TRACT-    0278     IN PITTSBURGH PA ADJ AREA,7815,7814,1,6296,1,1839,16.46
G42000300279,STCTY-42003 TRACT-    0279     IN PITTSBURGH PA ADJ AREA,1297,1157,140,1098,140,0,24.22
G42000300280,STCTY-42003 TRACT-    0280     IN PITTSBURGH PA ADJ AREA,1870,1808,62,1559,62,2625,29.16
G42000300281,STCTY-42003 TRACT-    0281     IN PITTSBURGH PA ADJ AREA,1220,1202,18,946,18,0,28.04
G42000300282,STCTY-42003 TRACT-    0282     IN PITTSBURGH PA ADJ AREA,436,408,28,324,28,0,0
G42000300283,STCTY-42003 TRACT-    0283     IN PITTSBURGH PA ADJ AREA,4755,4755,0,4434,0,5648,51.07
G42000300284,STCTY-42003 TRACT-    0284     IN PITTSBURGH PA ADJ AREA,2460,2460,0,2267,0,4872,39.44
G42000300285,STCTY-42003 TRACT-    0285     IN PITTSBURGH PA ADJ AREA,2217,2198,19,1862,19,3160,25.59
G42000300286,STCTY-42003 TRACT-    0286     IN PITTSBURGH PA ADJ AREA,3884,3883,1,3220,1,2850,24.8
G42000300287,STCTY-42003 TRACT-    0287     IN PITTSBURGH PA ADJ AREA,2511,2494,17,2354,17,6018,46.98
G42000300288,STCTY-42003 TRACT-    0288     IN PITTSBURGH PA ADJ AREA,2165,2062,103,1867,103,4543,35.82
G42000300289,STCTY-42003 TRACT-    0289     IN PITTSBURGH PA ADJ AREA,2633,2618,15,2474,15,7131,51.26
G42000300290,STCTY-42003 TRACT-    0290     IN PITTSBURGH PA ADJ AREA,1675,1671,4,1540,4,0,42.59
G42000300291,STCTY-42003 TRACT-    0291     IN PITTSBURGH PA ADJ AREA,2613,2393,220,2191,220,3298,33.92
G42000300292,STCTY-42003 TRACT-    0292     IN PITTSBURGH PA ADJ AREA,3676,3614,62,3378,54,5464,40.18
G42000300293,STCTY-42003 TRACT-    0293     IN PITTSBURGH PA ADJ AREA,4094,4070,24,3787,20,4768,39.24
G42000300294,STCTY-42003 TRACT-    0294     IN PITTSBURGH PA ADJ AREA,1960,1953,7,1796,7,6403,54.23
G42000300295,STCTY-42003 TRACT-    0295     IN PITTSBURGH PA ADJ AREA,4132,4110,22,3809,20,5195,38.16
G42000300296,STCTY-42003 TRACT-    0296     IN PITTSBURGH PA ADJ AREA,4394,4381,13,4071,12,6209,45.07
G42000300297,STCTY-42003 TRACT-    0297     IN PITTSBURGH PA ADJ AREA,3203,3095,108,2480,108,2901,26.93
G42000300298,STCTY-42003 TRACT-    0298     IN PITTSBURGH PA ADJ AREA,1161,1161,0,1027,0,0,34.14
G42000300299,STCTY-42003 TRACT-    0299     IN PITTSBURGH PA ADJ AREA,1298,1297,1,1090,0,0,32.54
G42010100001A,STCTY-42101 TRACT-    0001-A   IN PHILADELPHIA PA,582,581,1,514,1,0,24.22
G42010100001B,STCTY-42101 TRACT-    0001-B   IN PHILADELPHIA PA,16378,16172,206,11892,199,2257,23.71
G42010100001C,STCTY-42101 TRACT-    0001-C   IN PHILADELPHIA PA,19667,19415,252,13543,251,2399,23.12
G42010100002A,STCTY-42101 TRACT-    0002-A   IN PHILADELPHIA PA,9818,8147,1671,6096,1669,2181,19.34
G42010100002B,STCTY-42101 TRACT-    0002-B   IN PHILADELPHIA PA,10876,10170,706,7317,703,2537,18.86
G42010100002C,STCTY-42101 TRACT-    0002-C   IN PHILADELPHIA PA,1534,824,710,621,710,0,20.38
G42010100003A,STCTY-42101 TRACT-    0003-A   IN PHILADELPHIA PA,10776,9520,1256,6737,1253,2620,18.49
G42010100003B,STCTY-42101 TRACT-    0003-B   IN PHILADELPHIA PA,2274,967,1307,732,1306,0,15.8
G42010100004A,STCTY-42101 TRACT-    0004-A   IN PHILADELPHIA PA,8588,7219,1369,5014,1367,2836,18.63
G42010100004B,STCTY-42101 TRACT-    0004-B   IN PHILADELPHIA PA,2175,386,1789,270,1787,0,13.07
G42010100005A,STCTY-42101 TRACT-    0005-A   IN PHILADELPHIA PA,7142,6371,771,4176,759,4195,24.99
G42010100006A,STCTY-42101 TRACT-    0006-A   IN PHILADELPHIA PA,835,627,208,478,207,0,14.04
G42010100007A,STCTY-42101 TRACT-    0007-A   IN PHILADELPHIA PA,5015,4506,509,3796,493,0,37.46
G42010100007B,STCTY-42101 TRACT-    0007-B   IN PHILADELPHIA PA,5412,1493,3919,1052,3906,0,17.3
G42010100007C,STCTY-42101 TRACT-    0007-C   IN PHILADELPHIA PA,3607,3404,203,2964,196,10189,46.01
G42010100007D,STCTY-42101 TRACT-    0007-D   IN PHILADELPHIA PA,5884,2276,3608,2067,3600,2529,24.9
G42010100008A,STCTY-42101 TRACT-    0008-A   IN PHILADELPHIA PA,2350,2294,56,1988,55,0,44.01
G42010100008B,STCTY-42101 TRACT-    0008-B   IN PHILADELPHIA PA,8255,7778,477,6448,465,7917,48.8
G42010100009A,STCTY-42101 TRACT-    0009-A   IN PHILADELPHIA PA,243,234,9,196,9,0,0
G42010100009B,STCTY-42101 TRACT-    0009-B   IN PHILADELPHIA PA,985,973,12,832,12,0,38.33
G42010100010A,STCTY-42101 TRACT-    0010-A   IN PHILADELPHIA PA,4367,3783,584,3248,314,0,23.11
G42010100010B,STCTY-42101 TRACT-    0010-B   IN PHILADELPHIA PA,4288,4142,146,3449,111,0,27.78
G42010100011A,STCTY-42101 TRACT-    0011-A   IN PHILADELPHIA PA,2544,2218,326,1529,322,2813,17.85
G42010100011B,STCTY-42101 TRACT-    0011-B   IN PHILADELPHIA PA,1196,831,365,562,364,0,14.41
G42010100012A,STCTY-42101 TRACT-    0012-A   IN PHILADELPHIA PA,3569,2995,574,2030,549,2875,19.76
G42010100012B,STCTY-42101 TRACT-    0012-B   IN PHILADELPHIA PA,2309,2015,294,1471,294,2696,18.78
G42010100013A,STCTY-42101 TRACT-    0013-A   IN PHILADELPHIA PA,5849,3394,2455,2045,2441,3430,20.74
G42010100013B,STCTY-42101 TRACT-    0013-B   IN PHILADELPHIA PA,4878,3463,1415,2523,1405,3056,14.06
G42010100014A,STCTY-42101 TRACT-    0014-A   IN PHILADELPHIA PA,7406,3572,3834,2757,3814,3596,21.23
G42010100014B,STCTY-42101 TRACT-    0014-B   IN PHILADELPHIA PA,2307,1963,344,1549,303,0,24.05
G42010100015A,STCTY-42101 TRACT-    0015-A   IN PHILADELPHIA PA,15187,13620,1567,11833,1521,3833,22.5
G42010100015B,STCTY-42101 TRACT-    0015-B   IN PHILADELPHIA PA,2544,2325,219,1975,209,0,24.2
G42010100015C,STCTY-42101 TRACT-    0015-C   IN PHILADELPHIA PA,9713,7694,2019,6726,2014,3315,25.64
G42010100015D,STCTY-42101 TRACT-    0015-D   IN PHILADELPHIA PA,10678,10630,48,8788,47,2717,28.12
G42010100015E,STCTY-42101 TRACT-    0015-E   IN PHILADELPHIA PA,5,3,2,1,2,0,0
G42010100016A,STCTY-42101 TRACT-    0016-A   IN PHILADELPHIA PA,8157,7863,294,5756,290,2633,18.49
G42010100017A,STCTY-42101 TRACT-    0017-A   IN PHILADELPHIA PA,10218,10048,170,7662,161,2420,20.05
G42010100018A,STCTY-42101 TRACT-    0018-A   IN PHILADELPHIA PA,4740,4731,9,4212,7,1913,22.09
G42010100018B,STCTY-42101 TRACT-    0018-B   IN PHILADELPHIA PA,7031,7028,3,6412,3,2295,24.5
G42010100018C,STCTY-42101 TRACT-    0018-C   IN PHILADELPHIA PA,4028,4027,1,3641,0,2302,24.31
G42010100018D,STCTY-42101 TRACT-    0018-D   IN PHILADELPHIA PA,4450,4450,0,3399,0,2269,20.3
G42010100019A,STCTY-42101 TRACT-    0019-A   IN PHILADELPHIA PA,17128,16596,532,14213,507,2207,22.73
G42010100019B,STCTY-42101 TRACT-    0019-B   IN PHILADELPHIA PA,10712,10564,148,9187,135,2448,25.99
G42010100019C,STCTY-42101 TRACT-    0019-C   IN PHILADELPHIA PA,12854,12679,175,10272,161,2214,24
G42010100020A,STCTY-42101 TRACT-    0020-A   IN PHILADELPHIA PA,14526,12068,2458,8360,2426,2823,24.53
G42010100020B,STCTY-42101 TRACT-    0020-B   IN PHILADELPHIA PA,11681,1759,9922,1310,9901,1982,21.57
G42010100020C,STCTY-42101 TRACT-    0020-C   IN PHILADELPHIA PA,2718,1055,1663,911,1654,0,27.26
G42010100020D,STCTY-42101 TRACT-    0020-D   IN PHILADELPHIA PA,11440,6490,4950,4131,4939,2932,23.02
G42010100021A,STCTY-42101 TRACT-    0021-A   IN PHILADELPHIA PA,955,928,27,805,27,0,100
G42010100021B,STCTY-42101 TRACT-    0021-B   IN PHILADELPHIA PA,1039,1019,20,864,20,8125,0
G42010100021C,STCTY-42101 TRACT-    0021-C   IN PHILADELPHIA PA,53,53,0,52,0,0,0
G42010100021D,STCTY-42101 TRACT-    0021-D   IN PHILADELPHIA PA,271,271,0,257,0,0,0
G42010100021E,STCTY-42101 TRACT-    0021-E   IN PHILADELPHIA PA,311,308,3,290,3,0,0
G42010100021F,STCTY-42101 TRACT-    0021-F   IN PHILADELPHIA PA,187,186,1,175,0,0,0
G42010100021G,STCTY-42101 TRACT-    0021-G   IN PHILADELPHIA PA,279,279,0,251,0,0,0
G42010100021H,STCTY-42101 TRACT-    0021-H   IN PHILADELPHIA PA,109,90,19,85,19,0,0
G42010100021I,STCTY-42101 TRACT-    0021-I   IN PHILADELPHIA PA,175,175,0,158,0,0,0
G42010100021J,STCTY-42101 TRACT-    0021-J   IN PHILADELPHIA PA,546,546,0,517,0,0,0
G42010100021K,STCTY-42101 TRACT-    0021-K   IN PHILADELPHIA PA,237,233,4,221,4,0,0
G42010100021L,STCTY-42101 TRACT-    0021-L   IN PHILADELPHIA PA,108,108,0,100,0,0,0
G42010100021M,STCTY-42101 TRACT-    0021-M   IN PHILADELPHIA PA,334,334,0,314,0,0,0
G42010100021N,STCTY-42101 TRACT-    0021-N   IN PHILADELPHIA PA,3769,3686,83,3252,82,2738,27.27
G42010100021O,STCTY-42101 TRACT-    0021-O   IN PHILADELPHIA PA,1609,1609,0,1492,0,3596,30.58
G42010100021P,STCTY-42101 TRACT-    0021-P   IN PHILADELPHIA PA,821,817,4,773,4,5513,0
G42010100021Q,STCTY-42101 TRACT-    0021-Q   IN PHILADELPHIA PA,2058,2023,35,1912,33,3825,38.89
G42010100021R,STCTY-42101 TRACT-    0021-R   IN PHILADELPHIA PA,4985,4937,48,4605,48,3503,34.93
G42010100021S,STCTY-42101 TRACT-    0021-S   IN PHILADELPHIA PA,7232,6785,447,5891,447,2692,24.74
G42010100021T,STCTY-42101 TRACT-    0021-T   IN PHILADELPHIA PA,8202,8079,123,7077,123,2905,29.69
G42010100021U,STCTY-42101 TRACT-    0021-U   IN PHILADELPHIA PA,1782,1781,1,1659,1,5607,52.46
G42010100021V,STCTY-42101 TRACT-    0021-V   IN PHILADELPHIA PA,4317,4310,7,3835,7,3025,29.63
G42010100022A,STCTY-42101 TRACT-    0022-A   IN PHILADELPHIA PA,6077,5656,421,4987,420,3187,34.75
G42010100022AA,STCTY-42101 TRACT-    0022-AA  IN PHILADELPHIA PA,5040,4128,912,3747,909,5359,42.86
G42010100022B,STCTY-42101 TRACT-    0022-B   IN PHILADELPHIA PA,706,702,4,624,4,0,0
G42010100022BB,STCTY-42101 TRACT-    0022-BB  IN PHILADELPHIA PA,1735,1667,68,1526,67,9917,68.06
G42010100022C,STCTY-42101 TRACT-    0022-C   IN PHILADELPHIA PA,758,756,2,656,2,0,0
G42010100022CC,STCTY-42101 TRACT-    0022-CC  IN PHILADELPHIA PA,2163,2013,150,1860,150,5446,56.25
G42010100022D,STCTY-42101 TRACT-    0022-D   IN PHILADELPHIA PA,2823,2799,24,2643,23,7112,56.19
G42010100022DD,STCTY-42101 TRACT-    0022-DD  IN PHILADELPHIA PA,1951,1418,533,1270,533,7156,38.47
G42010100022E,STCTY-42101 TRACT-    0022-E   IN PHILADELPHIA PA,2641,2602,39,2422,36,8914,42.56
G42010100022EE,STCTY-42101 TRACT-    0022-EE  IN PHILADELPHIA PA,7308,5665,1643,4531,1635,3184,27.44
G42010100022F,STCTY-42101 TRACT-    0022-F   IN PHILADELPHIA PA,2749,2712,37,2494,35,8209,61.95
G42010100022FF,STCTY-42101 TRACT-    0022-FF  IN PHILADELPHIA PA,3474,3255,219,2880,219,4315,39.67
G42010100022G,STCTY-42101 TRACT-    0022-G   IN PHILADELPHIA PA,2082,2036,46,1650,46,5171,49.5
G42010100022GG,STCTY-42101 TRACT-    0022-GG  IN PHILADELPHIA PA,7703,7356,347,6385,343,3583,38.22
G42010100022H,STCTY-42101 TRACT-    0022-H   IN PHILADELPHIA PA,2065,2048,17,1700,14,6204,51.13
G42010100022HH,STCTY-42101 TRACT-    0022-HH  IN PHILADELPHIA PA,7559,6703,856,5908,855,2986,31
G42010100022I,STCTY-42101 TRACT-    0022-I   IN PHILADELPHIA PA,867,833,34,671,30,0,0
G42010100022II,STCTY-42101 TRACT-    0022-II  IN PHILADELPHIA PA,7984,6440,1544,5666,1541,3741,35.74
G42010100022J,STCTY-42101 TRACT-    0022-J   IN PHILADELPHIA PA,541,516,25,432,25,0,0
G42010100022JJ,STCTY-42101 TRACT-    0022-JJ  IN PHILADELPHIA PA,5284,5278,6,4603,3,4031,35.56
G42010100022K,STCTY-42101 TRACT-    0022-K   IN PHILADELPHIA PA,26,26,0,25,0,0,0
G42010100022KK,STCTY-42101 TRACT-    0022-KK  IN PHILADELPHIA PA,4369,3866,503,3496,502,4527,43.54
G42010100022L,STCTY-42101 TRACT-    0022-L   IN PHILADELPHIA PA,0,0,0,0,0,0,0
G42010100022M,STCTY-42101 TRACT-    0022-M   IN PHILADELPHIA PA,30,30,0,15,0,0,0
G42010100022N,STCTY-42101 TRACT-    0022-N   IN PHILADELPHIA PA,105,104,1,60,1,0,0
G42010100022O,STCTY-42101 TRACT-    0022-O   IN PHILADELPHIA PA,1176,1137,39,962,39,9531,63.9
G42010100022P,STCTY-42101 TRACT-    0022-P   IN PHILADELPHIA PA,1865,1761,104,1424,104,8036,56.77
G42010100022Q,STCTY-42101 TRACT-    0022-Q   IN PHILADELPHIA PA,106,103,3,65,3,0,0
G42010100022R,STCTY-42101 TRACT-    0022-R   IN PHILADELPHIA PA,1266,1210,56,1149,56,0,0
G42010100022S,STCTY-42101 TRACT-    0022-S   IN PHILADELPHIA PA,0,0,0,0,0,0,0
G42010100022T,STCTY-42101 TRACT-    0022-T   IN PHILADELPHIA PA,574,534,40,495,39,12500,0
G42010100022U,STCTY-42101 TRACT-    0022-U   IN PHILADELPHIA PA,4294,4260,34,3809,31,5333,56.03
G42010100022V,STCTY-42101 TRACT-    0022-V   IN PHILADELPHIA PA,2127,2068,59,1849,55,7346,59.16
G42010100022W,STCTY-42101 TRACT-    0022-W   IN PHILADELPHIA PA,2294,2211,83,2034,83,9597,67.21
G42010100022X,STCTY-42101 TRACT-    0022-X   IN PHILADELPHIA PA,3533,3138,395,2857,395,7635,61.83
G42010100022Y,STCTY-42101 TRACT-    0022-Y   IN PHILADELPHIA PA,6539,4855,1684,4181,1676,3417,26.93
G42010100022Z,STCTY-42101 TRACT-    0022-Z   IN PHILADELPHIA PA,8269,8099,170,7134,170,4621,40.01
G42010100023A,STCTY-42101 TRACT-    0023-A   IN PHILADELPHIA PA,1229,1229,0,1081,0,2432,26.21
G42010100023B,STCTY-42101 TRACT-    0023-B   IN PHILADELPHIA PA,2309,2309,0,2093,0,3713,35.59
G42010100023C,STCTY-42101 TRACT-    0023-C   IN PHILADELPHIA PA,1659,1658,1,1484,1,3414,38.62
G42010100023D,STCTY-42101 TRACT-    0023-D   IN PHILADELPHIA PA,7652,7641,11,6966,9,4787,43.84
G42010100023E,STCTY-42101 TRACT-    0023-E   IN PHILADELPHIA PA,6091,6069,22,5569,18,4910,43.61
G42010100023F,STCTY-42101 TRACT-    0023-F   IN PHILADELPHIA PA,5376,5336,40,4311,40,2395,29.99
G42010100023G,STCTY-42101 TRACT-    0023-G   IN PHILADELPHIA PA,8210,7120,1090,6447,1086,3186,32.53
G42010100023H,STCTY-42101 TRACT-    0023-H   IN PHILADELPHIA PA,5796,5770,26,4906,25,2592,34.41
G42010100023I,STCTY-42101 TRACT-    0023-I   IN PHILADELPHIA PA,6362,6194,168,5333,163,2128,26.73
G42010100023J,STCTY-42101 TRACT-    0023-J   IN PHILADELPHIA PA,936,925,11,699,11,868,0
G42010100023K,STCTY-42101 TRACT-    0023-K   IN PHILADELPHIA PA,5460,5459,1,4004,1,2314,23.64
G42010100024A,STCTY-42101 TRACT-    0024-A   IN PHILADELPHIA PA,566,554,12,499,12,0,0
G42010100024B,STCTY-42101 TRACT-    0024-B   IN PHILADELPHIA PA,8602,8318,284,5119,282,3064,33.56
G42010100024C,STCTY-42101 TRACT-    0024-C   IN PHILADELPHIA PA,12711,8305,4406,6729,4392,2740,29.06
G42010100024D,STCTY-42101 TRACT-    0024-D   IN PHILADELPHIA PA,12156,5498,6658,4528,6648,2187,24.9
G42010100024E,STCTY-42101 TRACT-    0024-E   IN PHILADELPHIA PA,5092,3853,1239,3407,1233,2807,30.03
G42010100024F,STCTY-42101 TRACT-    0024-F   IN PHILADELPHIA PA,9865,6651,3214,5970,3206,3835,30.43
G42010100024G,STCTY-42101 TRACT-    0024-G   IN PHILADELPHIA PA,4811,2241,2570,2001,2570,3438,26.45
G42010100025A,STCTY-42101 TRACT-    0025-A   IN PHILADELPHIA PA,11664,11644,20,10406,3,2470,27.65
G42010100025B,STCTY-42101 TRACT-    0025-B   IN PHILADELPHIA PA,11653,11219,434,9681,434,2264,27.55
G42010100025C,STCTY-42101 TRACT-    0025-C   IN PHILADELPHIA PA,16574,16564,10,13062,0,2260,24.21
G42010100025D,STCTY-42101 TRACT-    0025-D   IN PHILADELPHIA PA,1067,1054,13,843,13,2200,0
G42010100026A,STCTY-42101 TRACT-    0026-A   IN PHILADELPHIA PA,3037,1090,1947,781,1931,2337,26.08
G42010100026B,STCTY-42101 TRACT-    0026-B   IN PHILADELPHIA PA,8700,7356,1344,5310,1339,3187,23.66
G42010100026C,STCTY-42101 TRACT-    0026-C   IN PHILADELPHIA PA,10841,10374,467,7482,461,3059,27.22
G42010100026D,STCTY-42101 TRACT-    0026-D   IN PHILADELPHIA PA,15342,13156,2186,9453,2164,2970,29.8
G42010100026E,STCTY-42101 TRACT-    0026-E   IN PHILADELPHIA PA,21148,21133,15,17875,4,3228,32.62
G42010100026F,STCTY-42101 TRACT-    0026-F   IN PHILADELPHIA PA,1435,1416,19,1313,19,0,37.65
G42010100027A,STCTY-42101 TRACT-    0027-A   IN PHILADELPHIA PA,3470,2947,523,2606,518,4773,28.64
G42010100027B,STCTY-42101 TRACT-    0027-B   IN PHILADELPHIA PA,5514,4685,829,4204,824,6912,35.53
G42010100027C,STCTY-42101 TRACT-    0027-C   IN PHILADELPHIA PA,7289,6868,421,6263,419,5507,41.13
G42010100027D,STCTY-42101 TRACT-    0027-D   IN PHILADELPHIA PA,2360,1459,901,1324,900,0,34.11
G42010100027E,STCTY-42101 TRACT-    0027-E   IN PHILADELPHIA PA,2338,1987,351,1712,343,0,0
G42010100028A,STCTY-42101 TRACT-    0028-A   IN PHILADELPHIA PA,11259,10713,546,9292,520,2275,30.98
G42010100028B,STCTY-42101 TRACT-    0028-B   IN PHILADELPHIA PA,10672,4941,5731,4313,5729,2425,29.19
G42010100028C,STCTY-42101 TRACT-    0028-C   IN PHILADELPHIA PA,17059,13982,3077,9986,3071,2527,30.94
G42010100028D,STCTY-42101 TRACT-    0028-D   IN PHILADELPHIA PA,7315,7311,4,4424,3,2877,34.89
G42010100028E,STCTY-42101 TRACT-    0028-E   IN PHILADELPHIA PA,3686,3445,241,3059,230,2428,29.09
G42010100029A,STCTY-42101 TRACT-    0029-A   IN PHILADELPHIA PA,11488,7937,3551,6165,3543,2535,31.77
G42010100029B,STCTY-42101 TRACT-    0029-B   IN PHILADELPHIA PA,12,12,0,11,0,0,0
G42010100029C,STCTY-42101 TRACT-    0029-C   IN PHILADELPHIA PA,10724,10589,135,8717,128,2350,29.79
G42010100029D,STCTY-42101 TRACT-    0029-D   IN PHILADELPHIA PA,8439,3311,5128,2755,5127,2431,28.71
G42010100030A,STCTY-42101 TRACT-    0030-A   IN PHILADELPHIA PA,16554,785,15769,586,15752,3592,26.67
G42010100030B,STCTY-42101 TRACT-    0030-B   IN PHILADELPHIA PA,11051,4604,6447,4022,6433,2840,25.75
G42010100031A,STCTY-42101 TRACT-    0031-A   IN PHILADELPHIA PA,12901,12896,5,11700,1,2176,25.63
G42010100031B,STCTY-42101 TRACT-    0031-B   IN PHILADELPHIA PA,9855,9853,2,8993,0,2156,26.84
G42010100031C,STCTY-42101 TRACT-    0031-C   IN PHILADELPHIA PA,3484,3484,0,3023,0,2179,25.27
G42010100032A,STCTY-42101 TRACT-    0032-A   IN PHILADELPHIA PA,7437,2802,4635,2526,4548,2387,21.95
G42010100032B,STCTY-42101 TRACT-    0032-B   IN PHILADELPHIA PA,2301,1863,438,1682,420,5815,26.6
G42010100032C,STCTY-42101 TRACT-    0032-C   IN PHILADELPHIA PA,10846,5198,5648,4568,5646,3100,29.26
G42010100032D,STCTY-42101 TRACT-    0032-D   IN PHILADELPHIA PA,14170,1486,12684,1259,12678,2708,26.84
G42010100032E,STCTY-42101 TRACT-    0032-E   IN PHILADELPHIA PA,15297,13608,1689,9053,1683,2653,30.67
G42010100032F,STCTY-42101 TRACT-    0032-F   IN PHILADELPHIA PA,11,11,0,11,0,0,0
G42010100033A,STCTY-42101 TRACT-    0033-A   IN PHILADELPHIA PA,0,0,0,0,0,0,0
G42010100033B,STCTY-42101 TRACT-    0033-B   IN PHILADELPHIA PA,7429,7372,57,6442,46,3634,43.16
G42010100033C,STCTY-42101 TRACT-    0033-C   IN PHILADELPHIA PA,2234,2234,0,1926,0,3693,52.25
G42010100033D,STCTY-42101 TRACT-    0033-D   IN PHILADELPHIA PA,184,184,0,158,0,0,0
G42010100033E,STCTY-42101 TRACT-    0033-E   IN PHILADELPHIA PA,552,503,49,468,49,0,0
G42010100033F,STCTY-42101 TRACT-    0033-F   IN PHILADELPHIA PA,3290,3267,23,2608,23,2542,33.24
G42010100033G,STCTY-42101 TRACT-    0033-G   IN PHILADELPHIA PA,12114,12091,23,9854,13,2438,29.49
G42010100033H,STCTY-42101 TRACT-    0033-H   IN PHILADELPHIA PA,9230,9228,2,7894,0,2680,34.65
G42010100033I,STCTY-42101 TRACT-    0033-I   IN PHILADELPHIA PA,15431,15407,24,13381,1,2263,28.9
G42010100033J,STCTY-42101 TRACT-    0033-J   IN PHILADELPHIA PA,13703,13701,2,11389,0,1979,28.41
G42010100033K,STCTY-42101 TRACT-    0033-K   IN PHILADELPHIA PA,2622,2620,2,2203,0,1857,24.46
G42010100034A,STCTY-42101 TRACT-    0034-A   IN PHILADELPHIA PA,2167,2133,34,1911,33,6017,58.54
G42010100034B,STCTY-42101 TRACT-    0034-B   IN PHILADELPHIA PA,1445,1387,58,1137,58,16278,61.38
G42010100034C,STCTY-42101 TRACT-    0034-C   IN PHILADELPHIA PA,1454,1364,90,1160,90,13292,64.68
G42010100034D,STCTY-42101 TRACT-    0034-D   IN PHILADELPHIA PA,3499,3458,41,2607,40,6390,53.21
G42010100034E,STCTY-42101 TRACT-    0034-E   IN PHILADELPHIA PA,5175,5099,76,3592,76,5912,56.43
G42010100034F,STCTY-42101 TRACT-    0034-F   IN PHILADELPHIA PA,7679,7583,96,5214,96,5180,48.07
G42010100034G,STCTY-42101 TRACT-    0034-G   IN PHILADELPHIA PA,11,11,0,11,0,0,0
G42010100034H,STCTY-42101 TRACT-    0034-H   IN PHILADELPHIA PA,15457,13524,1933,11870,1931,3312,37.67
G42010100034I,STCTY-42101 TRACT-    0034-I   IN PHILADELPHIA PA,19999,18056,1943,15687,1927,3944,39.84
G42010100034J,STCTY-42101 TRACT-    0034-J   IN PHILADELPHIA PA,2892,2790,102,2612,102,9417,56.7
G42010100034K,STCTY-42101 TRACT-    0034-K   IN PHILADELPHIA PA,101,90,11,80,11,0,0
G42010100034L,STCTY-42101 TRACT-    0034-L   IN PHILADELPHIA PA,5,5,0,5,0,0,0
G42010100034M,STCTY-42101 TRACT-    0034-M   IN PHILADELPHIA PA,12516,12506,10,9669,8,3937,41.8
G42010100034N,STCTY-42101 TRACT-    0034-N   IN PHILADELPHIA PA,90,89,1,76,1,0,0
G42010100034O,STCTY-42101 TRACT-    0034-O   IN PHILADELPHIA PA,1,1,0,1,0,0,0
G42010100034P,STCTY-42101 TRACT-    0034-P   IN PHILADELPHIA PA,13789,8809,4980,6845,4963,2838,32.53
G42010100034Q,STCTY-42101 TRACT-    0034-Q   IN PHILADELPHIA PA,13333,3381,9952,2762,9947,3002,33.69
G42010100035A,STCTY-42101 TRACT-    0035-A   IN PHILADELPHIA PA,235,220,15,203,15,0,0
G42010100035AA,STCTY-42101 TRACT-    0035-AA  IN PHILADELPHIA PA,333,333,0,295,0,0,0
G42010100035AAA,STCTY-42101 TRACT-    0035-AAA IN PHILADELPHIA PA,1602,1601,1,1406,1,3408,44.92
G42010100035B,STCTY-42101 TRACT-    0035-B   IN PHILADELPHIA PA,138,138,0,129,0,0,0
G42010100035BB,STCTY-42101 TRACT-    0035-BB  IN PHILADELPHIA PA,34,34,0,24,0,0,0
G42010100035BBB,STCTY-42101 TRACT-    0035-BBB IN PHILADELPHIA PA,529,520,9,444,9,0,0
G42010100035C,STCTY-42101 TRACT-    0035-C   IN PHILADELPHIA PA,6060,5075,985,3501,981,0,0
G42010100035CC,STCTY-42101 TRACT-    0035-CC  IN PHILADELPHIA PA,896,896,0,783,0,5330,0
G42010100035CCC,STCTY-42101 TRACT-    0035-CCC IN PHILADELPHIA PA,2784,2782,2,2429,2,4597,47.55
G42010100035D,STCTY-42101 TRACT-    0035-D   IN PHILADELPHIA PA,311,311,0,304,0,0,0
G42010100035DD,STCTY-42101 TRACT-    0035-DD  IN PHILADELPHIA PA,1340,1340,0,1159,0,5571,0
G42010100035DDD,STCTY-42101 TRACT-    0035-DDD IN PHILADELPHIA PA,2697,2679,18,2088,18,6393,53.99
G42010100035E,STCTY-42101 TRACT-    0035-E   IN PHILADELPHIA PA,473,473,0,438,0,0,0
G42010100035EE,STCTY-42101 TRACT-    0035-EE  IN PHILADELPHIA PA,466,466,0,432,0,0,0
G42010100035EEE,STCTY-42101 TRACT-    0035-EEE IN PHILADELPHIA PA,1398,1396,2,1272,2,8137,60.57
G42010100035F,STCTY-42101 TRACT-    0035-F   IN PHILADELPHIA PA,47,39,8,39,8,0,0
G42010100035FF,STCTY-42101 TRACT-    0035-FF  IN PHILADELPHIA PA,1895,1873,22,1678,21,4791,36.17
G42010100035G,STCTY-42101 TRACT-    0035-G   IN PHILADELPHIA PA,338,337,1,319,1,0,0
G42010100035GG,STCTY-42101 TRACT-    0035-GG  IN PHILADELPHIA PA,4599,4598,1,4137,1,5250,50.99
G42010100035H,STCTY-42101 TRACT-    0035-H   IN PHILADELPHIA PA,41,41,0,33,0,0,0
G42010100035HH,STCTY-42101 TRACT-    0035-HH  IN PHILADELPHIA PA,486,486,0,457,0,0,0
G42010100035I,STCTY-42101 TRACT-    0035-I   IN PHILADELPHIA PA,116,115,1,102,1,0,0
G42010100035II,STCTY-42101 TRACT-    0035-II  IN PHILADELPHIA PA,119,119,0,111,0,0,0
G42010100035J,STCTY-42101 TRACT-    0035-J   IN PHILADELPHIA PA,91,91,0,89,0,0,0
G42010100035JJ,STCTY-42101 TRACT-    0035-JJ  IN PHILADELPHIA PA,627,627,0,547,0,5271,0
G42010100035K,STCTY-42101 TRACT-    0035-K   IN PHILADELPHIA PA,267,261,6,236,6,0,0
G42010100035KK,STCTY-42101 TRACT-    0035-KK  IN PHILADELPHIA PA,3915,3914,1,3167,0,4287,42.54
G42010100035L,STCTY-42101 TRACT-    0035-L   IN PHILADELPHIA PA,293,289,4,255,4,0,0
G42010100035LL,STCTY-42101 TRACT-    0035-LL  IN PHILADELPHIA PA,1168,1168,0,1005,0,4485,43.1
G42010100035M,STCTY-42101 TRACT-    0035-M   IN PHILADELPHIA PA,160,159,1,140,1,0,0
G42010100035MM,STCTY-42101 TRACT-    0035-MM  IN PHILADELPHIA PA,266,265,1,239,1,0,0
G42010100035N,STCTY-42101 TRACT-    0035-N   IN PHILADELPHIA PA,59,55,4,51,4,0,0
G42010100035NN,STCTY-42101 TRACT-    0035-NN  IN PHILADELPHIA PA,2307,2300,7,1926,7,4885,43.5
G42010100035O,STCTY-42101 TRACT-    0035-O   IN PHILADELPHIA PA,69,64,5,58,5,0,0
G42010100035OO,STCTY-42101 TRACT-    0035-OO  IN PHILADELPHIA PA,912,912,0,783,0,6422,0
G42010100035P,STCTY-42101 TRACT-    0035-P   IN PHILADELPHIA PA,85,85,0,72,0,0,0
G42010100035PP,STCTY-42101 TRACT-    0035-PP  IN PHILADELPHIA PA,1501,1501,0,1297,0,5299,0
G42010100035Q,STCTY-42101 TRACT-    0035-Q   IN PHILADELPHIA PA,1037,1037,0,971,0,5780,35.67
G42010100035QQ,STCTY-42101 TRACT-    0035-QQ  IN PHILADELPHIA PA,531,531,0,479,0,5313,0
G42010100035R,STCTY-42101 TRACT-    0035-R   IN PHILADELPHIA PA,140,140,0,124,0,0,0
G42010100035RR,STCTY-42101 TRACT-    0035-RR  IN PHILADELPHIA PA,4832,4832,0,4418,0,5744,44.38
G42010100035S,STCTY-42101 TRACT-    0035-S   IN PHILADELPHIA PA,462,435,27,400,27,0,0
G42010100035SS,STCTY-42101 TRACT-    0035-SS  IN PHILADELPHIA PA,2799,2799,0,2546,0,4678,47.32
G42010100035T,STCTY-42101 TRACT-    0035-T   IN PHILADELPHIA PA,200,130,70,121,70,0,0
G42010100035TT,STCTY-42101 TRACT-    0035-TT  IN PHILADELPHIA PA,2447,2447,0,2184,0,4512,0
G42010100035U,STCTY-42101 TRACT-    0035-U   IN PHILADELPHIA PA,218,218,0,202,0,0,0
G42010100035UU,STCTY-42101 TRACT-    0035-UU  IN PHILADELPHIA PA,971,971,0,873,0,5923,0
G42010100035V,STCTY-42101 TRACT-    0035-V   IN PHILADELPHIA PA,108,106,2,85,2,0,0
G42010100035VV,STCTY-42101 TRACT-    0035-VV  IN PHILADELPHIA PA,4958,4957,1,4162,0,4346,42.07
G42010100035W,STCTY-42101 TRACT-    0035-W   IN PHILADELPHIA PA,631,630,1,542,1,0,0
G42010100035WW,STCTY-42101 TRACT-    0035-WW  IN PHILADELPHIA PA,2438,2438,0,1983,0,4836,44.88
G42010100035X,STCTY-42101 TRACT-    0035-X   IN PHILADELPHIA PA,6,5,1,5,1,0,0
G42010100035XX,STCTY-42101 TRACT-    0035-XX  IN PHILADELPHIA PA,5361,5361,0,4556,0,3949,43.98
G42010100035Y,STCTY-42101 TRACT-    0035-Y   IN PHILADELPHIA PA,1587,1584,3,1403,3,4490,42.67
G42010100035YY,STCTY-42101 TRACT-    0035-YY  IN PHILADELPHIA PA,8658,8657,1,7833,1,4085,43.73
G42010100035Z,STCTY-42101 TRACT-    0035-Z   IN PHILADELPHIA PA,1717,1710,7,1536,6,5428,42.41
G42010100035ZZ,STCTY-42101 TRACT-    0035-ZZ  IN PHILADELPHIA PA,2931,2927,4,2599,4,5397,49.26
G42010100036A,STCTY-42101 TRACT-    0036-A   IN PHILADELPHIA PA,2654,287,2367,188,2361,2174,28.06
G42010100036B,STCTY-42101 TRACT-    0036-B   IN PHILADELPHIA PA,15468,5945,9523,4207,9503,2801,26.78
G42010100036C,STCTY-42101 TRACT-    0036-C   IN PHILADELPHIA PA,18043,13477,4566,11118,4554,2310,28.07
G42010100036D,STCTY-42101 TRACT-    0036-D   IN PHILADELPHIA PA,14333,12997,1336,11354,1330,2403,28.29
G42010100036E,STCTY-42101 TRACT-    0036-E   IN PHILADELPHIA PA,2167,1498,669,1188,669,1679,24.83
G42010100037A,STCTY-42101 TRACT-    0037-A   IN PHILADELPHIA PA,2284,2278,6,2043,0,3911,33.18
G42010100037B,STCTY-42101 TRACT-    0037-B   IN PHILADELPHIA PA,6751,6739,12,5962,0,3061,31.55
G42010100037C,STCTY-42101 TRACT-    0037-C   IN PHILADELPHIA PA,958,927,31,778,4,0,31.93
G42010100037D,STCTY-42101 TRACT-    0037-D   IN PHILADELPHIA PA,2526,2221,305,1853,277,2950,25.42
G42010100037E,STCTY-42101 TRACT-    0037-E   IN PHILADELPHIA PA,527,520,7,442,1,0,0
G42010100037F,STCTY-42101 TRACT-    0037-F   IN PHILADELPHIA PA,7035,5757,1278,5029,1268,2219,26.22
G42010100038A,STCTY-42101 TRACT-    0038-A   IN PHILADELPHIA PA,6258,6199,59,4705,53,2456,26.65
G42010100038B,STCTY-42101 TRACT-    0038-B   IN PHILADELPHIA PA,575,283,292,216,292,0,0
G42010100038C,STCTY-42101 TRACT-    0038-C   IN PHILADELPHIA PA,1069,1021,48,951,48,15931,0
G42010100038D,STCTY-42101 TRACT-    0038-D   IN PHILADELPHIA PA,3055,3034,21,2604,21,3591,34.14
G42010100038E,STCTY-42101 TRACT-    0038-E   IN PHILADELPHIA PA,4915,4914,1,4248,0,4075,36.06
G42010100038F,STCTY-42101 TRACT-    0038-F   IN PHILADELPHIA PA,10050,10044,6,8359,2,3042,36.77
G42010100038G,STCTY-42101 TRACT-    0038-G   IN PHILADELPHIA PA,10438,9937,501,8689,495,3810,36.28
G42010100038H,STCTY-42101 TRACT-    0038-H   IN PHILADELPHIA PA,14518,12504,2014,11020,1994,3763,35.69
G42010100038I,STCTY-42101 TRACT-    0038-I   IN PHILADELPHIA PA,7037,6847,190,5456,186,2572,30.22
G42010100038J,STCTY-42101 TRACT-    0038-J   IN PHILADELPHIA PA,15218,15092,126,12376,117,2791,33.12
G42010100038K,STCTY-42101 TRACT-    0038-K   IN PHILADELPHIA PA,30,30,0,28,0,0,0
G42010100039A,STCTY-42101 TRACT-    0039-A   IN PHILADELPHIA PA,332,318,14,222,5,0,0
G42010100039B,STCTY-42101 TRACT-    0039-B   IN PHILADELPHIA PA,19634,19241,393,14434,391,2175,30.07
G42010100039C,STCTY-42101 TRACT-    0039-C   IN PHILADELPHIA PA,24995,23832,1163,15220,1152,2279,28.86
G42010100039D,STCTY-42101 TRACT-    0039-D   IN PHILADELPHIA PA,19840,19769,71,14883,40,2547,28.45
G42010100039E,STCTY-42101 TRACT-    0039-E   IN PHILADELPHIA PA,6324,6162,162,5394,140,3533,36.7
G42010100039F,STCTY-42101 TRACT-    0039-F   IN PHILADELPHIA PA,75,75,0,70,0,0,0
G42010100039G,STCTY-42101 TRACT-    0039-G   IN PHILADELPHIA PA,0,0,0,0,0,0,0
G42010100039H,STCTY-42101 TRACT-    0039-H   IN PHILADELPHIA PA,345,306,39,273,39,0,0
G42010100039I,STCTY-42101 TRACT-    0039-I   IN PHILADELPHIA PA,124,123,1,119,1,0,0
G42010100039J,STCTY-42101 TRACT-    0039-J   IN PHILADELPHIA PA,0,0,0,0,0,0,0
G42010100039K,STCTY-42101 TRACT-    0039-K   IN PHILADELPHIA PA,1726,1684,42,1657,22,0,0
G42010100040A,STCTY-42101 TRACT-    0040-A   IN PHILADELPHIA PA,508,143,365,105,365,0,24.5
G42010100040AA,STCTY-42101 TRACT-    0040-AA  IN PHILADELPHIA PA,5,5,0,4,0,0,0
G42010100040B,STCTY-42101 TRACT-    0040-B   IN PHILADELPHIA PA,9145,6670,2475,5880,2473,2872,33.36
G42010100040BB,STCTY-42101 TRACT-    0040-BB  IN PHILADELPHIA PA,7,7,0,7,0,0,0
G42010100040C,STCTY-42101 TRACT-    0040-C   IN PHILADELPHIA PA,5019,5013,6,4540,5,3617,39.25
G42010100040D,STCTY-42101 TRACT-    0040-D   IN PHILADELPHIA PA,9445,9434,11,8682,9,3815,43.05
G42010100040E,STCTY-42101 TRACT-    0040-E   IN PHILADELPHIA PA,12417,12410,7,10585,6,3652,39.3
G42010100040F,STCTY-42101 TRACT-    0040-F   IN PHILADELPHIA PA,8505,8493,12,7573,11,2953,36.57
G42010100040G,STCTY-42101 TRACT-    0040-G   IN PHILADELPHIA PA,26,26,0,23,0,0,0
G42010100040H,STCTY-42101 TRACT-    0040-H   IN PHILADELPHIA PA,1120,1120,0,1031,0,0,38.04
G42010100040I,STCTY-42101 TRACT-    0040-I   IN PHILADELPHIA PA,10596,10584,12,9005,1,2643,31.17
G42010100040J,STCTY-42101 TRACT-    0040-J   IN PHILADELPHIA PA,5936,5927,9,5070,8,3892,43.38
G42010100040K,STCTY-42101 TRACT-    0040-K   IN PHILADELPHIA PA,5625,5225,400,4772,399,3740,39.5
G42010100040L,STCTY-42101 TRACT-    0040-L   IN PHILADELPHIA PA,14118,14107,11,12587,3,3135,38.83
G42010100040M,STCTY-42101 TRACT-    0040-M   IN PHILADELPHIA PA,9,3,6,2,6,0,0
G42010100040N,STCTY-42101 TRACT-    0040-N   IN PHILADELPHIA PA,8279,8240,39,7546,37,3168,38.49
G42010100040O,STCTY-42101 TRACT-    0040-O   IN PHILADELPHIA PA,3886,3329,557,3010,555,3155,35.34
G42010100040P,STCTY-42101 TRACT-    0040-P   IN PHILADELPHIA PA,2497,2358,139,2116,139,2873,33.27
G42010100040Q,STCTY-42101 TRACT-    0040-Q   IN PHILADELPHIA PA,2078,1708,370,1333,362,2082,28.41
G42010100040R,STCTY-42101 TRACT-    0040-R   IN PHILADELPHIA PA,23,23,0,18,0,0,0
G42010100040S,STCTY-42101 TRACT-    0040-S   IN PHILADELPHIA PA,168,158,10,153,10,0,0
G42010100040T,STCTY-42101 TRACT-    0040-T   IN PHILADELPHIA PA,27,27,0,27,0,0,0
G42010100040U,STCTY-42101 TRACT-    0040-U   IN PHILADELPHIA PA,2769,1316,1453,1115,1449,2042,23.64
G42010100040V,STCTY-42101 TRACT-    0040-V   IN PHILADELPHIA PA,2476,1755,721,1383,717,2535,25.78
G42010100040W,STCTY-42101 TRACT-    0040-W   IN PHILADELPHIA PA,1071,549,522,473,522,1925,21.47
G42010100040X,STCTY-42101 TRACT-    0040-X   IN PHILADELPHIA PA,1978,1120,858,990,857,2233,25.61
G42010100040Y,STCTY-42101 TRACT-    0040-Y   IN PHILADELPHIA PA,708,514,194,432,193,0,0
G42010100040Z,STCTY-42101 TRACT-    0040-Z   IN PHILADELPHIA PA,78,0,78,0,78,0,0
G42010100041A,STCTY-42101 TRACT-    0041-A   IN PHILADELPHIA PA,94,94,0,54,0,0,0
G42010100041B,STCTY-42101 TRACT-    0041-B   IN PHILADELPHIA PA,316,315,1,284,1,0,0
G42010100041C,STCTY-42101 TRACT-    0041-C   IN PHILADELPHIA PA,498,493,5,449,5,0,0
G42010100041D,STCTY-42101 TRACT-    0041-D   IN PHILADELPHIA PA,79,79,0,72,0,0,0
G42010100041E,STCTY-42101 TRACT-    0041-E   IN PHILADELPHIA PA,2013,1388,625,1206,625,0,40.58
G42010100041F,STCTY-42101 TRACT-    0041-F   IN PHILADELPHIA PA,23,7,16,6,16,0,0
G42010100041G,STCTY-42101 TRACT-    0041-G   IN PHILADELPHIA PA,3030,2658,372,2411,372,3419,39
G42010100041H,STCTY-42101 TRACT-    0041-H   IN PHILADELPHIA PA,4229,4214,15,3801,15,3820,44.44
G42010100041I,STCTY-42101 TRACT-    0041-I   IN PHILADELPHIA PA,8213,8100,113,6862,112,3975,42.14
G42010100041J,STCTY-42101 TRACT-    0041-J   IN PHILADELPHIA PA,3246,3245,1,2868,1,4206,43.6
G42010100041K,STCTY-42101 TRACT-    0041-K   IN PHILADELPHIA PA,4645,4645,0,4143,0,3692,37.13
G42010100041L,STCTY-42101 TRACT-    0041-L   IN PHILADELPHIA PA,4357,4356,1,3874,0,3381,36.02
G42010100041M,STCTY-42101 TRACT-    0041-M   IN PHILADELPHIA PA,3047,3047,0,2691,0,2989,37.1
G42010100041N,STCTY-42101 TRACT-    0041-N   IN PHILADELPHIA PA,6478,6475,3,5780,2,3507,37.16
G42010100041O,STCTY-42101 TRACT-    0041-O   IN PHILADELPHIA PA,629,629,0,563,0,0,0
G42010100041P,STCTY-42101 TRACT-    0041-P   IN PHILADELPHIA PA,285,281,4,263,4,0,0
G42010100041Q,STCTY-42101 TRACT-    0041-Q   IN PHILADELPHIA PA,1461,1214,247,1033,243,1783,20.5
G42010100041R,STCTY-42101 TRACT-    0041-R   IN PHILADELPHIA PA,1474,1287,187,865,185,0,0
G42010100041S,STCTY-42101 TRACT-    0041-S   IN PHILADELPHIA PA,814,507,307,425,305,0,0
G42010100041T,STCTY-42101 TRACT-    0041-T   IN PHILADELPHIA PA,3,3,0,3,0,0,0
G42010100041U,STCTY-42101 TRACT-    0041-U   IN PHILADELPHIA PA,553,553,0,521,0,0,21.35
G42010100041V,STCTY-42101 TRACT-    0041-V   IN PHILADELPHIA PA,266,262,4,229,4,0,0
G42010100042A,STCTY-42101 TRACT-    0042-A   IN PHILADELPHIA PA,1499,1499,0,1287,0,4430,42.7
G42010100042AA,STCTY-42101 TRACT-    0042-AA  IN PHILADELPHIA PA,8127,8121,6,6947,3,3482,40.13
G42010100042B,STCTY-42101 TRACT-    0042-B   IN PHILADELPHIA PA,6294,6293,1,5377,0,3990,45.17
G42010100042BB,STCTY-42101 TRACT-    0042-BB  IN PHILADELPHIA PA,3825,3818,7,3161,7,4328,43.49
G42010100042C,STCTY-42101 TRACT-    0042-C   IN PHILADELPHIA PA,1691,1643,48,1474,47,7957,52.56
G42010100042CC,STCTY-42101 TRACT-    0042-CC  IN PHILADELPHIA PA,110,110,0,97,0,0,0
G42010100042D,STCTY-42101 TRACT-    0042-D   IN PHILADELPHIA PA,3659,3616,43,3169,42,6675,51.9
G42010100042DD,STCTY-42101 TRACT-    0042-DD  IN PHILADELPHIA PA,9312,9306,6,6761,2,3643,44.42
G42010100042E,STCTY-42101 TRACT-    0042-E   IN PHILADELPHIA PA,8227,8215,12,7471,11,4902,55.6
G42010100042EE,STCTY-42101 TRACT-    0042-EE  IN PHILADELPHIA PA,6389,6387,2,5114,1,3328,37.77
G42010100042F,STCTY-42101 TRACT-    0042-F   IN PHILADELPHIA PA,6939,6929,10,6293,10,5498,49.81
G42010100042FF,STCTY-42101 TRACT-    0042-FF  IN PHILADELPHIA PA,2776,2773,3,2189,2,3508,36.61
G42010100042G,STCTY-42101 TRACT-    0042-G   IN PHILADELPHIA PA,128,128,0,122,0,0,0
G42010100042GG,STCTY-42101 TRACT-    0042-GG  IN PHILADELPHIA PA,8786,8777,9,6151,6,4048,43.71
G42010100042H,STCTY-42101 TRACT-    0042-H   IN PHILADELPHIA PA,19,19,0,17,0,0,0
G42010100042HH,STCTY-42101 TRACT-    0042-HH  IN PHILADELPHIA PA,10064,10015,49,7747,31,4530,48.03
G42010100042I,STCTY-42101 TRACT-    0042-I   IN PHILADELPHIA PA,18,18,0,15,0,0,0
G42010100042II,STCTY-42101 TRACT-    0042-II  IN PHILADELPHIA PA,4943,4932,11,4427,7,4819,46.98
G42010100042J,STCTY-42101 TRACT-    0042-J   IN PHILADELPHIA PA,139,139,0,129,0,0,0
G42010100042JJ,STCTY-42101 TRACT-    0042-JJ  IN PHILADELPHIA PA,1588,1588,0,1396,0,3531,45.11
G42010100042K,STCTY-42101 TRACT-    0042-K   IN PHILADELPHIA PA,325,325,0,302,0,0,0
G42010100042KK,STCTY-42101 TRACT-    0042-KK  IN PHILADELPHIA PA,4385,4381,4,3823,4,3384,36.24
G42010100042L,STCTY-42101 TRACT-    0042-L   IN PHILADELPHIA PA,3632,3626,6,3349,6,5497,46.65
G42010100042M,STCTY-42101 TRACT-    0042-M   IN PHILADELPHIA PA,5441,5419,22,4888,14,4283,46.52
G42010100042N,STCTY-42101 TRACT-    0042-N   IN PHILADELPHIA PA,9197,9144,53,7690,47,5225,49.3
G42010100042O,STCTY-42101 TRACT-    0042-O   IN PHILADELPHIA PA,1708,1666,42,1437,42,11892,62.13
G42010100042P,STCTY-42101 TRACT-    0042-P   IN PHILADELPHIA PA,3835,3833,2,3318,2,4112,45.82
G42010100042Q,STCTY-42101 TRACT-    0042-Q   IN PHILADELPHIA PA,7484,7470,14,6386,0,3751,40.29
G42010100042R,STCTY-42101 TRACT-    0042-R   IN PHILADELPHIA PA,3614,3611,3,3216,3,5221,49.19
G42010100042S,STCTY-42101 TRACT-    0042-S   IN PHILADELPHIA PA,3633,3621,12,2952,12,5046,47.54
G42010100042T,STCTY-42101 TRACT-    0042-T   IN PHILADELPHIA PA,4485,4477,8,3649,7,6035,45.96
G42010100042U,STCTY-42101 TRACT-    0042-U   IN PHILADELPHIA PA,7217,6635,582,5739,579,3314,39.12
G42010100042V,STCTY-42101 TRACT-    0042-V   IN PHILADELPHIA PA,5874,5856,18,4964,17,3684,43.73
G42010100042W,STCTY-42101 TRACT-    0042-W   IN PHILADELPHIA PA,3406,3351,55,2729,55,6338,61.29
G42010100042X,STCTY-42101 TRACT-    0042-X   IN PHILADELPHIA PA,132,130,2,110,2,0,0
G42010100042Y,STCTY-42101 TRACT-    0042-Y   IN PHILADELPHIA PA,4463,4459,4,3726,4,4584,45.98
G42010100042Z,STCTY-42101 TRACT-    0042-Z   IN PHILADELPHIA PA,3729,3729,0,3139,0,4150,45.15
G42010100043A,STCTY-42101 TRACT-    0043-A   IN PHILADELPHIA PA,8240,8238,2,6586,1,3081,38.35
G42010100043B,STCTY-42101 TRACT-    0043-B   IN PHILADELPHIA PA,7146,6797,349,5540,346,3256,31.25
G42010100043C,STCTY-42101 TRACT-    0043-C   IN PHILADELPHIA PA,6407,6013,394,5283,387,3575,35.94
G42010100043D,STCTY-42101 TRACT-    0043-D   IN PHILADELPHIA PA,17434,17254,180,14383,171,2789,34.59
G42010100043E,STCTY-42101 TRACT-    0043-E   IN PHILADELPHIA PA,11522,11514,8,9789,1,2578,32.41
G42010100044A,STCTY-42101 TRACT-    0044-A   IN PHILADELPHIA PA,13226,11946,1280,9499,1275,3263,29.88
G42010100044B,STCTY-42101 TRACT-    0044-B   IN PHILADELPHIA PA,16221,6614,9607,5663,9585,2533,27.51
G42010100044C,STCTY-42101 TRACT-    0044-C   IN PHILADELPHIA PA,14296,10124,4172,8956,4131,3278,31.85
G42010100045A,STCTY-42101 TRACT-    0045-A   IN PHILADELPHIA PA,3569,3567,2,3084,0,2013,24.4
G42010100045B,STCTY-42101 TRACT-    0045-B   IN PHILADELPHIA PA,12,12,0,11,0,0,0
G42010100045C,STCTY-42101 TRACT-    0045-C   IN PHILADELPHIA PA,6885,6884,1,5492,1,2608,31.32
G42010100045D,STCTY-42101 TRACT-    0045-D   IN PHILADELPHIA PA,362,362,0,323,0,0,0
G42010100045E,STCTY-42101 TRACT-    0045-E   IN PHILADELPHIA PA,1189,1188,1,1044,1,3390,32.88
G42010100045F,STCTY-42101 TRACT-    0045-F   IN PHILADELPHIA PA,2118,2113,5,1874,0,2686,32.88
G42010100045G,STCTY-42101 TRACT-    0045-G   IN PHILADELPHIA PA,9037,9033,4,7911,0,2778,33.67
G42010100045H,STCTY-42101 TRACT-    0045-H   IN PHILADELPHIA PA,3151,3096,55,2471,55,2372,28.32
G42010100045I,STCTY-42101 TRACT-    0045-I   IN PHILADELPHIA PA,7994,7978,16,5886,16,2365,27.69
G42010100045J,STCTY-42101 TRACT-    0045-J   IN PHILADELPHIA PA,1219,1184,35,1047,35,1708,20.84
G42010100045K,STCTY-42101 TRACT-    0045-K   IN PHILADELPHIA PA,21,21,0,18,0,0,0
G42010100046A,STCTY-42101 TRACT-    0046-A   IN PHILADELPHIA PA,8982,8789,193,7720,186,6114,48.11
G42010100046B,STCTY-42101 TRACT-    0046-B   IN PHILADELPHIA PA,10548,9900,648,8458,638,4148,40.22
G42010100046C,STCTY-42101 TRACT-    0046-C   IN PHILADELPHIA PA,8259,7665,594,5779,585,3639,38.29
G42010100046D,STCTY-42101 TRACT-    0046-D   IN PHILADELPHIA PA,15169,15147,22,11245,13,3628,41.17
G42010100046E,STCTY-42101 TRACT-    0046-E   IN PHILADELPHIA PA,11151,11094,57,8782,49,4593,48.8
G42010100046F,STCTY-42101 TRACT-    0046-F   IN PHILADELPHIA PA,13191,13180,11,10667,7,3506,38.23
G42010100046G,STCTY-42101 TRACT-    0046-G   IN PHILADELPHIA PA,6655,6639,16,5989,3,4473,38.04
G42010100046H,STCTY-42101 TRACT-    0046-H   IN PHILADELPHIA PA,5874,5810,64,5257,64,6188,44.1
G42010100046I,STCTY-42101 TRACT-    0046-I   IN PHILADELPHIA PA,5893,5781,112,5356,108,5276,37.17
G42010100046J,STCTY-42101 TRACT-    0046-J   IN PHILADELPHIA PA,0,0,0,0,0,0,0
G42010100047A,STCTY-42101 TRACT-    0047-A   IN PHILADELPHIA PA,13686,8447,5239,7167,5220,3509,26.59
G42010100047B,STCTY-42101 TRACT-    0047-B   IN PHILADELPHIA PA,5108,505,4603,356,4598,2579,29.86
G42010100047C,STCTY-42101 TRACT-    0047-C   IN PHILADELPHIA PA,10678,3426,7252,3077,7249,2931,25.98
G42010100047D,STCTY-42101 TRACT-    0047-D   IN PHILADELPHIA PA,2486,1327,1159,1144,1155,0,25.84
G42010100048A,STCTY-42101 TRACT-    0048-A   IN PHILADELPHIA PA,18950,18874,76,15035,67,2756,32.76
G42010100048B,STCTY-42101 TRACT-    0048-B   IN PHILADELPHIA PA,2881,2881,0,2312,0,2382,30.78
G42010100048C,STCTY-42101 TRACT-    0048-C   IN PHILADELPHIA PA,4958,4950,8,4314,7,2965,45.43
G42010100048D,STCTY-42101 TRACT-    0048-D   IN PHILADELPHIA PA,656,656,0,602,0,0,0
G42010100048E,STCTY-42101 TRACT-    0048-E   IN PHILADELPHIA PA,133,133,0,125,0,0,0
G42010100048F,STCTY-42101 TRACT-    0048-F   IN PHILADELPHIA PA,10,10,0,10,0,0,0
G44000700001,STCTY-44007 TRACT-    0001     IN PROVIDENCE RI,9781,8939,842,7018,721,3250,21.72
G44000700002,STCTY-44007 TRACT-    0002     IN PROVIDENCE RI,3943,3808,135,3146,135,2795,21.96
G44000700003,STCTY-44007 TRACT-    0003     IN PROVIDENCE RI,6220,6042,178,4870,178,2218,26.2
G44000700004,STCTY-44007 TRACT-    0004     IN PROVIDENCE RI,7119,7099,20,5753,18,3030,28.43
G44000700005,STCTY-44007 TRACT-    0005     IN PROVIDENCE RI,3244,3236,8,2682,8,4419,35.74
G44000700006,STCTY-44007 TRACT-    0006     IN PROVIDENCE RI,4783,4089,694,3294,694,3000,26.27
G44000700007,STCTY-44007 TRACT-    0007     IN PROVIDENCE RI,5184,4781,403,4019,403,2491,29.49
G44000700008,STCTY-44007 TRACT-    0008     IN PROVIDENCE RI,2705,2704,1,2309,0,2875,36.09
G44000700009,STCTY-44007 TRACT-    0009     IN PROVIDENCE RI,8660,8631,29,7075,26,2859,31.21
G44000700010,STCTY-44007 TRACT-    0010     IN PROVIDENCE RI,4227,4227,0,3479,0,5315,44.04
G44000700011,STCTY-44007 TRACT-    0011     IN PROVIDENCE RI,3069,3063,6,2499,1,5773,42.05
G44000700012,STCTY-44007 TRACT-    0012     IN PROVIDENCE RI,2599,2567,32,2163,30,2759,31.38
G44000700013,STCTY-44007 TRACT-    0013     IN PROVIDENCE RI,4925,4787,138,3910,138,3433,34.79
G44000700014,STCTY-44007 TRACT-    0014     IN PROVIDENCE RI,3114,3109,5,2644,0,4746,45.19
G44000700015,STCTY-44007 TRACT-    0015     IN PROVIDENCE RI,3822,3802,20,3098,15,5047,43.49
G44000700016,STCTY-44007 TRACT-    0016     IN PROVIDENCE RI,2443,2442,1,1999,0,5060,41.68
G44000700017,STCTY-44007 TRACT-    0017     IN PROVIDENCE RI,4108,3762,346,3132,341,2772,27.82
G44000700018,STCTY-44007 TRACT-    0018     IN PROVIDENCE RI,7259,6986,273,5320,270,2737,26.36
G44000700019,STCTY-44007 TRACT-    0019     IN PROVIDENCE RI,6766,6766,0,4747,0,2750,24.53
G44000700020,STCTY-44007 TRACT-    0020     IN PROVIDENCE RI,3546,3546,0,2747,0,2530,31.3
G44000700021,STCTY-44007 TRACT-    0021     IN PROVIDENCE RI,5084,5080,4,3610,4,2375,23.5
G44000700022,STCTY-44007 TRACT-    0022     IN PROVIDENCE RI,8208,8207,1,6486,1,2758,30.31
G44000700023,STCTY-44007 TRACT-    0023     IN PROVIDENCE RI,4770,4760,10,3990,10,2819,34.4
G44000700024,STCTY-44007 TRACT-    0024     IN PROVIDENCE RI,7169,7145,24,5666,18,2731,25.13
G44000700025,STCTY-44007 TRACT-    0025     IN PROVIDENCE RI,8015,8011,4,5826,0,2147,24.29
G44000700026,STCTY-44007 TRACT-    0026     IN PROVIDENCE RI,4287,4281,6,3459,0,2912,30.97
G44000700027,STCTY-44007 TRACT-    0027     IN PROVIDENCE RI,6978,6975,3,5379,0,2069,22.25
G44000700028,STCTY-44007 TRACT-    0028     IN PROVIDENCE RI,4499,4499,0,3564,0,4101,33.75
G44000700029,STCTY-44007 TRACT-    0029     IN PROVIDENCE RI,8602,8599,3,6457,0,2779,28.28
G44000700030,STCTY-44007 TRACT-    0030     IN PROVIDENCE RI,4168,4165,3,3279,3,2837,30.52
G44000700031,STCTY-44007 TRACT-    0031     IN PROVIDENCE RI,1696,1696,0,1297,0,2925,28.07
G44000700032,STCTY-44007 TRACT-    0032     IN PROVIDENCE RI,5915,5915,0,4728,0,3250,26.34
G44000700033,STCTY-44007 TRACT-    0033     IN PROVIDENCE RI,5897,5871,26,4812,24,5376,41.93
G44000700034,STCTY-44007 TRACT-    0034     IN PROVIDENCE RI,3884,3599,285,2874,280,3114,24.76
G44000700035,STCTY-44007 TRACT-    0035     IN PROVIDENCE RI,7135,6993,142,4872,136,2047,24.44
G44000700036,STCTY-44007 TRACT-    0036     IN PROVIDENCE RI,3508,3438,70,2848,69,1550,19.8
G44000700037,STCTY-44007 TRACT-    0037     IN PROVIDENCE RI,6480,6476,4,4925,3,4139,36.73
G44000700038,STCTY-44007 TRACT-    0038     IN PROVIDENCE RI,3697,3697,0,2779,0,3145,30.13
G44000700039,STCTY-44007 TRACT-    0039     IN PROVIDENCE RI,3825,3825,0,3086,0,5102,36.3
G44000700040,STCTY-44007 TRACT-    0040     IN PROVIDENCE RI,5814,5813,1,4556,1,3032,25.61
G44000700041,STCTY-44007 TRACT-    0041     IN PROVIDENCE RI,5157,5148,9,3864,7,2696,22.73
G44000700042,STCTY-44007 TRACT-    0042     IN PROVIDENCE RI,7582,6662,920,4897,918,2120,21.61
G44000700043,STCTY-44007 TRACT-    0043     IN PROVIDENCE RI,5951,5455,496,4466,485,9659,42.51
G44000700044,STCTY-44007 TRACT-    0044     IN PROVIDENCE RI,3228,3162,66,2657,65,5633,45.72
G44000700045,STCTY-44007 TRACT-    0045     IN PROVIDENCE RI,4198,4167,31,3634,30,11940,68.11
G44000700046,STCTY-44007 TRACT-    0046     IN PROVIDENCE RI,8947,7614,1333,6158,1330,3664,31.46
G44000700047,STCTY-44007 TRACT-    0047     IN PROVIDENCE RI,4444,4444,0,3732,0,5554,48.19
G44000700048,STCTY-44007 TRACT-    0048     IN PROVIDENCE RI,2843,2836,7,2411,6,6910,60.34
G44000700049,STCTY-44007 TRACT-    0049     IN PROVIDENCE RI,4006,3985,21,3480,20,13608,69.71
G4500030SC0001,STCTY-45003 TRACT- SC 0001     IN AUGUSTA GA-SC ADJ AREA,2629,2209,420,2197,420,3625,22.75
G47003700001,STCTY-47037 TRACT-    0001     IN NASHVILLE TN,8803,8333,470,8295,470,1440,15.84
G47003700002,STCTY-47037 TRACT-    0002     IN NASHVILLE TN,7301,6048,1253,6015,1253,1571,16.86
G47003700003,STCTY-47037 TRACT-    0003     IN NASHVILLE TN,5019,217,4802,209,4799,1750,15.75
G47003700004,STCTY-47037 TRACT-    0004     IN NASHVILLE TN,4660,837,3823,814,3823,0,15.12
G47003700005,STCTY-47037 TRACT-    0005     IN NASHVILLE TN,4917,280,4637,274,4637,1554,12.33
G47003700006,STCTY-47037 TRACT-    0006     IN NASHVILLE TN,765,430,335,404,335,0,12.13
G47003700007,STCTY-47037 TRACT-    0007     IN NASHVILLE TN,1729,1186,543,1118,543,0,17.39
G47003700008,STCTY-47037 TRACT-    0008     IN NASHVILLE TN,3145,2505,640,2442,640,0,19.48
G47003700009,STCTY-47037 TRACT-    0009     IN NASHVILLE TN,811,373,438,372,438,0,9.33
G47003700010,STCTY-47037 TRACT-    0010     IN NASHVILLE TN,2797,1189,1608,1174,1607,0,13.89
G47003700011,STCTY-47037 TRACT-    0011     IN NASHVILLE TN,2761,1177,1584,1134,1584,2930,19.3
G47003700012,STCTY-47037 TRACT-    0012     IN NASHVILLE TN,3039,2976,63,2912,63,4333,35.74
G47003700013,STCTY-47037 TRACT-    0013     IN NASHVILLE TN,4094,3210,884,3136,884,4538,39.09
G47003700014,STCTY-47037 TRACT-    0014     IN NASHVILLE TN,4180,4156,24,4131,24,3607,33.04
G47003700015,STCTY-47037 TRACT-    0015     IN NASHVILLE TN,2968,2512,456,2491,456,2902,26.22
G47003700016,STCTY-47037 TRACT-    0016     IN NASHVILLE TN,5172,1092,4080,1082,4080,1428,12.35
G47003700017,STCTY-47037 TRACT-    0017     IN NASHVILLE TN,5070,3319,1751,3289,1751,1921,12.7
G47003700018,STCTY-47037 TRACT-    0018     IN NASHVILLE TN,5946,3646,2300,3622,2300,1410,13.43
G47003700019,STCTY-47037 TRACT-    0019     IN NASHVILLE TN,4992,1359,3633,1345,3630,1159,12.57
G47003700020,STCTY-47037 TRACT-    0020     IN NASHVILLE TN,8174,8044,130,7925,130,4835,43.46
G47003700021,STCTY-47037 TRACT-    0021     IN NASHVILLE TN,5161,4977,184,4785,184,6464,52.36
G47003700022,STCTY-47037 TRACT-    0022     IN NASHVILLE TN,4839,4734,105,4575,104,4886,41.46
G47003700023,STCTY-47037 TRACT-    0023     IN NASHVILLE TN,3881,3813,68,3692,67,3699,39.03
G47003700024,STCTY-47037 TRACT-    0024     IN NASHVILLE TN,2205,263,1942,249,1942,0,11.87
G47003700025,STCTY-47037 TRACT-    0025     IN NASHVILLE TN,2632,1688,944,1634,944,2821,19.26
G47003700026,STCTY-47037 TRACT-    0026     IN NASHVILLE TN,3882,1876,2006,1861,2006,1053,15.35
G47003700027,STCTY-47037 TRACT-    0027     IN NASHVILLE TN,4111,27,4084,26,4084,1361,14.68
G47003700028,STCTY-47037 TRACT-    0028     IN NASHVILLE TN,5861,5858,3,5823,3,2606,22.27
G47003700029,STCTY-47037 TRACT-    0029     IN NASHVILLE TN,6870,6546,324,6516,324,1430,16.67
G47003700030,STCTY-47037 TRACT-    0030     IN NASHVILLE TN,1587,1030,557,1027,557,1208,12.14
G47003700031,STCTY-47037 TRACT-    0031     IN NASHVILLE TN,3620,3545,75,3525,75,2593,16.44
G47003700032,STCTY-47037 TRACT-    0032     IN NASHVILLE TN,3290,2837,453,2827,453,1840,17.77
G47003700033,STCTY-47037 TRACT-    0033     IN NASHVILLE TN,3558,3374,184,3349,184,2913,21.36
G47003700034,STCTY-47037 TRACT-    0034     IN NASHVILLE TN,3556,2573,983,2558,983,1309,12.4
G47003700035,STCTY-47037 TRACT-    0035     IN NASHVILLE TN,2967,2071,896,2052,896,1899,18.88
G47003700036,STCTY-47037 TRACT-    0036     IN NASHVILLE TN,4463,4280,183,4263,183,1948,17.64
G47003700037,STCTY-47037 TRACT-    0037     IN NASHVILLE TN,5220,4603,617,4581,617,2079,18.44
G47003700038,STCTY-47037 TRACT-    0038     IN NASHVILLE TN,7070,6828,242,6794,242,3118,28.13
G47003700039,STCTY-47037 TRACT-    0039     IN NASHVILLE TN,3274,3250,24,3225,21,3688,32.25
G47003700040,STCTY-47037 TRACT-    0040     IN NASHVILLE TN,3012,3010,2,3004,2,2340,25.42
G47015700001,STCTY-47157 TRACT-    0001     IN MEMPHIS TN,3692,597,3095,568,3095,1293,13.14
G47015700002,STCTY-47157 TRACT-    0002     IN MEMPHIS TN,4307,1812,2495,1773,2495,1693,13.12
G47015700003,STCTY-47157 TRACT-    0003     IN MEMPHIS TN,4840,1652,3188,1575,3188,1733,17.62
G47015700004,STCTY-47157 TRACT-    0004     IN MEMPHIS TN,3667,1569,2098,1535,2098,1348,16.12
G47015700005,STCTY-47157 TRACT-    0005     IN MEMPHIS TN,312,27,285,27,285,0,0
G47015700006,STCTY-47157 TRACT-    0006     IN MEMPHIS TN,3465,234,3231,229,3228,1225,12.61
G47015700007,STCTY-47157 TRACT-    0007     IN MEMPHIS TN,1999,1104,895,1071,895,4582,12.52
G47015700008,STCTY-47157 TRACT-    0008     IN MEMPHIS TN,2948,2939,9,2914,9,1663,22.15
G47015700009,STCTY-47157 TRACT-    0009     IN MEMPHIS TN,2961,727,2234,718,2233,1382,12.12
G47015700010,STCTY-47157 TRACT-    0010     IN MEMPHIS TN,1420,73,1347,72,1347,1023,11.75
G47015700011,STCTY-47157 TRACT-    0011     IN MEMPHIS TN,1690,1681,9,1667,9,2162,22.92
G47015700012,STCTY-47157 TRACT-    0012     IN MEMPHIS TN,1423,1395,28,1375,28,3309,0
G47015700013,STCTY-47157 TRACT-    0013     IN MEMPHIS TN,3590,3581,9,3542,9,2578,25.16
G47015700014,STCTY-47157 TRACT-    0014     IN MEMPHIS TN,989,497,492,486,492,2208,13.57
G47015700015,STCTY-47157 TRACT-    0015     IN MEMPHIS TN,2775,2578,197,2547,197,3728,29.31
G47015700016,STCTY-47157 TRACT-    0016     IN MEMPHIS TN,3303,3153,150,3064,150,7956,56.43
G47015700017,STCTY-47157 TRACT-    0017     IN MEMPHIS TN,6590,6544,46,6299,46,5309,46.73
G47015700018,STCTY-47157 TRACT-    0018     IN MEMPHIS TN,3192,51,3141,45,3141,1170,14.68
G47015700019,STCTY-47157 TRACT-    0019     IN MEMPHIS TN,5010,2791,2219,2717,2219,2138,17.55
G47015700020,STCTY-47157 TRACT-    0020     IN MEMPHIS TN,5435,4239,1196,4134,1195,2395,19.1
G47015700021,STCTY-47157 TRACT-    0021     IN MEMPHIS TN,4959,2497,2462,2413,2462,1368,13.5
G47015700022,STCTY-47157 TRACT-    0022     IN MEMPHIS TN,4997,3113,1884,2942,1880,0,12.57
G47015700023,STCTY-47157 TRACT-    0023     IN MEMPHIS TN,8670,4163,4507,3920,4507,1951,13.69
G47015700024,STCTY-47157 TRACT-    0024     IN MEMPHIS TN,7429,2569,4860,2353,4860,3460,16.22
G47015700025,STCTY-47157 TRACT-    0025     IN MEMPHIS TN,7457,6933,524,6648,524,4447,36.78
G47015700026,STCTY-47157 TRACT-    0026     IN MEMPHIS TN,4877,4471,406,4335,406,6055,46.55
G47015700027,STCTY-47157 TRACT-    0027     IN MEMPHIS TN,3386,3291,95,3231,95,2700,21.95
G47015700028,STCTY-47157 TRACT-    0028     IN MEMPHIS TN,4236,1410,2826,1402,2826,1358,12.93
G47015700029,STCTY-47157 TRACT-    0029     IN MEMPHIS TN,938,829,109,822,109,10250,0
G47015700030,STCTY-47157 TRACT-    0030     IN MEMPHIS TN,506,271,235,270,235,0,0
G47015700031,STCTY-47157 TRACT-    0031     IN MEMPHIS TN,3175,3057,118,3005,118,3964,33.45
G47015700032,STCTY-47157 TRACT-    0032     IN MEMPHIS TN,7181,6635,546,6399,546,3905,39.61
G47015700033,STCTY-47157 TRACT-    0033     IN MEMPHIS TN,4390,4148,242,4086,242,4936,34.53
G47015700034,STCTY-47157 TRACT-    0034     IN MEMPHIS TN,4671,4088,583,4017,583,4912,38.56
G47015700035,STCTY-47157 TRACT-    0035     IN MEMPHIS TN,5096,4259,837,4156,837,6368,17.86
G47015700036,STCTY-47157 TRACT-    0036     IN MEMPHIS TN,5834,4926,908,4814,899,4272,35.56
G47015700037,STCTY-47157 TRACT-    0037     IN MEMPHIS TN,3542,2983,559,2906,559,4563,26.75
G47015700038,STCTY-47157 TRACT-    0038     IN MEMPHIS TN,4723,3655,1068,3585,1068,3235,22.5
G47015700039,STCTY-47157 TRACT-    0039     IN MEMPHIS TN,4289,3346,943,3271,942,0,15.03
G47015700040,STCTY-47157 TRACT-    0040     IN MEMPHIS TN,7161,1884,5277,1809,5277,0,13.15
G47015700041,STCTY-47157 TRACT-    0041     IN MEMPHIS TN,8004,2348,5656,2242,5650,0,10.91
G47015700042,STCTY-47157 TRACT-    0042     IN MEMPHIS TN,3991,2104,1887,1978,1883,0,12.21
G47015700043,STCTY-47157 TRACT-    0043     IN MEMPHIS TN,1751,259,1492,255,1492,0,11.69
G47015700044,STCTY-47157 TRACT-    0044     IN MEMPHIS TN,3185,207,2978,193,2978,0,13.95
G47015700045,STCTY-47157 TRACT-    0045     IN MEMPHIS TN,4914,935,3979,872,3979,2083,13.84
G47015700046,STCTY-47157 TRACT-    0046     IN MEMPHIS TN,5637,3260,2377,3180,2377,3469,17.33
G47015700047,STCTY-47157 TRACT-    0047     IN MEMPHIS TN,5501,4122,1379,4033,1379,2254,22.68
G47015700048,STCTY-47157 TRACT-    0048     IN MEMPHIS TN,4748,258,4490,238,4487,2479,13.46
G47015700049,STCTY-47157 TRACT-    0049     IN MEMPHIS TN,5730,991,4739,974,4739,2409,18.51
G47015700050,STCTY-47157 TRACT-    0050     IN MEMPHIS TN,4922,2547,2375,2500,2375,2774,16.74
G47015700051,STCTY-47157 TRACT-    0051     IN MEMPHIS TN,6212,1629,4583,1584,4582,0,13.38
G47015700052,STCTY-47157 TRACT-    0052     IN MEMPHIS TN,3828,1993,1835,1961,1835,1292,14.44
G47015700053,STCTY-47157 TRACT-    0053     IN MEMPHIS TN,4110,603,3507,591,3507,875,12.41
G47015700054,STCTY-47157 TRACT-    0054     IN MEMPHIS TN,5759,354,5405,326,5405,1215,12.84
G47015700055,STCTY-47157 TRACT-    0055     IN MEMPHIS TN,3633,1680,1953,1649,1953,1375,13.62
G47015700056,STCTY-47157 TRACT-    0056     IN MEMPHIS TN,937,872,65,854,65,3949,0
G47015700057,STCTY-47157 TRACT-    0057     IN MEMPHIS TN,5316,3118,2198,3058,2198,1816,16.53
G47015700058,STCTY-47157 TRACT-    0058     IN MEMPHIS TN,4401,3096,1305,3031,1305,2017,18.22
G47015700059,STCTY-47157 TRACT-    0059     IN MEMPHIS TN,6971,6496,475,6317,474,2763,24.59
G47015700060,STCTY-47157 TRACT-    0060     IN MEMPHIS TN,1550,316,1234,311,1234,1437,16.38
G47015700061,STCTY-47157 TRACT-    0061     IN MEMPHIS TN,1772,94,1678,93,1678,1985,13.77
G47015700062,STCTY-47157 TRACT-    0062     IN MEMPHIS TN,5015,4334,681,4280,681,3726,32.15
G47015700063,STCTY-47157 TRACT-    0063     IN MEMPHIS TN,5272,4526,746,4451,746,3447,31.48
G47015700064,STCTY-47157 TRACT-    0064     IN MEMPHIS TN,2472,2423,49,2362,49,6109,40.05
G47015700065,STCTY-47157 TRACT-    0065     IN MEMPHIS TN,1954,289,1665,282,1665,1165,12.52
G47015700066,STCTY-47157 TRACT-    0066     IN MEMPHIS TN,4058,4024,34,3963,34,3238,27.55
G47015700067,STCTY-47157 TRACT-    0067     IN MEMPHIS TN,5419,295,5124,288,5123,1518,13.37
G47015700068,STCTY-47157 TRACT-    0068     IN MEMPHIS TN,2194,336,1858,320,1855,1387,14.99
G47015700069,STCTY-47157 TRACT-    0069     IN MEMPHIS TN,1345,1307,38,1294,38,3604,0
G47015700070,STCTY-47157 TRACT-    0070     IN MEMPHIS TN,3154,3129,25,3102,25,3715,33.01
G47015700071,STCTY-47157 TRACT-    0071     IN MEMPHIS TN,1617,1535,82,1509,82,4823,28.11
G47015700072,STCTY-47157 TRACT-    0072     IN MEMPHIS TN,2254,2195,59,2171,59,4410,37.46
G47015700073,STCTY-47157 TRACT-    0073     IN MEMPHIS TN,1194,1145,49,1135,49,6245,40.93
G47015700074,STCTY-47157 TRACT-    0074     IN MEMPHIS TN,2313,2295,18,2283,18,3405,30.78
G47015700075,STCTY-47157 TRACT-    0075     IN MEMPHIS TN,684,519,165,516,165,0,10.59
G4701570S0001,STCTY-47157 TRACT-  S 0001     IN MEMPHIS TN ADJ AREA,677,149,528,148,528,0,12.23
G4701570S0002,STCTY-47157 TRACT-  S 0002     IN MEMPHIS TN ADJ AREA,2919,1173,1746,1166,1744,1208,10.91
G4701570S0003,STCTY-47157 TRACT-  S 0003     IN MEMPHIS TN ADJ AREA,1231,931,300,874,300,0,0
G4701570S0004,STCTY-47157 TRACT-  S 0004     IN MEMPHIS TN ADJ AREA,1850,1292,558,1251,558,7684,0
G4701570S0005,STCTY-47157 TRACT-  S 0005     IN MEMPHIS TN ADJ AREA,322,113,209,103,209,0,0
G4701570S0006,STCTY-47157 TRACT-  S 0006     IN MEMPHIS TN ADJ AREA,1370,1229,141,1211,141,2697,0
G4701570S0007,STCTY-47157 TRACT-  S 0007     IN MEMPHIS TN ADJ AREA,803,495,308,469,308,0,0
G4701570S0008,STCTY-47157 TRACT-  S 0008     IN MEMPHIS TN ADJ AREA,1716,877,839,850,839,1468,11.77
G4701570S0009,STCTY-47157 TRACT-  S 0009     IN MEMPHIS TN ADJ AREA,1680,1522,158,1495,158,2375,14.72
G48011300001,STCTY-48113 TRACT-    0001     IN DALLAS TX,2883,2587,296,2535,296,8168,23.78
G48011300002,STCTY-48113 TRACT-    0002     IN DALLAS TX,3745,3685,60,3605,60,5369,44.68
G48011300003,STCTY-48113 TRACT-    0003     IN DALLAS TX,3818,3758,60,3679,60,5626,52.51
G48011300004,STCTY-48113 TRACT-    0004     IN DALLAS TX,8225,8198,27,8105,22,3161,23.95
G48011300005,STCTY-48113 TRACT-    0005     IN DALLAS TX,4339,4255,84,4156,83,3402,33.44
G48011300006,STCTY-48113 TRACT-    0006     IN DALLAS TX,9627,9089,538,8853,535,4656,42.1
G48011300007,STCTY-48113 TRACT-    0007     IN DALLAS TX,6414,5716,698,5580,694,3039,30.75
G48011300008,STCTY-48113 TRACT-    0008     IN DALLAS TX,3936,3847,89,3774,89,3155,31.54
G48011300009,STCTY-48113 TRACT-    0009     IN DALLAS TX,3418,3329,89,3242,87,3983,36.33
G48011300010,STCTY-48113 TRACT-    0010     IN DALLAS TX,5888,5785,103,5679,99,3644,39.44
G48011300011,STCTY-48113 TRACT-    0011     IN DALLAS TX,8128,7955,173,7797,173,3616,38.75
G48011300012,STCTY-48113 TRACT-    0012     IN DALLAS TX,5993,5875,118,5773,118,3740,29.74
G48011300013,STCTY-48113 TRACT-    0013     IN DALLAS TX,8031,7645,386,7483,383,3650,30.19
G48011300014,STCTY-48113 TRACT-    0014     IN DALLAS TX,2644,2259,385,2200,385,8979,12.91
G48011300015,STCTY-48113 TRACT-    0015     IN DALLAS TX,11705,11104,601,10870,596,2986,25.65
G48011300016,STCTY-48113 TRACT-    0016     IN DALLAS TX,8786,2744,6042,2601,6039,2294,21.05
G48011300017,STCTY-48113 TRACT-    0017     IN DALLAS TX,12027,2281,9746,2062,9741,2495,19.9
G48011300018,STCTY-48113 TRACT-    0018     IN DALLAS TX,4025,3859,166,3682,166,2750,26.84
G48011300019,STCTY-48113 TRACT-    0019     IN DALLAS TX,5584,5377,207,4155,206,550,10.43
G48011300020,STCTY-48113 TRACT-    0020     IN DALLAS TX,5378,5145,233,5070,228,2948,28.11
G48011300021,STCTY-48113 TRACT-    0021     IN DALLAS TX,2915,2727,188,2391,187,0,12.72
G48011300022,STCTY-48113 TRACT-    0022     IN DALLAS TX,8301,6200,2101,5944,2098,2363,16.61
G48011300023,STCTY-48113 TRACT-    0023     IN DALLAS TX,5046,3727,1319,3670,1319,2181,20.6
G48011300024,STCTY-48113 TRACT-    0024     IN DALLAS TX,4326,4239,87,4201,87,2322,25.7
G48011300025,STCTY-48113 TRACT-    0025     IN DALLAS TX,4547,2045,2502,2011,2501,1240,17.73
G48011300026,STCTY-48113 TRACT-    0026     IN DALLAS TX,2597,2595,2,2548,2,3123,26.1
G48011300027,STCTY-48113 TRACT-    0027     IN DALLAS TX,7346,4419,2927,4331,2925,1374,16.59
G48011300028,STCTY-48113 TRACT-    0028     IN DALLAS TX,4849,4701,148,4619,147,1764,17.73
G48011300029,STCTY-48113 TRACT-    0029     IN DALLAS TX,2420,2154,266,2090,266,2430,19
G48011300030,STCTY-48113 TRACT-    0030     IN DALLAS TX,7754,4095,3659,3866,3655,1588,14.03
G48011300031,STCTY-48113 TRACT-    0031     IN DALLAS TX,2516,2106,410,1977,410,0,10.03
G48011300032,STCTY-48113 TRACT-    0032     IN DALLAS TX,4024,3626,398,3488,395,0,13.97
G48011300033,STCTY-48113 TRACT-    0033     IN DALLAS TX,5647,4963,684,4818,680,1813,16.06
G48011300034,STCTY-48113 TRACT-    0034     IN DALLAS TX,5816,5151,665,4768,656,2641,20
G48011300035,STCTY-48113 TRACT-    0035     IN DALLAS TX,2631,2404,227,1995,227,5227,26.81
G48011300036,STCTY-48113 TRACT-    0036     IN DALLAS TX,3373,3262,111,3035,111,2618,25.21
G48011300037,STCTY-48113 TRACT-    0037     IN DALLAS TX,7442,2121,5321,2073,5321,2035,20.69
G48011300038,STCTY-48113 TRACT-    0038     IN DALLAS TX,3985,3912,73,3848,73,1775,22.23
G48011300039,STCTY-48113 TRACT-    0039     IN DALLAS TX,6601,2933,3668,2891,3668,1022,14.73
G48011300040,STCTY-48113 TRACT-    0040     IN DALLAS TX,4204,4137,67,3892,67,2413,23.42
G48011300041,STCTY-48113 TRACT-    0041     IN DALLAS TX,5345,2043,3302,2019,3302,1375,16.75
G48011300042,STCTY-48113 TRACT-    0042     IN DALLAS TX,4476,4354,122,4289,122,4062,31.09
G48011300043,STCTY-48113 TRACT-    0043     IN DALLAS TX,1313,1268,45,1260,45,1720,15.22
G48011300044,STCTY-48113 TRACT-    0044     IN DALLAS TX,4971,4856,115,4786,115,5739,35.06
G48011300045,STCTY-48113 TRACT-    0045     IN DALLAS TX,2963,2950,13,2914,13,3645,32.03
G48011300046,STCTY-48113 TRACT-    0046     IN DALLAS TX,2937,2868,69,2829,67,3530,29.25
G48011300047,STCTY-48113 TRACT-    0047     IN DALLAS TX,4754,4670,84,4640,84,2810,27.73
G48011300048,STCTY-48113 TRACT-    0048     IN DALLAS TX,4865,4779,86,4723,79,2801,24.69
G48011300049,STCTY-48113 TRACT-    0049     IN DALLAS TX,3367,3330,37,3313,37,2845,24.39
G48011300050,STCTY-48113 TRACT-    0050     IN DALLAS TX,5358,5258,100,5186,100,3077,28.65
G48011300051,STCTY-48113 TRACT-    0051     IN DALLAS TX,4084,4066,18,4032,18,3174,30.86
G48011300052,STCTY-48113 TRACT-    0052     IN DALLAS TX,5304,5260,44,5211,44,3444,29.88
G48011300053,STCTY-48113 TRACT-    0053     IN DALLAS TX,5448,5446,2,5407,2,3037,29.56
G48011300054,STCTY-48113 TRACT-    0054     IN DALLAS TX,5144,5120,24,5073,24,3224,29.01
G48011300055,STCTY-48113 TRACT-    0055     IN DALLAS TX,3074,3070,4,3038,3,2592,25.77
G48011300056,STCTY-48113 TRACT-    0056     IN DALLAS TX,4589,4586,3,4542,2,1885,22.53
G48011300057,STCTY-48113 TRACT-    0057     IN DALLAS TX,4307,4306,1,4267,1,2122,21.95
G48011300058,STCTY-48113 TRACT-    0058     IN DALLAS TX,1501,6,1495,5,1494,1576,13.37
G4801130D0001,STCTY-48113 TRACT-  D 0001     IN DALLAS TX ADJ AREA,2671,2586,85,2560,79,5721,46.14
G4801130D0002,STCTY-48113 TRACT-  D 0002     IN DALLAS TX ADJ AREA,4342,4156,186,4088,185,5929,45.64
G4801130D0003,STCTY-48113 TRACT-  D 0003     IN DALLAS TX ADJ AREA,7445,7006,439,6832,438,7053,59.29
G4801130D0004,STCTY-48113 TRACT-  D 0004     IN DALLAS TX ADJ AREA,2803,2527,276,2470,275,6558,47.42
G4801130D0005,STCTY-48113 TRACT-  D 0005     IN DALLAS TX ADJ AREA,3098,2612,486,2563,481,10170,12.74
G4801130D0006,STCTY-48113 TRACT-  D 0006     IN DALLAS TX ADJ AREA,4387,3831,556,3746,554,10200,12.54
G48020100001,STCTY-48201 TRACT-    0001     IN HOUSTON TX,4472,949,3523,903,3518,936,12.66
G48020100002,STCTY-48201 TRACT-    0002     IN HOUSTON TX,7216,7195,21,6954,15,2372,24.59
G48020100003,STCTY-48201 TRACT-    0003     IN HOUSTON TX,5649,4678,971,4500,971,2079,20.22
G48020100004,STCTY-48201 TRACT-    0004     IN HOUSTON TX,10519,10485,34,10225,33,3390,30.23
G48020100005,STCTY-48201 TRACT-    0005     IN HOUSTON TX,10579,10439,140,10167,135,2954,28.94
G48020100006,STCTY-48201 TRACT-    0006     IN HOUSTON TX,3257,2897,360,2816,359,1769,18.2
G48020100007,STCTY-48201 TRACT-    0007     IN HOUSTON TX,6364,6326,38,6145,28,1586,20.4
G48020100008,STCTY-48201 TRACT-    0008     IN HOUSTON TX,3814,242,3572,172,3572,1842,19.37
G48020100009,STCTY-48201 TRACT-    0009     IN HOUSTON TX,14400,4082,10318,3831,10312,2136,19.11
G48020100010,STCTY-48201 TRACT-    0010     IN HOUSTON TX,14354,14099,255,13304,253,2750,25.49
G48020100011,STCTY-48201 TRACT-    0011     IN HOUSTON TX,11500,11459,41,11127,39,3848,32.2
G48020100012,STCTY-48201 TRACT-    0012     IN HOUSTON TX,7117,4834,2283,4679,2282,1857,20.04
G48020100013,STCTY-48201 TRACT-    0013     IN HOUSTON TX,6855,6616,239,6402,239,1726,19.67
G48020100014,STCTY-48201 TRACT-    0014     IN HOUSTON TX,6965,6593,372,6352,372,2708,24.56
G48020100015,STCTY-48201 TRACT-    0015     IN HOUSTON TX,10243,8144,2099,7586,2098,2693,20.97
G48020100016,STCTY-48201 TRACT-    0016     IN HOUSTON TX,9370,7535,1835,6664,1829,2377,17.53
G48020100017,STCTY-48201 TRACT-    0017     IN HOUSTON TX,5588,4537,1051,3776,1051,1761,15.93
G48020100018,STCTY-48201 TRACT-    0018     IN HOUSTON TX,13038,999,12039,822,12039,1536,15.92
G48020100019,STCTY-48201 TRACT-    0019     IN HOUSTON TX,8471,8369,102,7482,72,2277,19.29
G48020100020,STCTY-48201 TRACT-    0020     IN HOUSTON TX,9617,9507,110,8907,87,2506,24.04
G48020100021,STCTY-48201 TRACT-    0021     IN HOUSTON TX,7701,7691,10,7484,8,2907,26.91
G48020100022,STCTY-48201 TRACT-    0022     IN HOUSTON TX,11946,11925,21,11569,20,3517,28.78
G48020100023,STCTY-48201 TRACT-    0023     IN HOUSTON TX,8561,7487,1074,6369,1070,3000,14.34
G48020100024,STCTY-48201 TRACT-    0024     IN HOUSTON TX,4271,3728,543,3376,543,3571,20.24
G48020100025,STCTY-48201 TRACT-    0025     IN HOUSTON TX,8383,8134,249,7677,242,0,21.89
G48020100026,STCTY-48201 TRACT-    0026     IN HOUSTON TX,6246,5845,401,5558,365,0,34.78
G48020100027,STCTY-48201 TRACT-    0027     IN HOUSTON TX,13267,1765,11502,1614,11489,3436,22.06
G48020100028,STCTY-48201 TRACT-    0028     IN HOUSTON TX,6015,5621,394,5412,392,4344,40.41
G48020100029,STCTY-48201 TRACT-    0029     IN HOUSTON TX,4707,4161,546,4089,543,14027,61.72
G48020100030,STCTY-48201 TRACT-    0030     IN HOUSTON TX,14076,13382,694,12890,680,4570,40.7
G48020100031,STCTY-48201 TRACT-    0031     IN HOUSTON TX,5218,5013,205,4812,205,5542,31.5
G48020100032,STCTY-48201 TRACT-    0032     IN HOUSTON TX,6707,6391,316,6106,307,7574,22.7
G48020100033,STCTY-48201 TRACT-    0033     IN HOUSTON TX,5341,4053,1288,3605,1274,4000,27.22
G48020100034,STCTY-48201 TRACT-    0034     IN HOUSTON TX,7355,1741,5614,1629,5614,3473,21.37
G48020100035,STCTY-48201 TRACT-    0035     IN HOUSTON TX,6752,6702,50,6441,49,4776,37.18
G48020100036,STCTY-48201 TRACT-    0036     IN HOUSTON TX,9903,9588,315,9260,310,4187,37.31
G48020100037,STCTY-48201 TRACT-    0037     IN HOUSTON TX,12792,200,12592,175,12585,2186,20.17
G48020100038,STCTY-48201 TRACT-    0038     IN HOUSTON TX,6533,80,6453,69,6453,1815,19.69
G48020100039,STCTY-48201 TRACT-    0039     IN HOUSTON TX,6848,5748,1100,5253,1100,5063,32.5
G48020100040,STCTY-48201 TRACT-    0040     IN HOUSTON TX,7607,6961,646,6711,646,7187,40.64
G48020100041,STCTY-48201 TRACT-    0041     IN HOUSTON TX,6212,6039,173,5875,172,5958,49.96
G48020100042,STCTY-48201 TRACT-    0042     IN HOUSTON TX,7350,6894,456,6713,454,7670,51.7
G48020100043,STCTY-48201 TRACT-    0043     IN HOUSTON TX,6746,6337,409,6161,409,8120,53.77
G48020100044,STCTY-48201 TRACT-    0044     IN HOUSTON TX,3477,3331,146,3150,146,7962,46.65
G48020100045,STCTY-48201 TRACT-    0045     IN HOUSTON TX,6689,6555,134,6054,122,6081,45.33
G48020100046,STCTY-48201 TRACT-    0046     IN HOUSTON TX,6916,6476,440,6183,440,9036,48.82
G48020100047,STCTY-48201 TRACT-    0047     IN HOUSTON TX,2591,2439,152,2337,152,6678,22.13
G48020100048,STCTY-48201 TRACT-    0048     IN HOUSTON TX,3393,3358,35,3253,35,3841,34.76
G48020100049,STCTY-48201 TRACT-    0049     IN HOUSTON TX,7075,6024,1051,5818,1031,2201,22.8
G48020100050,STCTY-48201 TRACT-    0050     IN HOUSTON TX,4448,4305,143,4189,142,4210,34.08
G48045300001,STCTY-48453 TRACT-    0001     IN AUSTIN TX,9021,8821,200,8694,198,6027,43.27
G48045300002,STCTY-48453 TRACT-    0002     IN AUSTIN TX,7347,6445,902,6236,902,3213,30.64
G48045300003,STCTY-48453 TRACT-    0003     IN AUSTIN TX,6372,6350,22,6195,17,3151,29.63
G48045300004,STCTY-48453 TRACT-    0004     IN AUSTIN TX,4041,3177,864,3084,864,3004,29.3
G48045300005,STCTY-48453 TRACT-    0005     IN AUSTIN TX,3033,3010,23,2932,23,5667,41.17
G48045300006,STCTY-48453 TRACT-    0006     IN AUSTIN TX,4146,3995,151,3882,151,7445,42.11
G48045300007,STCTY-48453 TRACT-    0007     IN AUSTIN TX,5348,4973,375,4748,372,4459,30.16
G48045300008,STCTY-48453 TRACT-    0008     IN AUSTIN TX,9701,1825,7876,1723,7874,1198,13.26
G48045300009,STCTY-48453 TRACT-    0009     IN AUSTIN TX,11903,8850,3053,7852,3046,1207,11.45
G48045300010,STCTY-48453 TRACT-    0010     IN AUSTIN TX,5485,5475,10,5343,0,1862,20.76
G48045300011,STCTY-48453 TRACT-    0011     IN AUSTIN TX,7212,6885,327,6433,312,5261,19.27
G48045300012,STCTY-48453 TRACT-    0012     IN AUSTIN TX,4965,4392,573,4251,573,3482,27.9
G48045300013,STCTY-48453 TRACT-    0013     IN AUSTIN TX,5581,5089,492,4983,492,2408,20.69
G48045300014,STCTY-48453 TRACT-    0014     IN AUSTIN TX,3775,3738,37,3673,37,3702,33.15
G5107600E0001,STCTY-51760 TRACT-  E 0001     IN RICHMOND VA,2858,970,1888,911,1887,0,17.18
G5107600E0002,STCTY-51760 TRACT-  E 0002     IN RICHMOND VA,5533,2513,3020,2475,3020,2134,15.73
G5107600E0003,STCTY-51760 TRACT-  E 0003     IN RICHMOND VA,4272,2204,2068,2190,2068,1770,17.32
G5107600E0004,STCTY-51760 TRACT-  E 0004     IN RICHMOND VA,5301,1811,3490,1784,3489,1450,17.07
G5107600E0005,STCTY-51760 TRACT-  E 0005     IN RICHMOND VA,5294,4031,1263,3951,1263,2048,19.74
G5107600E0006,STCTY-51760 TRACT-  E 0006     IN RICHMOND VA,5691,3573,2118,3292,2107,2188,14.64
G5107600E0007,STCTY-51760 TRACT-  E 0007     IN RICHMOND VA,4604,2790,1814,2754,1814,3171,24.15
G5107600E0008,STCTY-51760 TRACT-  E 0008     IN RICHMOND VA,4405,4095,310,4056,310,3323,26.59
G5107600E0009,STCTY-51760 TRACT-  E 0009     IN RICHMOND VA,5548,2874,2674,2838,2659,2026,14.4
G5107600N0001,STCTY-51760 TRACT-  N 0001     IN RICHMOND VA,4213,88,4125,70,4117,2196,18.08
G5107600N0002,STCTY-51760 TRACT-  N 0002     IN RICHMOND VA,3857,327,3530,295,3520,3087,20.74
G5107600N0003,STCTY-51760 TRACT-  N 0003     IN RICHMOND VA,5427,81,5346,39,5345,2475,19.2
G5107600N0004,STCTY-51760 TRACT-  N 0004     IN RICHMOND VA,3786,3146,640,3090,640,4404,32.22
G5107600N0005,STCTY-51760 TRACT-  N 0005     IN RICHMOND VA,3554,3537,17,3483,17,4193,32.92
G5107600N0006,STCTY-51760 TRACT-  N 0006     IN RICHMOND VA,5504,117,5387,66,5383,2280,16.39
G5107600N0007,STCTY-51760 TRACT-  N 0007     IN RICHMOND VA,4537,120,4417,69,4411,2764,16.56
G5107600N0008,STCTY-51760 TRACT-  N 0008     IN RICHMOND VA,3257,71,3186,54,3186,1806,15.32
G5107600N0009,STCTY-51760 TRACT-  N 0009     IN RICHMOND VA,3776,2319,1457,2252,1457,4981,29.73
G5107600N0010,STCTY-51760 TRACT-  N 0010     IN RICHMOND VA,3765,3747,18,3700,16,6005,45.32
G5107600N0011,STCTY-51760 TRACT-  N 0011     IN RICHMOND VA,3770,3346,424,3278,424,5131,42.56
G5107600N0012,STCTY-51760 TRACT-  N 0012     IN RICHMOND VA,4884,4822,62,4722,62,4459,37.73
G5107600N0013,STCTY-51760 TRACT-  N 0013     IN RICHMOND VA,1235,1233,2,1219,2,0,24.31
G5107600N0014,STCTY-51760 TRACT-  N 0014     IN RICHMOND VA,224,224,0,223,0,0,0
G5107600N0015,STCTY-51760 TRACT-  N 0015     IN RICHMOND VA,6494,6310,184,6198,184,8296,61.8
G5107600S0001,STCTY-51760 TRACT-  S 0001     IN RICHMOND VA,4677,4307,370,4254,370,2162,20.93
G5107600S0002,STCTY-51760 TRACT-  S 0002     IN RICHMOND VA,2474,2047,427,2037,427,2987,22.99
G5107600S0003,STCTY-51760 TRACT-  S 0003     IN RICHMOND VA,5016,2425,2591,2381,2589,2412,21.77
G5107600S0004,STCTY-51760 TRACT-  S 0004     IN RICHMOND VA,5702,4800,902,4735,902,3288,25.6
G5107600S0005,STCTY-51760 TRACT-  S 0005     IN RICHMOND VA,4760,4466,294,4421,294,5547,33.82
G5107600W0001,STCTY-51760 TRACT-  W 0001     IN RICHMOND VA,447,444,3,425,3,0,0
G5107600W0002,STCTY-51760 TRACT-  W 0002     IN RICHMOND VA,2749,2248,501,2179,493,0,17.92
G5107600W0003,STCTY-51760 TRACT-  W 0003     IN RICHMOND VA,3274,2392,882,2298,882,0,18.64
G5107600W0004,STCTY-51760 TRACT-  W 0004     IN RICHMOND VA,5626,4342,1284,4289,1284,2018,20.72
G5107600W0005,STCTY-51760 TRACT-  W 0005     IN RICHMOND VA,2756,1574,1182,1514,1182,2556,21.54
G5107600W0006,STCTY-51760 TRACT-  W 0006     IN RICHMOND VA,4589,4470,119,4327,112,5500,35.94
G5107600W0007,STCTY-51760 TRACT-  W 0007     IN RICHMOND VA,4026,975,3051,953,3051,1918,15.02
G5107600W0008,STCTY-51760 TRACT-  W 0008     IN RICHMOND VA,3245,1461,1784,1412,1784,2391,21.12
G5107600W0009,STCTY-51760 TRACT-  W 0009     IN RICHMOND VA,5528,5438,90,5326,88,6982,47.55
G5107600W0010,STCTY-51760 TRACT-  W 0010     IN RICHMOND VA,3852,3807,45,3607,45,5965,39.06
G5107600W0011,STCTY-51760 TRACT-  W 0011     IN RICHMOND VA,4237,4233,4,4093,4,4016,30.9
G5107600W0012,STCTY-51760 TRACT-  W 0012     IN RICHMOND VA,5598,5554,44,5411,42,5716,45.71
G5107600W0013,STCTY-51760 TRACT-  W 0013     IN RICHMOND VA,5480,5354,126,5193,125,6783,46.88
G5107600W0014,STCTY-51760 TRACT-  W 0014     IN RICHMOND VA,2960,2921,39,2799,39,5456,39.17
G5107600W0015,STCTY-51760 TRACT-  W 0015     IN RICHMOND VA,3585,3549,36,3426,34,6452,43.07
G5107600W0016,STCTY-51760 TRACT-  W 0016     IN RICHMOND VA,2818,2773,45,2638,44,7091,48.78
G5107600W0017,STCTY-51760 TRACT-  W 0017     IN RICHMOND VA,3164,3161,3,3086,3,4798,40.07
G5107600W0018,STCTY-51760 TRACT-  W 0018     IN RICHMOND VA,4690,4616,74,4480,73,8468,54.58
G5300330A0001,STCTY-53033 TRACT-  A 0001     IN SEATTLE WA,4688,4687,1,3686,0,3356,28.03
G5300330A0002,STCTY-53033 TRACT-  A 0002     IN SEATTLE WA,5253,5235,18,4310,17,3430,31.13
G5300330A0003,STCTY-53033 TRACT-  A 0003     IN SEATTLE WA,5549,5544,5,4523,2,2648,23.88
G5300330A0004,STCTY-53033 TRACT-  A 0004     IN SEATTLE WA,5267,5242,25,4083,1,2754,24.18
G5300330A0005,STCTY-53033 TRACT-  A 0005     IN SEATTLE WA,5288,5261,27,4249,6,2155,19.43
G5300330B0001,STCTY-53033 TRACT-  B 0001     IN SEATTLE WA,4651,4647,4,3823,2,3369,30.5
G5300330B0002,STCTY-53033 TRACT-  B 0002     IN SEATTLE WA,4650,4639,11,3994,8,3186,28.97
G5300330B0003,STCTY-53033 TRACT-  B 0003     IN SEATTLE WA,4076,4073,3,3399,2,3752,34.45
G5300330B0004,STCTY-53033 TRACT-  B 0004     IN SEATTLE WA,3394,3390,4,2759,3,3228,30.65
G5300330B0005,STCTY-53033 TRACT-  B 0005     IN SEATTLE WA,3732,3732,0,2991,0,2726,25.06
G5300330B0006,STCTY-53033 TRACT-  B 0006     IN SEATTLE WA,4601,4581,20,3781,1,3136,28.08
G5300330C0001,STCTY-53033 TRACT-  C 0001     IN SEATTLE WA,5587,5574,13,4866,0,3921,38.16
G5300330C0002,STCTY-53033 TRACT-  C 0002     IN SEATTLE WA,4813,4795,18,4168,4,3205,31.26
G5300330C0003,STCTY-53033 TRACT-  C 0003     IN SEATTLE WA,3704,3697,7,3122,2,3378,32.88
G5300330C0004,STCTY-53033 TRACT-  C 0004     IN SEATTLE WA,3458,3454,4,3040,4,3483,36.56
G5300330D0001,STCTY-53033 TRACT-  D 0001     IN SEATTLE WA,5206,5186,20,4648,5,4198,41.75
G5300330D0002,STCTY-53033 TRACT-  D 0002     IN SEATTLE WA,4964,4944,20,4492,3,4497,37.86
G5300330D0003,STCTY-53033 TRACT-  D 0003     IN SEATTLE WA,3578,3554,24,3220,4,4332,39.72
G5300330D0004,STCTY-53033 TRACT-  D 0004     IN SEATTLE WA,3878,3863,15,3432,3,4012,40.61
G5300330D0005,STCTY-53033 TRACT-  D 0005     IN SEATTLE WA,3730,3690,40,3415,7,8976,64
G5300330D0006,STCTY-53033 TRACT-  D 0006     IN SEATTLE WA,5714,5625,89,5009,3,3925,32.24
G5300330E0001,STCTY-53033 TRACT-  E 0001     IN SEATTLE WA,3261,3248,13,2760,1,3566,33.21
G5300330E0002,STCTY-53033 TRACT-  E 0002     IN SEATTLE WA,4548,4542,6,3951,0,3791,35.18
G5300330E0003,STCTY-53033 TRACT-  E 0003     IN SEATTLE WA,4872,4851,21,4238,0,3570,30.52
G5300330E0004,STCTY-53033 TRACT-  E 0004     IN SEATTLE WA,3993,3976,17,3351,1,3173,26.19
G5300330F0001,STCTY-53033 TRACT-  F 0001     IN SEATTLE WA,6178,6155,23,5403,11,6295,34.27
G5300330F0002,STCTY-53033 TRACT-  F 0002     IN SEATTLE WA,3914,3856,58,3056,32,2245,17.26
G5300330G0001,STCTY-53033 TRACT-  G 0001     IN SEATTLE WA,4231,4228,3,3604,1,3513,26.45
G5300330G0002,STCTY-53033 TRACT-  G 0002     IN SEATTLE WA,4100,4095,5,3487,4,3601,28.07
G5300330G0003,STCTY-53033 TRACT-  G 0003     IN SEATTLE WA,4119,4111,8,3434,2,3737,29.48
G5300330G0004,STCTY-53033 TRACT-  G 0004     IN SEATTLE WA,3779,3770,9,3261,0,3444,32.15
G5300330G0005,STCTY-53033 TRACT-  G 0005     IN SEATTLE WA,4148,4136,12,3513,1,3777,34.32
G5300330G0006,STCTY-53033 TRACT-  G 0006     IN SEATTLE WA,5537,5514,23,4849,2,5682,35.92
G5300330H0001,STCTY-53033 TRACT-  H 0001     IN SEATTLE WA,4906,4887,19,4302,1,4613,37.55
G5300330H0002,STCTY-53033 TRACT-  H 0002     IN SEATTLE WA,4291,4251,40,3676,17,5742,39.75
G5300330H0003,STCTY-53033 TRACT-  H 0003     IN SEATTLE WA,3638,3631,7,3011,0,2659,29.46
G5300330I0001,STCTY-53033 TRACT-  I 0001     IN SEATTLE WA,4607,4587,20,4033,9,6056,54.27
G5300330I0002,STCTY-53033 TRACT-  I 0002     IN SEATTLE WA,4555,4522,33,4064,6,6391,43.31
G5300330I0003,STCTY-53033 TRACT-  I 0003     IN SEATTLE WA,4048,3967,81,3437,52,4754,41.25
G5300330J0001,STCTY-53033 TRACT-  J 0001     IN SEATTLE WA,3357,2547,810,2018,771,2421,24.04
G5300330J0002,STCTY-53033 TRACT-  J 0002     IN SEATTLE WA,5674,5594,80,4723,35,4813,37.11
G5300330J0003,STCTY-53033 TRACT-  J 0003     IN SEATTLE WA,4702,4512,190,3157,92,2915,29.23
G5300330K0001,STCTY-53033 TRACT-  K 0001     IN SEATTLE WA,7042,6939,103,5792,23,3346,30.32
G5300330K0002,STCTY-53033 TRACT-  K 0002     IN SEATTLE WA,4107,3789,318,3194,284,3336,35.54
G5300330K0003,STCTY-53033 TRACT-  K 0003     IN SEATTLE WA,4568,4389,179,3591,129,2317,31.42
G5300330K0004,STCTY-53033 TRACT-  K 0004     IN SEATTLE WA,4827,3397,1430,2690,105,2235,20.82
G5300330K0005,STCTY-53033 TRACT-  K 0005     IN SEATTLE WA,5049,3729,1320,2713,610,2421,23.1
G5300330L0001,STCTY-53033 TRACT-  L 0001     IN SEATTLE WA,3703,3674,29,3074,0,2281,26
G5300330L0002,STCTY-53033 TRACT-  L 0002     IN SEATTLE WA,4211,4177,34,3479,1,0,24.86
G5300330L0003,STCTY-53033 TRACT-  L 0003     IN SEATTLE WA,5705,5550,155,4298,3,0,18.98
G5300330L0004,STCTY-53033 TRACT-  L 0004     IN SEATTLE WA,7696,7655,41,6409,2,4340,32.3
G5300330L0005,STCTY-53033 TRACT-  L 0005     IN SEATTLE WA,3547,3398,149,2541,9,0,10.49
G5300330M0001,STCTY-53033 TRACT-  M 0001     IN SEATTLE WA,4620,4325,295,3137,49,0,11.49
G5300330M0002,STCTY-53033 TRACT-  M 0002     IN SEATTLE WA,6234,6104,130,5178,2,0,20.07
G5300330M0003,STCTY-53033 TRACT-  M 0003     IN SEATTLE WA,5037,4950,87,4236,1,0,29.97
G5300330M0004,STCTY-53033 TRACT-  M 0004     IN SEATTLE WA,4812,4727,85,4034,4,0,24.98
G5300330M0005,STCTY-53033 TRACT-  M 0005     IN SEATTLE WA,5048,4525,523,3514,47,0,13.31
G5300330N0001,STCTY-53033 TRACT-  N 0001     IN SEATTLE WA,4351,4350,1,3746,0,3844,30.61
G5300330N0002,STCTY-53033 TRACT-  N 0002     IN SEATTLE WA,5639,5639,0,4858,0,3630,32.55
G5300330N0003,STCTY-53033 TRACT-  N 0003     IN SEATTLE WA,5117,5109,8,4393,0,3075,28.17
G5300330N0004,STCTY-53033 TRACT-  N 0004     IN SEATTLE WA,3905,3897,8,3178,0,2996,29.86
G5300330O0001,STCTY-53033 TRACT-  O 0001     IN SEATTLE WA,3616,2583,1033,1641,173,0,7.38
G5300330O0002,STCTY-53033 TRACT-  O 0002     IN SEATTLE WA,3733,1419,2314,742,262,0,8.64
G5300330O0003,STCTY-53033 TRACT-  O 0003     IN SEATTLE WA,4899,4456,443,2848,114,254,7.04
G5300330O0004,STCTY-53033 TRACT-  O 0004     IN SEATTLE WA,5244,5196,48,4064,5,1895,17.94
G5300330P0001,STCTY-53033 TRACT-  P 0001     IN SEATTLE WA,3796,1757,2039,1265,416,2420,19.45
G5300330P0002,STCTY-53033 TRACT-  P 0002     IN SEATTLE WA,4560,4119,441,3095,46,2439,23.52
G5300330P0003,STCTY-53033 TRACT-  P 0003     IN SEATTLE WA,4631,4473,158,3640,13,3330,34.24
G5300330Q0001,STCTY-53033 TRACT-  Q 0001     IN SEATTLE WA,4866,4455,411,3494,175,2693,24.47
G5300330Q0002,STCTY-53033 TRACT-  Q 0002     IN SEATTLE WA,5533,5443,90,4569,49,5043,39.65
G5300330Q0003,STCTY-53033 TRACT-  Q 0003     IN SEATTLE WA,3871,3762,109,3172,44,2537,25.11
G5300330R0001,STCTY-53033 TRACT-  R 0001     IN SEATTLE WA,6626,6476,150,5204,16,2007,20.37
G5300330R0002,STCTY-53033 TRACT-  R 0002     IN SEATTLE WA,3380,3358,22,2659,0,2342,23.23
G5300330R0003,STCTY-53033 TRACT-  R 0003     IN SEATTLE WA,6438,6379,59,5460,49,2493,22.5
G5300330R0004,STCTY-53033 TRACT-  R 0004     IN SEATTLE WA,4253,4172,81,3478,24,2575,23.79
G5300330R0005,STCTY-53033 TRACT-  R 0005     IN SEATTLE WA,5167,5153,14,4379,12,2621,25.56
G5300330S0001,STCTY-53033 TRACT-  S 0001     IN SEATTLE WA,5676,5666,10,4901,1,2988,28.34
G5300330S0002,STCTY-53033 TRACT-  S 0002     IN SEATTLE WA,3607,3571,36,3155,5,1870,21.62
G5300330S0003,STCTY-53033 TRACT-  S 0003     IN SEATTLE WA,4949,4947,2,4333,1,2697,26.22
G55007900001,STCTY-55079 TRACT-    0001     IN MILWAUKEE WI,2613,2589,24,1881,22,0,32.79
G55007900002,STCTY-55079 TRACT-    0002     IN MILWAUKEE WI,4032,3990,42,3171,27,0,27.97
G55007900003,STCTY-55079 TRACT-    0003     IN MILWAUKEE WI,4737,4729,8,4254,2,0,40.61
G55007900004,STCTY-55079 TRACT-    0004     IN MILWAUKEE WI,4228,4226,2,3862,2,10556,54.25
G55007900005,STCTY-55079 TRACT-    0005     IN MILWAUKEE WI,4502,4499,3,3886,0,3792,32.54
G55007900006,STCTY-55079 TRACT-    0006     IN MILWAUKEE WI,3872,3861,11,3251,2,3382,27.47
G55007900007,STCTY-55079 TRACT-    0007     IN MILWAUKEE WI,4723,4663,60,3709,42,2875,25.88
G55007900008,STCTY-55079 TRACT-    0008     IN MILWAUKEE WI,4145,4141,4,3436,0,2365,28.77
G55007900009,STCTY-55079 TRACT-    0009     IN MILWAUKEE WI,3812,3812,0,3365,0,3793,37.39
G55007900010,STCTY-55079 TRACT-    0010     IN MILWAUKEE WI,4834,4833,1,4262,1,3816,41.21
G55007900011,STCTY-55079 TRACT-    0011     IN MILWAUKEE WI,3851,3822,29,3445,17,12361,65.35
G55007900012,STCTY-55079 TRACT-    0012     IN MILWAUKEE WI,3676,3673,3,3373,3,9520,70.89
G55007900013,STCTY-55079 TRACT-    0013     IN MILWAUKEE WI,4353,4344,9,3891,2,4877,52.62
G55007900014,STCTY-55079 TRACT-    0014     IN MILWAUKEE WI,3651,3648,3,3290,2,4860,51.84
G55007900015,STCTY-55079 TRACT-    0015     IN MILWAUKEE WI,1862,1860,2,1751,2,13371,79.74
G55007900016,STCTY-55079 TRACT-    0016     IN MILWAUKEE WI,2128,2118,10,1575,8,0,32.41
G55007900017,STCTY-55079 TRACT-    0017     IN MILWAUKEE WI,2633,2624,9,2115,0,0,29.47
G55007900018,STCTY-55079 TRACT-    0018     IN MILWAUKEE WI,4437,4410,27,3683,0,0,32.48
G55007900019,STCTY-55079 TRACT-    0019     IN MILWAUKEE WI,3270,2882,388,2272,347,0,26.02
G55007900020,STCTY-55079 TRACT-    0020     IN MILWAUKEE WI,1656,538,1118,308,1105,0,25.63
G55007900021,STCTY-55079 TRACT-    0021     IN MILWAUKEE WI,3395,1726,1669,1238,1665,0,28.6
G55007900022,STCTY-55079 TRACT-    0022     IN MILWAUKEE WI,3611,3601,10,2801,2,2723,31.98
G55007900023,STCTY-55079 TRACT-    0023     IN MILWAUKEE WI,7038,7013,25,6193,7,3458,30.37
G55007900024,STCTY-55079 TRACT-    0024     IN MILWAUKEE WI,3997,3991,6,3561,0,0,31.75
G55007900025,STCTY-55079 TRACT-    0025     IN MILWAUKEE WI,4837,4833,4,4288,1,3841,32.64
G55007900026,STCTY-55079 TRACT-    0026     IN MILWAUKEE WI,3539,3529,10,2776,0,2913,33.42
G55007900027,STCTY-55079 TRACT-    0027     IN MILWAUKEE WI,3186,3184,2,2454,0,2911,31.83
G55007900028,STCTY-55079 TRACT-    0028     IN MILWAUKEE WI,3353,3352,1,2571,0,2557,30.01
G55007900029,STCTY-55079 TRACT-    0029     IN MILWAUKEE WI,4498,2226,2272,1530,2260,2750,29.37
G55007900030,STCTY-55079 TRACT-    0030     IN MILWAUKEE WI,3510,1637,1873,1175,1871,0,31.09
G55007900031,STCTY-55079 TRACT-    0031     IN MILWAUKEE WI,2304,2202,102,1793,98,0,30.85
G55007900032,STCTY-55079 TRACT-    0032     IN MILWAUKEE WI,3925,3925,0,3331,0,3019,31.67
G55007900033,STCTY-55079 TRACT-    0033     IN MILWAUKEE WI,3421,3417,4,2811,4,3390,32.31
G55007900034,STCTY-55079 TRACT-    0034     IN MILWAUKEE WI,2871,2870,1,2369,1,3800,33.89
G55007900035,STCTY-55079 TRACT-    0035     IN MILWAUKEE WI,4603,4161,442,3355,439,2647,30.4
G55007900036,STCTY-55079 TRACT-    0036     IN MILWAUKEE WI,6648,6144,504,4566,484,2731,32.9
G55007900037,STCTY-55079 TRACT-    0037     IN MILWAUKEE WI,4560,4559,1,3406,1,3210,33.65
G55007900038,STCTY-55079 TRACT-    0038     IN MILWAUKEE WI,3609,3609,0,2766,0,3227,38
G55007900039,STCTY-55079 TRACT-    0039     IN MILWAUKEE WI,4024,4023,1,3318,0,3106,35.52
G55007900040,STCTY-55079 TRACT-    0040     IN MILWAUKEE WI,2992,2991,1,2495,1,2984,33.22
G55007900041,STCTY-55079 TRACT-    0041     IN MILWAUKEE WI,3340,3340,0,2810,0,3398,34.95
G55007900042,STCTY-55079 TRACT-    0042     IN MILWAUKEE WI,4629,4626,3,4060,0,4411,33.37
G55007900043,STCTY-55079 TRACT-    0043     IN MILWAUKEE WI,4000,4000,0,3556,0,3569,37.02
G55007900044,STCTY-55079 TRACT-    0044     IN MILWAUKEE WI,3854,3854,0,3472,0,4479,34.02
G55007900045,STCTY-55079 TRACT-    0045     IN MILWAUKEE WI,2834,2829,5,2400,0,3516,38.48
G55007900046,STCTY-55079 TRACT-    0046     IN MILWAUKEE WI,3009,3004,5,2531,0,2875,34.34
G55007900047,STCTY-55079 TRACT-    0047     IN MILWAUKEE WI,5790,5786,4,4894,0,3524,35.22
G55007900048,STCTY-55079 TRACT-    0048     IN MILWAUKEE WI,4820,4820,0,4100,0,3225,38.36
G55007900049,STCTY-55079 TRACT-    0049     IN MILWAUKEE WI,3407,3406,1,2861,0,3207,37.59
G55007900050,STCTY-55079 TRACT-    0050     IN MILWAUKEE WI,3676,3676,0,2971,0,3315,37.96
G55007900051,STCTY-55079 TRACT-    0051     IN MILWAUKEE WI,3828,3828,0,3089,0,3210,37.75
G55007900052,STCTY-55079 TRACT-    0052     IN MILWAUKEE WI,5250,5235,15,4362,13,3113,35.08
G55007900053,STCTY-55079 TRACT-    0053     IN MILWAUKEE WI,3596,3594,2,3037,2,3250,34.54
G55007900054,STCTY-55079 TRACT-    0054     IN MILWAUKEE WI,2608,2606,2,2230,0,3867,37.72
G55007900055,STCTY-55079 TRACT-    0055     IN MILWAUKEE WI,2892,2890,2,2462,0,3009,35.97
G55007900056,STCTY-55079 TRACT-    0056     IN MILWAUKEE WI,4182,4182,0,3590,0,3221,34.32
G55007900057,STCTY-55079 TRACT-    0057     IN MILWAUKEE WI,3686,3683,3,3143,0,2598,29.36
G55007900058,STCTY-55079 TRACT-    0058     IN MILWAUKEE WI,3632,3632,0,3145,0,4500,41.69
G55007900059,STCTY-55079 TRACT-    0059     IN MILWAUKEE WI,3961,3961,0,3359,0,3212,33.06
G55007900060,STCTY-55079 TRACT-    0060     IN MILWAUKEE WI,5730,5728,2,5038,0,3594,38.18
G55007900061,STCTY-55079 TRACT-    0061     IN MILWAUKEE WI,4663,4663,0,4106,0,3530,38.56
G55007900062,STCTY-55079 TRACT-    0062     IN MILWAUKEE WI,3788,3785,3,3170,3,3327,38.63
G55007900063,STCTY-55079 TRACT-    0063     IN MILWAUKEE WI,5463,5461,2,4710,0,3865,39.31
G55007900064,STCTY-55079 TRACT-    0064     IN MILWAUKEE WI,6534,6511,23,5483,23,3252,36.78
G55007900065,STCTY-55079 TRACT-    0065     IN MILWAUKEE WI,4750,4750,0,4050,0,3276,37.03
G55007900066,STCTY-55079 TRACT-    0066     IN MILWAUKEE WI,4514,4510,4,3895,0,3765,40.93
G55007900067,STCTY-55079 TRACT-    0067     IN MILWAUKEE WI,4334,4332,2,3769,2,3961,41.05
G55007900068,STCTY-55079 TRACT-    0068     IN MILWAUKEE WI,3504,3504,0,2961,0,2861,37.06
G55007900069,STCTY-55079 TRACT-    0069     IN MILWAUKEE WI,4127,4125,2,3614,1,3022,39.08
G55007900070,STCTY-55079 TRACT-    0070     IN MILWAUKEE WI,4666,4665,1,4130,0,4547,36.51
G55007900071,STCTY-55079 TRACT-    0071     IN MILWAUKEE WI,4828,4828,0,4165,0,3955,38.81
G55007900072,STCTY-55079 TRACT-    0072     IN MILWAUKEE WI,5241,5228,13,4787,0,6543,40.87
G55007900073,STCTY-55079 TRACT-    0073     IN MILWAUKEE WI,5473,5374,99,4697,97,3616,38.68
G55007900074,STCTY-55079 TRACT-    0074     IN MILWAUKEE WI,2765,2764,1,2315,1,3041,34.72
G55007900075,STCTY-55079 TRACT-    0075     IN MILWAUKEE WI,2208,2206,2,1979,0,4548,41.89
G55007900076,STCTY-55079 TRACT-    0076     IN MILWAUKEE WI,4392,4392,0,3905,0,4143,44.6
G55007900077,STCTY-55079 TRACT-    0077     IN MILWAUKEE WI,5082,5082,0,4556,0,3926,43.81
G55007900078,STCTY-55079 TRACT-    0078     IN MILWAUKEE WI,4249,4247,2,3657,0,4528,47.78
G55007900079,STCTY-55079 TRACT-    0079     IN MILWAUKEE WI,4990,4990,0,4393,0,5122,47.15
G55007900080,STCTY-55079 TRACT-    0080     IN MILWAUKEE WI,5788,5787,1,5082,0,4781,45.03
G55007900081,STCTY-55079 TRACT-    0081     IN MILWAUKEE WI,4463,4461,2,3954,1,4796,44.8
G55007900082,STCTY-55079 TRACT-    0082     IN MILWAUKEE WI,4720,4720,0,4143,0,4318,41.73
G55007900083,STCTY-55079 TRACT-    0083     IN MILWAUKEE WI,3596,3596,0,3168,0,4431,43.29
G55007900084,STCTY-55079 TRACT-    0084     IN MILWAUKEE WI,5757,5752,5,5204,5,5835,49.89
G55007900085,STCTY-55079 TRACT-    0085     IN MILWAUKEE WI,3395,3387,8,3038,1,5189,45.41
G55007900086,STCTY-55079 TRACT-    0086     IN MILWAUKEE WI,1464,1463,1,1252,1,4677,36.73
G55007900087,STCTY-55079 TRACT-    0087     IN MILWAUKEE WI,2480,2480,0,2059,0,4231,40.69
G55007900088,STCTY-55079 TRACT-    0088     IN MILWAUKEE WI,3872,3866,6,3453,6,4715,43.31
G55007900089,STCTY-55079 TRACT-    0089     IN MILWAUKEE WI,4412,4409,3,3776,0,4349,40.67
G55007900090,STCTY-55079 TRACT-    0090     IN MILWAUKEE WI,3086,3061,25,2788,25,5779,33.79
G55007900091,STCTY-55079 TRACT-    0091     IN MILWAUKEE WI,3506,3506,0,3202,0,5937,50.3
G55007900092,STCTY-55079 TRACT-    0092     IN MILWAUKEE WI,5628,5625,3,4846,0,6813,56.29
G55007900093,STCTY-55079 TRACT-    0093     IN MILWAUKEE WI,3978,3977,1,3624,0,6737,54.65
G55007900094,STCTY-55079 TRACT-    0094     IN MILWAUKEE WI,2821,2820,1,2591,0,6607,49.06
G55007900095,STCTY-55079 TRACT-    0095     IN MILWAUKEE WI,4309,4308,1,3709,0,4970,51.05
G55007900096,STCTY-55079 TRACT-    0096     IN MILWAUKEE WI,3561,3561,0,2833,0,5027,54.88
G55007900097,STCTY-55079 TRACT-    0097     IN MILWAUKEE WI,3038,3037,1,2599,0,6982,58.09
G55007900098,STCTY-55079 TRACT-    0098     IN MILWAUKEE WI,3833,3828,5,3406,2,5580,46.38
G55007900099,STCTY-55079 TRACT-    0099     IN MILWAUKEE WI,2295,2283,12,1982,0,5810,49.76
G55007900100,STCTY-55079 TRACT-    0100     IN MILWAUKEE WI,3426,3426,0,3105,0,5883,55.3
G55007900101,STCTY-55079 TRACT-    0101     IN MILWAUKEE WI,3908,3907,1,3583,0,6526,54.56
G55007900102,STCTY-55079 TRACT-    0102     IN MILWAUKEE WI,3102,3100,2,2808,1,6699,53.37
G55007900103,STCTY-55079 TRACT-    0103     IN MILWAUKEE WI,4033,4032,1,3549,0,5341,48.54
G55007900104,STCTY-55079 TRACT-    0104     IN MILWAUKEE WI,2601,2601,0,2321,0,7679,52.79
G55007900105,STCTY-55079 TRACT-    0105     IN MILWAUKEE WI,2869,2869,0,2495,0,4434,40.65
G55007900106,STCTY-55079 TRACT-    0106     IN MILWAUKEE WI,1059,1059,0,894,0,3847,37.36
G55007900107,STCTY-55079 TRACT-    0107     IN MILWAUKEE WI,3133,3133,0,2633,0,2581,37.46
G55007900108,STCTY-55079 TRACT-    0108     IN MILWAUKEE WI,4721,4526,195,3820,194,3861,36.96
G55007900109,STCTY-55079 TRACT-    0109     IN MILWAUKEE WI,3520,3520,0,3036,0,3423,39.32
G55007900110,STCTY-55079 TRACT-    0110     IN MILWAUKEE WI,3922,3922,0,3480,0,4429,41.49
G55007900111,STCTY-55079 TRACT-    0111     IN MILWAUKEE WI,3959,3952,7,3502,0,3836,35.72
G55007900112,STCTY-55079 TRACT-    0112     IN MILWAUKEE WI,4383,4375,8,3787,0,3210,32.46
G55007900113,STCTY-55079 TRACT-    0113     IN MILWAUKEE WI,4408,4402,6,3295,0,3139,28.98
G55007900114,STCTY-55079 TRACT-    0114     IN MILWAUKEE WI,3001,2988,13,2171,9,3838,27.39
G55007900115,STCTY-55079 TRACT-    0115     IN MILWAUKEE WI,1140,1120,20,836,7,0,23.67
G55007900116,STCTY-55079 TRACT-    0116     IN MILWAUKEE WI,6063,6053,10,5239,1,3228,30.36
G55007900117,STCTY-55079 TRACT-    0117     IN MILWAUKEE WI,5318,5312,6,4628,0,3276,32.85
G55007900118,STCTY-55079 TRACT-    0118     IN MILWAUKEE WI,6117,6114,3,5232,1,3500,33.6
G55007900119,STCTY-55079 TRACT-    0119     IN MILWAUKEE WI,4139,4136,3,3616,0,4108,37.03
G55007900120,STCTY-55079 TRACT-    0120     IN MILWAUKEE WI,3810,3810,0,3228,0,4158,37.96
G55007900121,STCTY-55079 TRACT-    0121     IN MILWAUKEE WI,2731,2730,1,2381,0,4356,39.36
G55007900122,STCTY-55079 TRACT-    0122     IN MILWAUKEE WI,6653,6652,1,5633,0,3705,35.93
G55007900123,STCTY-55079 TRACT-    0123     IN MILWAUKEE WI,4964,4964,0,4106,0,3083,32.62
G55007900124,STCTY-55079 TRACT-    0124     IN MILWAUKEE WI,6018,6011,7,5102,0,3199,28.21
G55007900125,STCTY-55079 TRACT-    0125     IN MILWAUKEE WI,5003,5003,0,4309,0,3195,28.43
G55007900126,STCTY-55079 TRACT-    0126     IN MILWAUKEE WI,4875,4864,11,4150,0,2860,27.65
G55007900127,STCTY-55079 TRACT-    0127     IN MILWAUKEE WI,5225,5218,7,4372,1,3148,33.81
G55007900128,STCTY-55079 TRACT-    0128     IN MILWAUKEE WI,4854,4833,21,4262,4,3737,35.13
G55007900129,STCTY-55079 TRACT-    0129     IN MILWAUKEE WI,616,616,0,521,0,0,25.57
G55007900130,STCTY-55079 TRACT-    0130     IN MILWAUKEE WI,4450,4450,0,3700,0,2484,30.67
G55007900131,STCTY-55079 TRACT-    0131     IN MILWAUKEE WI,4087,4087,0,3441,0,3167,28.9
G55007900132,STCTY-55079 TRACT-    0132     IN MILWAUKEE WI,5700,5699,1,4761,0,2984,27.9
G55007900133,STCTY-55079 TRACT-    0133     IN MILWAUKEE WI,4138,4137,1,3430,1,3113,28.98
G55007900134,STCTY-55079 TRACT-    0134     IN MILWAUKEE WI,4139,4139,0,3696,0,3864,41.48
G55007900135,STCTY-55079 TRACT-    0135     IN MILWAUKEE WI,2978,2978,0,2601,0,4448,39.73
G55007900136,STCTY-55079 TRACT-    0136     IN MILWAUKEE WI,1809,1809,0,1675,0,6960,47.71
G55007900137,STCTY-55079 TRACT-    0137     IN MILWAUKEE WI,1879,1878,1,1693,1,4933,35.4
G55007900138,STCTY-55079 TRACT-    0138     IN MILWAUKEE WI,2764,2764,0,2225,0,3036,27.53
G55007900139,STCTY-55079 TRACT-    0139     IN MILWAUKEE WI,4459,4459,0,3734,0,2982,33.78
G55007900140,STCTY-55079 TRACT-    0140     IN MILWAUKEE WI,3859,3859,0,3228,0,2845,31.24
G55007900141,STCTY-55079 TRACT-    0141     IN MILWAUKEE WI,1341,1338,3,1191,0,4895,33.58
G55007900142,STCTY-55079 TRACT-    0142     IN MILWAUKEE WI,1778,1778,0,1533,0,4431,41.2
G55007900143,STCTY-55079 TRACT-    0143     IN MILWAUKEE WI,3576,3576,0,3217,0,4434,40.58
G55007900144,STCTY-55079 TRACT-    0144     IN MILWAUKEE WI,2411,2411,0,2089,0,4606,41.75
G55007900145,STCTY-55079 TRACT-    0145     IN MILWAUKEE WI,2657,2657,0,2383,0,5691,45.74
G55007900146,STCTY-55079 TRACT-    0146     IN MILWAUKEE WI,4379,4379,0,4040,0,4835,43.95
G55007900147,STCTY-55079 TRACT-    0147     IN MILWAUKEE WI,2890,2885,5,2573,0,4733,41.83
G55007900148,STCTY-55079 TRACT-    0148     IN MILWAUKEE WI,2707,2700,7,2428,0,5229,39.96
G55007900149,STCTY-55079 TRACT-    0149     IN MILWAUKEE WI,3837,3837,0,3214,0,4209,37.95
G55007900150,STCTY-55079 TRACT-    0150     IN MILWAUKEE WI,3860,3860,0,3329,0,4164,38.48
G55007900151,STCTY-55079 TRACT-    0151     IN MILWAUKEE WI,1581,1581,0,1416,0,4581,43.2
G55007900152,STCTY-55079 TRACT-    0152     IN MILWAUKEE WI,452,452,0,404,0,0,0
G55007900153,STCTY-55079 TRACT-    0153     IN MILWAUKEE WI,2937,2937,0,2535,0,5220,40.04
